1
1
###########
#.........#
#.........#
#.....#..##
#.........#
#.........#
#...#.....#
#.........#
#.........#
#..#.....##
#####D#####

2
3
###########
#.........#
#.........#
#.........#
#.........#
l.........d
#.........#
#.#.....#.#
#..#...#..#
#.........#
#####d#####
locked : 1

2
1
#####D#####
##........#
#..#..#...#
#.#.......#
#.........#
D.........l
#.........#
#.#.....#.#
#..#...#..#
#k........#
#####D#####
key : 0

1
4
###########
#ee?....#.#
#e###.....#
#..#..#...#
#..####...#
#..#####..D
#.#...#...#
#...#.....#
#..##.#...#
#.........#
#####D#####
enemies 3
sign Turn back; you are not yet ready.

5
2
#####D#####
#..#......#
#..#......#
#.##......#
#.........#
#.........#
#.........#
###.......#
#..#......#
#k........#
###########
key : 3

3
5
#####D#####
#.........#
#.#.#.#.#.#
#.........#
#..#...#..#
D.........#
#...#...#.#
#.........#
#..#...#..#
#.........#
###########
door 1 : 1

3
1
#####D#####
#.........#
#..#...#..#
#k#.....#.#
#.........#
#.........D
#.........#
#.........#
#.........#
#.........#
#####D#####
key : 1

0
5
###########
#X........#
#.p.......#
#.....#####
#.....##..#
#....#....#
#.........#
#.....##..#
#.........#
#.........#
#####D#####

2
0
###########
#.........#
#.........#
#......#..#
#...@.....#
#...##....D
#.####....#
##.##.....#
##........#
#?........#
###########
sign The brave are rewarded.

2
5
#####l#####
#.........#
##.#...#..#
#.........#
#.#.#.#.#.#
l.........D
#..#.#.#..#
#.........#
#.#.#...#.#
#.........#
#####D#####
locked : 2

4
1
#####D#####
#.........#
#......#..#
#.......#.#
#.........#
#.........D
#.........#
#.......#.#
#......#..#
#.........#
###########

3
2
#####D#####
#.........#
#.........#
#.........#
#.........#
D.........D
#....#....#
#.....#k#.#
#..#...#..#
#.........#
#####D#####
key : 2

3
3
#####d#####
#..#......#
#.#.#.....#
#.#.......#
#.......#.#
D..#..#...D
#.#.#.....#
#...#.....#
#.#.......#
#.#.......#
###########

4
2
#####D#####
#e#.......#
#.........#
#..#...#..#
#.........#
D........?#
#.........#
#..#.#.#..#
#.........#
#e#.....#s#
#####D#####
enemies 2
switch 0 : 0
sign Those who search shall find.

3
4
#####D#####
#e........#
#.........#
#.........#
#.........#
D.........D
#.........#
#.........#
#.........#
#e.?se....#
###########
enemies 3
switch 1 : 1
sign Beware what lurks ahead.

1
5
#####D#####
#.......#.#
#.....##..#
#.........#
#.........#
D....e....#
#.........#
#.........#
#.........#
#.........#
#####l#####
locked : 3
boss
enemies 1

2
6
###########
#......##e#
#.....#...#
#.......###
#.....##..#
D.........#
#.........#
#.........#
#.........#
#.........#
###########
enemies 1
door 0 : 0

2
2
###########
#..#......#
#.........#
#.........#
#....#....#
l......#..l
#.....#.#.#
#.......#.#
#.........#
#.........#
#####D#####
locked : 0

2
4
#####D#####
#.........#
#......#..#
#......#..#
#.........#
d.........l
#.........#
#.........#
#.........#
#.........#
#####D#####

