3
1
#####D#####
#.........#
#.........#
#..#..#...#
#.#..##...#
d..####...D
#.##.#....#
#.##..#...#
#.........#
#.........#
#####D#####

2
0
#####D#####
#.........#
#......#..#
#.......###
#.......#.#
#.........D
#......#..#
#.......#.#
#......#..#
#.........#
#####D#####

3
2
#####D#####
#.#.......#
#.........#
#.#.#.#...#
#.........#
D...#.#...#
#.........#
#.#.#.#.#.#
#.........#
#.#.......#
#####D#####

0
0
###########
#.........#
#.........#
#.........#
#.........#
#.........#
#.........#
#.......#.#
#......#..#
#.........#
#####d#####

1
0
#####d#####
#.........#
##.....#..#
#.........#
#..#.#.#..#
#.........#
#..#.#.#..#
#.........#
##.#...#.##
#.........#
#####D#####

6
1
#####D#####
#.........#
#.........#
#.........#
#.........#
D.........#
#.........#
#.........#
#.........#
#........e#
###########
enemies 1
door 0 : 0

2
1
###########
#.....k...#
#.....#...#
#...#.....#
#.........#
D.........d
#.........#
#.........#
#.........#
#.........#
#####D#####
key : 0

7
0
#####D#####
#........##
#.........#
#......#..#
#.........#
#.........#
#.........#
#.........#
#.........#
#.........#
###########

5
0
#####l#####
#.........#
#.........#
#.#.......#
#.........#
#.........D
#.........#
#..#....#.#
#......##.#
#.........#
#####D#####
locked : 1

4
0
#####D#####
#.........#
#.....#...#
#....#....#
#.........#
#.........D
#.........#
#.........#
#.........#
#.........#
#####l#####

4
1
#####D#####
#k........#
#.........#
#.........#
#.........#
D.........d
#.........#
#.......#.#
#......#..#
#.........#
#####D#####
key : 1

2
3
###########
#........k#
#......#..#
#.......#.#
#.........#
D.........#
#.........#
#.........#
#.........#
#.........#
###########
key : 4

1
2
###########
#k#.....#.#
#.........#
#..#.#.#.##
#.........#
#.....#...#
#.........#
#..#...#.##
#.........#
#.......#.#
#####D#####
key : 5

2
2
#####D#####
#.........#
#..#......#
#.#.......#
#.........#
d.........D
#.........#
#.#.......#
#..#......#
#.........#
#####D#####

6
0
#####D#####
#e#.......#
#.........#
#.........#
#.........#
#s........D
#.........#
#e#.......#
#.........#
#.........#
#####D#####
enemies 2
switch 0 : 0

3
0
#####D#####
#.........#
#.........#
#.........#
#.........#
#....@....d
#.........#
#.###.....#
#.........#
#.........#
#####D#####

5
2
#####D#####
#.........#
#......#..#
#.....#.###
#....#..#.#
D.........#
#.....###.#
#.........#
#.........#
#........X#
###########

5
1
#####D#####
#e........#
#.........#
#.........#
#.....#...#
D.....##..D
#.........#
#..####.###
#...#?#.###
#e.......e#
#####D#####
enemies 3
sign Seek the matching key before you proceed.

4
2
#####D#####
#.......#.#
#.........#
#......##.#
#...e####.#
d....###..#
#....#..#.#
#....##..##
#.........#
#.......#.#
#####D#####
boss
enemies 1

