2
1
#####D#####
#.........#
#.........#
#.........#
#.........#
D.........#
#.........#
#.........#
#.........#
#.........#
#####D#####

4
1
#####D#####
#k#.......#
#.###.#...#
#.###.#...#
#..#.##...#
D..#.#....l
#.........#
#.........#
#.........#
#.........#
###########
key : 3

3
2
###########
#.........#
#..#...#..#
#.#.....#.#
#.........#
l.........D
#.........#
#.........#
#.........#
#.........#
#####D#####
locked : 3

3
3
#####D#####
#.........#
#.........#
#.........#
#......#..#
D........k#
#...#.....#
#.........#
#.........#
#.........#
#####D#####
key : 5

6
3
#####D#####
#.........#
#.........#
#.........#
#...#.#...#
#.........#
#....##...#
#......##.#
#...#.#.#.#
#X........#
###########

1
1
#####d#####
#.........#
#.........#
#.........#
#.........#
D..#......d
#.##......#
#.##......#
##..#.....#
##........#
#####D#####

1
0
#####D#####
#.........#
#......#..#
#.......#.#
#.........#
#k........D
#.........#
#.......#.#
#......#..#
#.........#
#####D#####
key : 2

3
1
#####D#####
#.........#
#..#...#..#
#.#.....#.#
#.........#
l.........l
#......#..#
#.#.#.....#
#..#...#..#
#.........#
#####D#####
locked : 0

4
0
#####D#####
#.........#
#.........#
#.........#
#.......p.#
#....@.p..D
#.........#
#.........#
#.........#
#.........#
###########

3
0
#####D#####
#.........#
##.....#.##
#.......#.#
#.........#
#.........l
#.........#
#.........#
##........#
#.........#
#####D#####

0
0
###########
#.........#
#.........#
#.........#
#.........#
#.........D
#.........#
#.........#
#.........#
#.........#
#####D#####

2
3
###########
#.........#
#.........#
#.........#
#.........#
#.........#
#......p..#
#.........#
#.........#
#.........#
#####D#####

0
1
###########
#.........#
#.#.#.....#
###..#....#
#.#.##....#
D..###....#
#...#.....#
#.........#
#.........#
#.........#
#####d#####

2
0
#####D#####
#.........#
#.........#
#.........#
#.........#
#k........D
#.........#
#.......#.#
#......#..#
#.........#
#####D#####
key : 0

4
4
###########
#.#.......#
#..##...p.#
#..#..#...#
#..####...#
l...###...#
#.##......#
#..#.#....#
#.##..#...#
#.........#
###########
locked : 5

5
3
#####d#####
#.........#
#.........#
###.#.....#
#...#.....#
#..#.e....#
#.....#...#
#.........#
#.........#
#.........#
#####D#####
boss
enemies 1

1
2
###########
#.#.....#.#
#.........#
#..#.#.#.##
#.........#
d...#.#...#
#.........#
#....#.#.##
#.........#
#.......#.#
###########

4
2
#####D#####
#.........#
#..#......#
#.#.......#
#.........#
l.........d
#.........#
#.........#
#.........#
#.........#
###########
locked : 2

4
3
#####D#####
#.........#
#.........#
#..#..#...#
#.........#
d.........l
#..#..#...#
#.........#
#.........#
#..#.....##
#####d#####

