2
0
#####D#####
#.........#
#...#...#.#
#...#.###.#
#....#.##.#
#...#.....d
#....#.#..#
#....##...#
#.........#
#.........#
#####D#####

4
0
#####D#####
#.........#
#......#..#
#....#.#.##
#...@##...#
#....#.#..D
#?.#....#.#
##.#......#
##.#......#
#.........#
#####D#####
sign Someone has been here recently.

5
3
#####D#####
#.......#.#
#.....###.#
#....####.#
#....##e..#
D..#.#e#..#
#.........#
#.........#
#.........#
#.......se#
###########
enemies 3
switch 0 : 0 1

4
3
#####D#####
#.........#
#.........#
#.........#
#.........#
d...#e....#
#....#....#
#..#...#..#
#...#.##..#
#..#......#
#####D#####
boss
enemies 1

3
3
###########
#........X#
#..#......#
###.......#
#.#.......#
D.........#
#.........#
#.........#
#.........#
#.........#
#####D#####

3
2
#####D#####
#..#......#
#.........#
#.........#
#...#.....#
D.........D
#.........#
#..#..#..##
#.........#
#.........#
#####l#####
locked : 0

4
2
#####l#####
#.........#
#..#......#
#.#.......#
#.........#
D.........d
#.........#
#.#.......#
#..#......#
#.........#
#####d#####

3
0
#####D#####
#k........#
##..#..#..#
#.........#
#.........#
#...#..#..D
#.........#
#.........#
#...#.....#
#.........#
#####D#####
key : 1

3
1
#####D#####
#k........#
#..#...#..#
#.........#
#.#.#.#.#.#
D.........D
#..#...#..#
#.........#
#...#.#...#
#.........#
#####D#####
key : 2

4
1
#####D#####
#.........#
#.#...#.#.#
#.........#
#...#...#.#
D.........D
#.#.#.#...#
#.........#
#.#...#.#.#
#.........#
#####l#####
locked : 2

1
1
###########
#.........#
#.....#.#.#
#.........#
#..#.#.#..#
d.........#
#.....#...#
#.........#
#..#...#.##
#.........#
#####D#####

5
1
#####l#####
#.........#
#.........#
#.........#
#.........#
D.........l
#.........#
#.......#.#
#......#..#
#.........#
#####D#####

6
1
#####D#####
#.........#
##.#...#.##
#.........#
#.#.#...#.#
#.........#
#....#.#..#
#.........#
#...#.#.#.#
#.........#
###########

5
2
#####d#####
#.........#
#.........#
#...##....#
#.####....#
l...##....D
#.##......#
###..#....#
#.........#
#.........#
###########
locked : 1

0
0
###########
#k........#
#......#..#
#.......#.#
#.........#
#.........#
#.........#
#.......#.#
#......#..#
#.........#
#####D#####
key : 4

2
2
###########
#.......ee#
#........?#
#.........#
#.........#
D.........#
#.........#
#.........#
#.........#
#.........#
#####D#####
enemies 2
door 0 : 0 1
sign A locked path — look elsewhere first.

2
1
#####D#####
#.#.......#
#.........#
#......#.##
#.........#
d...#.#...D
#.........#
#....#.#.##
#.........#
#.#.......#
#####D#####

5
0
#####D#####
#.........#
#.........#
#..#..##..#
#....#....#
#...#.#...D
#.###.##..#
#####.#...#
##k.......#
####......#
###########
key : 0

1
0
#####D#####
#.#.......#
#.........#
#.........#
#.#..#....#
#.........d
#.........#
#.#..#..#.#
#.........#
#.........#
#####D#####

