2
1
#####l#####
##.....#..#
#.........#
#.........#
#...#..#..#
...........
#.........#
##.....#..#
#.........#
#k........#
#####.#####
key : 0

3
0
#####.#####
#.......#.#
#.........#
#.........#
#.....#...#
#..........
#.........#
#.#..#..#.#
#.........#
#k........#
###########
key : 1

2
4
###########
#.......#.#
#.........#
#.........#
#...e#.#..#
d....###..#
#....###..#
#.........#
#.........#
#.........#
#####.#####
boss
enemies 1

2
2
###########
#.........#
##.#...#.##
#.........#
#...#...#.#
...........
#..#.#....#
#.........#
#.#.#.#.#.#
#.........#
#####l#####
locked : 4

3
1
#####.#####
#k........#
#......##.#
#.......#.#
#.........#
.......#..l
#.........#
#.........#
#.......#.#
#.........#
#####.#####
key : 2

0
0
###########
#.........#
#.#.....#.#
#.........#
#..#.#.#..#
#.........#
#.....#.#.#
#.........#
#..#...#..#
#.........#
#####.#####

1
1
###########
#.........#
#..#...#..#
#.#.....#.#
#.........#
..........#
#.........#
#.#.......#
#..#......#
#.........#
#####l#####
locked : 1

5
1
#####d#####
#.#.....#.#
#.........#
#...#...#.#
#.........#
#...#.....d
#.........#
#.#.#.#.#.#
#.........#
#.#.....#.#
#####.#####

5
2
#####.#####
#.........#
#.........#
#...#..#..#
#.........#
d.........#
#....#....#
#.........#
#.........#
#.........#
###########

3
3
#####.#####
#.........#
#......#..#
#.......#.#
#.........#
...........
#.........#
#.........#
#.........#
#....k....#
###########
key : 4

2
3
#####l#####
#e........#
#.........#
#...#.....#
#......#..#
......##..d
#..#..##..#
#.........#
#.........#
#e........#
#####.#####
enemies 2

3
2
#####l#####
#.........#
#.........#
#.........#
#.........#
l..........
#.........#
#.........#
#.........#
#.........#
#####.#####
locked : 2

1
0
#####.#####
#.........#
#...#.....#
#.###.....#
#..e###...#
#..#.......
#.........#
#.........#
#.........#
#.........#
#####.#####
enemies 1

4
1
#####.#####
#.........#
#..#..#..##
#.........#
#.........#
#......#...
#.........#
#.........#
#..#..#..##
#.........#
#####d#####

4
2
#####.#####
#.........#
#..#......#
#.#.......#
#.........#
..........#
#.........#
#.#.......#
#..#......#
#.........#
#####.#####

6
1
#####.#####
##.#...#.##
#.........#
#.#.......#
#.........#
#..#......#
#.........#
#.#.#.#...#
#.........#
##.#...#.##
###########

1
3
###########
#.........#
#..##.....#
#..#.##.#.#
#.#..#.#..#
#...#.....#
#...#..#..#
#...##..#.#
#.........#
#.........#
#####l#####
locked : 0

3
4
#####.#####
#.........#
#.........#
#....#....#
#.........#
..........#
#.........#
#.........#
#.........#
##.......X#
###########

2
0
#####.#####
#.........#
#.........#
#.#.#.....#
#..#......#
#..##@.....
#?##......#
#..#......#
#.........#
#.........#
#####.#####
sign What you seek is close.

