2
2
#####.#####
#.........#
#..#......#
#.#.......#
#.........#
..........l
#.........#
#.......#.#
#......#..#
#......k..#
###########
key : 2

1
2
###########
#.........#
#......#..#
#.....#.#.#
#.........#
#..........
#.........#
#.........#
#.........#
#.........#
#####.#####

1
3
#####.#####
#.........#
##.#......#
##........#
#.#.......#
..........d
#......#..#
#.......#.#
#.........#
#.........#
#####d#####

3
0
#####.#####
#.........#
#..#......#
#.#.......#
#.........#
#..........
#.........#
#.........#
#.........#
#.........#
#####.#####

2
1
###########
#.........#
#.........#
#....#.##.#
#....k#.#.#
.....##....
#...##.#..#
#.......###
#.........#
#.........#
#####.#####
key : 0

2
5
###########
#.........#
#..#......#
#.#.......#
#.........#
d.........#
#.........#
#.........#
#.........#
#.........#
###########

0
3
###########
#e.....##.#
##....#...#
#....#....#
#.......#.#
#......#...
#.........#
#.........#
#.........#
#.........#
#####.#####
enemies 1

5
0
#####.#####
#..#......#
#..#...#..#
#.#.....#.#
#.........#
#..#......#
#.........#
#.........#
#.........#
##........#
###########

1
0
###########
#e.......s#
#.........#
#.........#
#.........#
#.........#
#.........#
#.........#
#.........#
#..#......#
#####.#####
enemies 1
switch 0 : 0 1

4
0
#####.#####
#k........#
##.#...#.##
#.........#
#....#.#..#
#.........d
#....#.#..#
#.........#
##.#...#.##
#.........#
#####.#####
key : 1

3
1
#####.#####
#e........#
#.........#
#.........#
#.........#
.........e#
#.........#
#.........#
#...#.....#
#?........#
#####.#####
enemies 2
door 0 : 0 1
sign The brave are rewarded.

3
4
#####.#####
#.........#
#...#..#..#
##......#.#
#.........#
..........#
#.........#
#.........#
#.........#
#.........#
###########

1
4
#####.#####
#.........#
#.........#
#.........#
#..##.....#
d...e#....#
#..#.#....#
#.........#
#.........#
#.........#
#####.#####
boss
enemies 1

2
0
#####.#####
#.........#
#.........#
#.........#
#.........#
#....@.....
#.........#
#.........#
#.........#
#.........#
#####.#####

4
1
#####.#####
#.........#
#.........#
#.........#
#.........#
d...#.....#
#.##......#
#..##.....#
#.###.....#
##........#
###########

2
3
#####d#####
#.........#
#......#..#
#.......#.#
#.........#
l..........
#.........#
#.......#.#
#......#..#
#.........#
#####l#####
locked : 0

3
3
#####l#####
#.........#
#.........#
##.#..#...#
#.........#
#..#.......
#.........#
#.........#
#........##
#.........#
###########
locked : 3

0
4
###########
#........X#
#...#.#...#
#...##....#
#.........#
.......#..#
#.........#
#.......#.#
#.........#
#.........#
#####.#####

2
4
#####.#####
#k........#
#..#...#..#
#.#.....#.#
#.........#
..........d
#.........#
#.#.......#
#..#......#
#.........#
#####.#####
key : 3

