4
0
#####.#####
#.........#
#..#...#..#
#.#.....#.#
#.........#
#..........
#.........#
#.........#
#.........#
#.........#
#####.#####

3
2
#####.#####
#k........#
#.........#
#.........#
#.........#
..........d
#.........#
#.#.......#
#..#......#
#.........#
#####.#####
key : 0

2
2
#####.#####
#.........#
#.........#
#.........#
#.........#
...........
#.........#
#.........#
#.........#
#.........#
#####.#####

1
3
###########
#........X#
#.........#
#.........#
#.........#
..........#
#.........#
#.........#
#.........#
#.........#
#####.#####

1
1
#####.#####
#.........#
#.....#..##
#.........#
#.........#
#...#..#...
#.........#
#.........#
#..#..#..##
#.........#
#####d#####

3
4
###########
#........k#
#..#......#
#.#.......#
#.........#
..........#
#.........#
#.........#
#.........#
#.........#
###########
key : 3

4
1
#####.#####
#.........#
#.........#
##..#..#..#
#.........#
...........
#.#..#..#.#
#.........#
#.........#
##?...e#..#
###########
enemies 1
sign Something glints behind that door…

0
1
###########
#s........#
#?........#
#.........#
#.........#
#..........
#.........#
#.#.....#.#
#..#...#..#
#.........#
#####.#####
switch 0 : 0 1
sign Many have walked this path.

2
3
#####.#####
#.........#
#.........#
#....#....#
#...##....#
.....e....#
#.........#
#.........#
#.........#
#.........#
#####d#####
boss
enemies 1

3
1
#####.#####
#.........#
#.........#
#.#.....#.#
#.........#
...........
#..#..#...#
#.........#
#.........#
#e#.....#e#
#####.#####
enemies 2

1
2
#####.#####
#........e#
#.....#..##
#.........#
#.........#
....#..#...
#.........#
#.........#
#..#..#..##
#........?#
#####.#####
enemies 1
sign Many have walked this path.

3
0
###########
#.........#
##.#...#.##
#.........#
#..#.#.#..#
#..........
#..#.#.#..#
#.........#
#......#.##
#.........#
#####.#####

4
3
#####.#####
##........#
#..#......#
##.#......#
#..##.#...#
....#.....#
#..####...#
#.....#...#
#..#...#..#
#.........#
###########

0
2
###########
#..#....e##
#.........#
#.........#
#..#......#
..........#
#.........#
#..#..#..##
#.........#
#.........#
#####.#####
enemies 1
door 0 : 0 1

6
0
#####d#####
#.........#
#..#......#
#.#.......#
#.........#
#.........#
#.........#
#.#.....#.#
#..#...#..#
#.........#
###########

5
0
#####.#####
#..#......#
#.........#
#...#..#..#
#...###?..#
#....@##..#
#...#..#..#
#......##.#
#.........#
#.........#
#####d#####
sign The dungeon remembers all who enter.

2
1
#####d#####
#........k#
#........##
#.........#
#....#.#..#
#..........
#..#.#....#
#.........#
#......#.##
#.........#
#####.#####
key : 1

3
3
#####d#####
#.........#
#.........#
#.........#
#.........#
d..........
#.........#
#.#.....#.#
#..#...#..#
#.........#
#####.#####

4
2
#####.#####
#.........#
#..#......#
#.#.......#
#.........#
...........
#.........#
#.#.......#
#..#......#
#..k......#
###########
key : 2

