4
0
#####d#####
#.........#
#.........#
#.........#
#.........#
#.........#
#.........#
#.........#
#.........#
#.........#
###########

3
4
#####D#####
#.........#
##.....#.##
#.........#
#.#.#.#.#.#
d.........#
#..#.#.#..#
#.........#
#.#.#.#.#.#
#.........#
###########

3
0
#####D#####
#.........#
#..#......#
#k#.......#
#.........#
#.........l
#.........#
#.......#.#
#......#..#
#.........#
#####d#####
key : 1

2
0
#####D#####
#.........#
#.........#
#.....#...#
#.#.......#
#..#.@....D
#..#......#
#.........#
#.........#
#.........#
#####D#####

4
3
#####l#####
#.........#
#.........#
#..##.....#
#..###....#
D..###....#
#...###...#
#.........#
#.........#
#.........#
###########
locked : 0

1
1
###########
#.........#
#.........#
#.##......#
#.#.#.....#
D...#.....D
#.........#
#.........#
#.........#
#.........#
#####D#####

1
2
#####D#####
#.#.......#
#..#..#...#
#.###.....#
#.###.#...#
D..####...D
#.........#
#.........#
#.........#
#.........#
#####D#####

2
1
#####D#####
#.........#
#.#.......#
#.........#
#.........#
D.........D
#.........#
#.........#
#.........#
#.........#
#####D#####

0
2
###########
#e........#
#?........#
#.........#
#.........#
#.........D
#.........#
#.........#
#.........#
#.........#
#####D#####
enemies 1
sign Beware what lurks ahead.

0
3
###########
#........X#
#.........#
#.........#
#.........#
D.........#
#.........#
#.........#
#.........#
#.........#
#####D#####

3
1
#####D#####
#.........#
#.........#
#.........#
#.........#
l.........d
#.........#
#.#.....#.#
#..#...#..#
#.........#
###########
locked : 1

4
2
#####D#####
##.#...#.##
#.........#
#...#...#.#
#.........#
#..#.#.#..D
#.........#
#...#.....#
#.........#
##.....#.##
###########

1
0
###########
#k#.....#.#
#.........#
#.#.#.#...#
#.........#
#...#.#...D
#.........#
#.#...#...#
#.........#
#.#.....#.#
#####D#####
key : 0

2
2
#####D#####
#.........#
#.........#
#..#..#..##
#.........#
D.........d
#...#.....#
#.........#
#.........#
#..#......#
#####l#####
locked : 3

3
2
#####l#####
#........##
#......#..#
#.#.....#.#
#.........#
d.........D
#.........#
#.........#
#.#.......#
#.........#
#####D#####

1
3
#####D#####
#.........#
#.........#
##..#.....#
#.........#
D........e#
#...#..#..#
#.........#
#.........#
##.....#..#
#####D#####
enemies 1

3
3
#####D#####
#.........#
#.........#
#.....#...#
#.........#
D.........d
#.........#
#.......#.#
#...#..#k##
#.........#
#####l#####
key : 3

2
4
###########
#........k#
#.........#
#.........#
#.........#
D.........#
#.........#
#.........#
#.........#
#.........#
#####D#####
key : 6

2
3
#####D#####
#.........#
#.........#
#.........#
#.........#
d....e....D
#.........#
#.........#
#.........#
#.........#
#####D#####
boss
enemies 1

