5
0
#####d#####
#.........#
#.........#
#.........#
#.........#
#..........
#.........#
#.......#.#
#......#..#
#.........#
###########

5
1
#####.#####
#.........#
#..#......#
#.#.......#
#.........#
.........k#
#.........#
#.#.......#
#..#......#
#.........#
#####.#####
key : 1

3
1
#####.#####
#e........#
#.........#
#.........#
#.........#
...........
#.........#
#.........#
#.........#
#e........#
#####.#####
enemies 2

3
2
###########
#.........#
#.........#
#.#.....#.#
#.........#
...........
#....#..#.#
#.........#
#.........#
#.........#
#####.#####

2
0
#####l#####
#k........#
##.......##
#.........#
#.#.#.#.#.#
#..........
#..#......#
#.........#
#.#...#.#.#
#.........#
#####.#####
key : 0

0
0
###########
#.........#
##..#..#..#
#.........#
#.........#
#....#....#
#.........#
#.........#
##..#..#..#
#.........#
#####d#####

5
3
#####l#####
#.........#
#.......#.#
#.........#
#.........#
#....#....#
#.........#
#.........#
#.........#
#.........#
###########
locked : 3

4
4
###########
#........e#
#.........#
#.........#
#.........#
....#.##..#
#..#..#...#
#...##....#
#.....##..#
#..#.....?#
###########
enemies 1
sign The brave are rewarded.

3
0
#####.#####
#.........#
#.#.#.#...#
#.........#
#...#.#.#.#
#..........
#.#...#.#.#
#.........#
#...#.#.#.#
#.........#
#####.#####

1
0
#####d#####
##.....#.##
#.........#
#.#...#...#
#.........#
#..#.#.#...
#.........#
#.#.#...#.#
#.........#
##.....#.##
#####l#####
locked : 2

4
1
#####.#####
#.........#
#.#.....#.#
#.........#
#.#.#.#...#
..........l
#...#.#.#.#
#.........#
#.#...#.#.#
#.........#
#####.#####

3
3
#####.#####
#..#......#
#.........#
#..#.##...#
#......#..#
.....e....#
#.........#
#.........#
#.........#
#.........#
#####d#####
boss
enemies 1

2
1
#####d#####
#.........#
#..#......#
#.#.......#
#.........#
.........k#
#.........#
#.#.......#
#..#......#
#.........#
#####.#####
key : 2

4
2
#####.#####
#.........#
#.#.#.#...#
#.........#
#.#...#.#.#
l..........
#...#.#.#.#
#.........#
#.#.#.#...#
#.........#
###########
locked : 0

4
0
#####.#####
#.......#.#
#.....##..#
#.....#...#
#.........#
#....@.....
#.#.#.....#
#.#.#.....#
#.........#
#.........#
#####d#####

2
3
###########
####......#
##X##.....#
#....#....#
#..#.#....#
#.........#
#.........#
#.........#
#.........#
#.........#
#####.#####

4
3
#####d#####
#k........#
#.........#
#.........#
#.........#
...#.......
#.........#
#.........#
#.#.....#.#
#.........#
#####l#####
key : 3

1
1
###########
#.........#
#..#......#
#.#.......#
#.........#
..........#
#.........#
#.........#
#.........#
#.........#
#####d#####

6
1
#####.#####
#..#...#.##
#.........#
#...#.#.#.#
#.........#
#..#...#..#
#.........#
#.#.#...#.#
#.........#
##.#.....##
###########

