5
2
#####D#####
#.#.......#
#..#......#
#.#.......#
#...#.....#
d.........#
#.........#
#.#.....#.#
#..#...#..#
#.........#
#####D#####

6
1
#####D#####
####......#
#k#.......#
#.##.....##
#..###.#..#
#...###...l
#.....#.#.#
#....####.#
#.....#.#.#
#.........#
#####D#####
key : 4

7
1
#####D#####
#.........#
#.........#
#.........#
#.........#
#.........D
#.........#
#.#.......#
#..#......#
#k........#
###########
key : 5

6
2
#####D#####
#.........#
#.........#
#.........#
#...##....#
l...#e##..#
#...#..##.#
#....#.##.#
#...#....##
#.........#
#####D#####
locked : 5
boss
enemies 1

7
2
#####D#####
#......##.#
#......##.#
#.....#.#.#
#....#....#
D.........#
#.........#
#.........#
#.........#
#........X#
###########

4
0
#####D#####
#......##.#
#.....###.#
#......##.#
#.......#.#
#.........D
#.........#
#.........#
#.........#
#k........#
###########
key : 0

3
1
###########
#.........#
#.##......#
#...##....#
#.####....#
D..#.##...D
#.#.....p.#
#.........#
#####...p.#
#.........#
#####d#####

1
2
#####l#####
#e........#
###.#..#..#
#e##......#
#.........#
#.........l
#e###.....#
#.........#
#.........#
#.........#
#####D#####
enemies 3

1
3
###########
##.#...#.##
#.........#
#..#.#.#..#
#.........#
l..#.#....#
#.........#
##.#...#..#
#.........#
##.#.....##
###########
locked : 1

4
2
#####D#####
#.........#
#..#......#
#.#.......#
#.........#
l.........#
#.........#
#.......#.#
#......#..#
#.........#
#####D#####
locked : 0

3
0
#####D#####
#........##
#..#.....##
#....#.#..#
#..#@###..#
#..#.###..D
#.....##..#
#.........#
#.........#
#.........#
#####D#####

0
2
###########
#.........#
#.........#
#.........#
#.........#
#.........#
#.........#
#.......#.#
#......#..#
#.........#
#####l#####
locked : 4

3
2
#####D#####
#.........#
#.........#
#.........#
#.........#
D........k#
#.........#
#.........#
#.........#
#.........#
#####D#####
key : 1

4
1
#####d#####
#.........#
#..#......#
#.#.......#
#.........#
D.........l
#.........#
#.#.....#.#
#..#...#..#
#.........#
#####d#####

2
2
#####D#####
#.........#
#.........#
#.........#
#.........#
#.........#
#.........#
#.#.......#
#..#......#
#.........#
#####D#####

2
0
###########
#.........#
#.#...#.#.#
#.........#
#...#.#.#.#
#.........#
#.#.#.#.#.#
#.........#
#.#.#.#.#.#
#.........#
#####D#####

5
1
#####d#####
#.........#
#.....#..##
#....#.####
#....#..#.#
#.....#...d
#....####.#
#....##.###
#.....#...#
#.........#
#####D#####

