5
1
###########
#.........#
#.....#...#
#.........#
#.........#
d.........#
#.........#
#.........#
#.........#
#.........#
###########

1
3
#####D#####
#.........#
#.#.......#
#####.....#
#..###e...#
#..###....D
#.####....#
#.........#
#.........#
#.........#
#####d#####
boss
enemies 1

3
3
#####l#####
#k........#
#..#......#
#.#.......#
#.........#
D.........D
#.........#
#.......#.#
#......#..#
#.........#
#####D#####
key : 2

2
0
###########
#.........#
#..#......#
#.#.......#
#.........#
#.........#
#.........#
#.#.......#
#..#......#
#.........#
#####D#####

5
3
#####D#####
#.......#.#
#.........#
#.#.#.#...#
#.........#
#...#.....#
#.........#
#s#.#.#.#.#
#.........#
#e......#e#
###########
enemies 2
switch 1 : 2 3

3
4
#####D#####
#s#.....#.#
#.........#
#....#....#
#.........#
D.....#...#
#.........#
#....#.#..#
#........e#
#......e#e#
###########
enemies 3
switch 0 : 0 1

3
0
#####D#####
#.........#
#.........#
#.........#
#.........#
#?...@....D
#.........#
#.........#
#.........#
#.........#
#####D#####
sign Someone has been here recently.

5
0
#####D#####
#.........#
#..#......#
#k#.......#
#.........#
#.........d
#.........#
#.........#
#.........#
#.........#
#####d#####
key : 1

0
3
###########
#X........#
#.........#
#.........#
#.........#
#.........#
#.........#
#.........#
#.........#
#.........#
#####D#####

2
3
#####d#####
#.........#
#.........#
#.........#
#.........#
D.........D
#.........#
#.......#.#
#......#..#
#.........#
#####l#####
locked : 2

3
1
###########
#.........#
#.........#
#.........#
#.........#
D.........D
#.........#
#.........#
#.........#
#.........#
###########

4
0
#####D#####
#..#...#.##
#.........#
#k#.#.#.#.#
#.........#
#....#.#..#
#.........#
#.#.#...#.#
#.........#
##.....#..#
#####D#####
key : 0

3
2
#####d#####
#.........#
#..#......#
#.#......##
#.........#
D.........D
#.........#
#.##......#
#..#.....##
#.........#
###########

4
3
#####D#####
#.........#
#e........#
##.#......#
#e........#
#e........#
#.........#
#.........#
#.........#
#.........#
#####D#####
enemies 3
door 0 : 0 1

2
4
#####D#####
#.##......#
#.###.....#
#.#.#.....#
#.#..#....#
D...##....#
#.........#
#.........#
#.........#
#.........#
#####D#####

6
0
#####d#####
#.........#
#.........#
#.........#
#.........#
#.........#
#..##.....#
#..#......#
#.##....#.#
#.........#
###########

2
2
###########
#.........#
#.........#
#.........#
#.........#
#.........D
#.........#
#.......#.#
#......#..#
#.........#
#####d#####

1
4
###########
##k#...#.##
#.........#
#..#.#.#.##
#.........#
D..#.#....D
#.........#
#....#.#.##
#.........#
##.#.....##
#####D#####
key : 4

1
5
###########
#........e#
#.........#
#.........#
#.........#
D...#.....#
#.........#
#....#....#
#.........#
#.......e##
###########
enemies 2
door 1 : 2 3

