4
1
#####.#####
#e........#
##e#...#..#
#.........#
#.#.#.#.#.#
...........
#..#s#?#..#
#.........#
#...#...#.#
#e........#
#####.#####
enemies 3
switch 0 : 0 1
sign The dungeon remembers all who enter.

1
2
#####d#####
#.........#
#.........#
##..#..#..#
#.........#
...........
#......#..#
#.........#
#.........#
##.....#..#
#####.#####

0
1
###########
#.........#
#......#..#
#.......#.#
#.........#
...........
#.........#
#.........#
#.........#
#.........#
#####.#####

3
1
#####.#####
#.........#
#.........#
#.........#
#.........#
d..........
#.........#
#.........#
#.........#
#.........#
#####.#####

1
1
#####.#####
#.........#
##.#...#.##
#.........#
#.#.....#.#
l..........
#....#.#..#
#.........#
#.#.#.#.#.#
#.........#
#####d#####
locked : 0

2
1
#####d#####
#.........#
##.#...#.##
#.........#
#...#.#.#.#
...........
#..#.#.#..#
#.........#
#.#.#.#.#.#
#.........#
#####.#####

0
2
###########
#.........#
#.........#
#.........#
#.........#
..........#
#.........#
#.#.......#
#..#......#
#.........#
#####d#####

1
0
#####.#####
#.........#
#.....###.#
#..#k####.#
#..#####..#
#....###..l
#.....#.#.#
#.........#
#.........#
#.........#
#####.#####
key : 0

5
0
#####.#####
#.......#.#
#.........#
#.........#
#.####....#
#..#.#.....
#.##.#.#..#
#.........#
#.........#
#X........#
###########

4
0
#####d#####
##........#
#.##......#
#.##......#
#.........#
#....e.....
#....##...#
#.........#
#.....#...#
#.........#
#####.#####
boss
enemies 1

0
0
###########
#.........#
#.........#
#.........#
#.........#
#....@.....
#.........#
#.........#
#.........#
#.........#
#####.#####

2
2
#####.#####
#.........#
#.........#
#....###..#
#.....##..#
.....##...#
#....#....#
#.........#
#.#.......#
#.........#
#####.#####

4
2
#####.#####
#......#..#
#.....###.#
#......#..#
#.........#
..........#
#.........#
#.........#
#........e#
#.......ee#
###########
enemies 3

3
0
#####l#####
##.#...#..#
#.........#
##.#.#.#.##
#.........#
#..#.#....d
#.........#
#..#.#...##
#.........#
##.#.....##
#####d#####
locked : 1

1
3
###########
#.........#
#.........#
#.........#
#.........#
..........#
#.........#
#.........#
#.........#
#.........#
###########

3
3
###########
#........k#
#..#......#
#.#.......#
#.........#
..........#
#.........#
#.#.......#
#..#......#
#.........#
###########
key : 4

5
1
#####.#####
#.........#
#.........#
#....#..#.#
#.........#
..........#
#..#......#
#.........#
#.........#
#.#.....#e#
###########
enemies 1
door 0 : 0 1

2
0
#####.#####
#.........#
#.........#
#.........#
#.........#
#..........
#.........#
#k#.....#.#
#..#...#..#
#.........#
#####l#####
key : 1

3
2
#####.#####
#k........#
#.........#
#.........#
#.........#
...........
#.........#
#.........#
#.........#
#.........#
#####.#####
key : 3

