1
2
#####l#####
#.........#
#.........#
#........##
#.........#
D....#....l
#....##...#
#.......###
#.........#
#.........#
#####D#####

3
2
#####D#####
##.....#..#
#.........#
#.#.#...#.#
#.........#
D..#.#....d
#.........#
#.#.#.#...#
#.........#
##.#......#
#####D#####

4
4
###########
#........X#
#.........#
#.#.......#
#.........#
D.........#
#.........#
#.........#
#.........#
#.........#
###########

2
2
#####D#####
#.........#
#......#..#
#.......#k#
#.........#
D.........#
#.........#
#.#.......#
#..#......#
#.........#
#####D#####
key : 3

5
2
#####D#####
#..#...#.##
#.........#
#.#.#.#.#.#
#.........#
D..#...#..D
#.........#
#.#...#...#
#.........#
##.....#.##
###########

3
3
###########
#.........#
#.........#
#.........#
#.........#
d.........#
#.........#
#.......#.#
#......#..#
#.........#
#####D#####

0
2
###########
#.........#
#.........#
#.........#
#.........#
#..#......#
#..#.#....#
#.######..#
#.#.#.#...#
#.........#
#####l#####
locked : 0

1
3
###########
#.........#
#......#..#
#.......#.#
#.........#
l.........#
#.........#
#.......#.#
#......#..#
#.........#
###########
locked : 3

3
1
#####l#####
#.........#
##.....#.##
#.........#
#.#...#.#.#
D.........D
#..#.#.#..#
#.........#
#.#.#.#.#.#
#.........#
#####d#####
locked : 2

2
1
#####l#####
##........#
#.........#
#.........#
#.......#.#
D.........D
#.........#
#.........#
#.........#
#k........#
#####l#####
key : 2

5
1
#####D#####
#.........#
#...#..#..#
#.........#
#.........#
#...#..#..D
#.........#
#.........#
#...#..#..#
#e.?s.....#
###########
enemies 1
switch 0 : 0
sign Beware what lurks ahead.

1
0
###########
#k........#
#.........#
#.........#
#.........#
#.........D
#.........#
#.........#
#.........#
#.........#
#####D#####
key : 1

3
0
#####D#####
###.......#
#...#.....#
#..#.#....#
#..#......#
#..##.....D
#.........#
##........#
#.........#
#k........#
###########
key : 0

2
0
#####D#####
#.........#
#.........#
#.........#
#.........#
#....@....D
#.........#
#.........#
#.........#
#.........#
#####D#####

4
3
#####D#####
#.........#
#.........#
#.........#
#.........#
d....e....D
#.........#
#.........#
#.........#
#.........#
#####D#####
boss
enemies 1

5
3
#####D#####
#.........#
#.........#
#.........#
#...p.....#
D...#.....#
#.##......#
#.#?#.....#
#........e#
#.......ee#
###########
enemies 3
door 0 : 0
sign The dungeon remembers all who enter.

1
1
###########
#.........#
#..#......#
#.#.......#
#.........#
D.........D
#.#.......#
#...#.....#
#.........#
#.........#
#####l#####
locked : 1

4
2
#####D#####
##.......##
#.........#
#.#.#.#.#.#
#.........#
D..#.#....d
#.........#
#.#.#.#.#.#
#.........#
##.#...#.##
#####D#####

4
1
#####d#####
#.........#
#.........#
#.........#
#.........#
#.........D
#.........#
#.........#
#.........#
#.........#
#####D#####

