2
0
#####.#####
#.........#
##..#..#..#
#.........#
#.........#
#..........
#.........#
#.........#
#......#..#
#.........#
#####d#####

9
0
#####d#####
#.........#
#.........#
#.....#.#.#
#.........#
#....e....#
#.........#
#.........#
#.........#
#.........#
#####.#####
boss
enemies 1

3
1
#####.#####
#.........#
#......#..#
#.......#.#
#.........#
..........d
#.........#
#.#.....#.#
#..#...#..#
#.........#
#####l#####

0
0
###########
#k........#
#.........#
#.........#
#.........#
#...#.#....
#....#....#
#....##...#
#.........#
#.........#
#####.#####
key : 0

10
0
#####.#####
#.........#
#.........#
#....##...#
#....##...#
#.....##..#
#....###..#
#.........#
#.........#
#X........#
###########

5
0
#####.#####
#.........#
#..#......#
#.#.......#
#.........#
#..........
#.........#
#.........#
#.........#
#.........#
#####.#####

4
0
#####.#####
##.#...#..#
#.........#
#..#.#.#..#
#.........#
#..#...#...
#.........#
##.#.#.#.##
#k........#
##.......##
#####.#####
key : 1

4
1
#####l#####
#......#..#
#.....###.#
#....###..#
#....#..#.#
..........#
#....##...#
#.........#
#..#......#
#.........#
#####.#####
locked : 1

3
0
#####d#####
#.........#
#..#......#
#..#.#....#
#..#......#
#..##......
#.........#
#.........#
#.###.....#
#.........#
#####.#####

3
2
###########
#.........#
#..#......#
#.#.......#
#.........#
d.........#
#.........#
#.#.......#
#..#......#
#.........#
###########

2
1
#####.#####
#.........#
#.........#
#.........#
#.........#
..........#
#.........#
#.........#
#.........#
#.........#
#####.#####

1
0
#####.#####
#..#......#
#..#......#
#..###.#..#
#..#####..#
#...@#.....
#.........#
##........#
##........#
#.........#
#####.#####

6
0
#####.#####
#?........#
#......#..#
#.........#
#.........#
#e........d
#..#......#
#.........#
#.........#
#.........#
#####.#####
enemies 1
sign What you seek is close.

6
1
#####.#####
#.........#
#.........#
#.........#
#.........#
d..#.#....#
#.#####...#
#.#.###...#
#.#.#.#...#
#.........#
###########

8
0
#####.#####
#.........#
##..#..#..#
#.........#
#.........#
#.........#
#.........#
#.........#
##..#..#..#
#.........#
#####d#####

1
1
#####l#####
#......##.#
#......##.#
#.....###.#
#......#..#
.......#..#
#.....###.#
#.........#
#.........#
#.........#
#####.#####

5
1
#####.#####
#.........#
#......#..#
#.......#k#
#.........#
..........#
#.........#
#.........#
#.........#
#.........#
#####.#####
key : 2

0
1
###########
#.........#
#.........#
#.........#
#...#..#..#
..........#
#.........#
##.....#..#
#.........#
#.........#
#####l#####
locked : 0

7
0
#####.#####
#........##
#......#..#
#.......#k#
#.........#
#.........#
#.........#
#.......#.#
#......#..#
#.........#
#####.#####
key : 3

