1
4
###########
#........X#
#.........#
#.........#
#.........#
D....#....#
#....#....#
#....##...#
#.........#
#.........#
###########

3
1
#####D#####
#.........#
##.#...#.##
#.........#
#...#.#.#.#
#.........#
#......#..#
#.........#
#.#.#...#.#
#.........#
#####D#####

4
1
#####D#####
#.........#
#.#.....#.#
#.........#
#.........#
D..#..#...#
#.........#
#.........#
#.........#
#.........#
#####d#####

0
3
###########
#e.......e#
#?........#
#.........#
#.........#
#.........#
#.......#.#
#.....#.#.#
#......#..#
#.........#
#####D#####
enemies 2
door 0 : 0
sign Many have walked this path.

1
2
###########
#.........#
#.........#
##...#....#
#..#.#....#
D..##.....D
#.##......#
#....#....#
#.........#
#.........#
#####d#####

0
1
###########
#.........#
##..#.....#
#.........#
#.........#
#.........#
#.........#
#.........#
##..#..#..#
#.........#
#####l#####
locked : 2

4
0
###########
#.........#
#.........#
#.........#
#.........#
#.........D
#.........#
#.........#
#.........#
#.........#
#####D#####

5
0
#####D#####
#.........#
#.#.#.....#
#.###.....#
#.........#
#..p.@....D
#.........#
#p........#
#.........#
#.........#
#####D#####

2
1
#####D#####
#k#.......#
#..#...#..#
#.#.....#.#
#.......#.#
#.........l
#.........#
#.#.......#
#..#......#
#.........#
#####D#####
key : 1

2
3
#####d#####
#.........#
#.........#
#.........#
#.........#
d...##....#
#..#.#....#
#..#.#....#
#.........#
#.##......#
#####D#####

3
3
#####D#####
#.........#
#.........#
#.........#
#.........#
#.........#
#.........#
#.........#
#.........#
#k........#
###########
key : 5

7
0
#####l#####
#.#.....#.#
#.........#
#.#.....#.#
#.........#
#...#.....#
#.........#
#.#.#.#...#
#.........#
#.#.....#.#
###########
locked : 0

5
1
#####d#####
#......#..#
#..#...#..#
#.....#.#.#
#.........#
D.........D
#.........#
#.......#.#
#......#..#
#.........#
#####D#####

5
2
###########
#........k#
#.........#
#.........#
#.........#
D.........#
#.........#
#.#.......#
#..#......#
#.........#
###########
key : 0

6
1
#####D#####
#.........#
#.........#
#........##
#.........#
D.........#
#.........#
#.#.#.....#
#..#......#
#.......#.#
###########

1
1
#####l#####
#.........#
#..#......#
#.#.......#
#k#.......#
#.........D
#.........#
#.......#.#
#......#..#
#.........#
#####D#####
key : 2

1
3
#####D#####
#.........#
#.........#
#.........#
#.........#
D...#e#...D
#.........#
#....p....#
#.........#
#.........#
#####d#####
boss
enemies 1

2
2
#####d#####
#.........#
#...#.#.#.#
#.........#
#.#...#.#.#
l.........d
#.#.#.#...#
#.........#
#.#.#.#.#.#
#.........#
###########
locked : 1

6
0
#####D#####
#?........#
#s###.....#
#e###.....#
#e###.....#
#..e#.....D
#.........#
#.........#
#.........#
#.........#
#####l#####
enemies 3
switch 0 : 0
sign This door will not yield without a key.

