0
1
###########
#.#.....#.#
#.........#
#..#.#.#.##
#.........#
#.....#...#
#.........#
#..#.#.#.##
#.........#
#.#.......#
#####l#####
locked : 0

3
2
#####D#####
#e.......e#
##..#..#..#
#.........#
#.........#
D...#..#..D
#.........#
#.........#
##..#..#..#
#e.......?#
#####d#####
enemies 3
sign Beware what lurks ahead.

3
3
###########
##.#.....##
#.........#
#.......#.#
#.........#
D....#....d
#.........#
#.#...#.#.#
#.........#
##.#...#.##
#####D#####

4
2
#####d#####
#.........#
#.........#
#.........#
#.........#
D.........D
#.........#
#.......#.#
#......#..#
#.........#
#####D#####

3
0
#####D#####
#.........#
#.#...#...#
#.........#
#....#.#..#
#.........D
#.#.#.#.#.#
#.........#
#..#...#.##
#.........#
###########

2
1
#####D#####
#?........#
#.........#
#.........#
#.........#
D.........d
#..#......#
#.#e#.....#
#.#.#.....#
#.........#
#####D#####
enemies 1
sign The brave are rewarded.

5
1
#####D#####
#.........#
#p....p...#
#.........#
#.....#...#
#.....##..D
#.....#...#
#......##.#
#......####
#.........#
###########

4
3
#####D#####
#k........#
#.........#
#....###..#
#.........#
D.........D
#.........#
#.........#
#.........#
#.........#
#####D#####
key : 3

4
4
#####D#####
#.........#
#......#..#
#.......#.#
#.........#
D.........#
#....#....#
#.#.......#
#..#.....##
#........k#
###########
key : 4

2
0
###########
##.#......#
##........#
#.#.......#
#..##.....#
#....@.#..D
#.....##..#
#.....#.#.#
#.........#
#.........#
#####D#####

5
2
#####D#####
#.........#
#.........#
#.........#
#..#.#....#
D..#k#....D
#..##.....#
#.........#
#.........#
#.........#
###########
key : 1

2
4
###########
#X........#
#.........#
#.........#
#.........#
#.........#
#.........#
#.........#
#.........#
#.........#
#####D#####

5
3
#####D#####
#.........#
#.#.#.#.#.#
#.........#
#..#.#....#
D.........#
#.#...#.#.#
#.........#
#..#...#..#
#........e#
###########
enemies 1

1
2
###########
#.#.....#.#
#.........#
#.#...#...#
#.........#
d.....#...#
#.........#
#.#...#.#.#
#.........#
#.#.......#
#####D#####

2
2
#####D#####
#.........#
#......#.##
#.........#
#..#...#..#
d.........#
#....#.#..#
#.........#
##.#...#.##
#.........#
#####D#####

4
1
#####D#####
#.........#
#.........#
#..#......#
#.........#
#....#....D
#.........#
#.........#
#.........#
#.........#
#####D#####

3
1
#####D#####
#.........#
#.#.......#
#.........#
#.........#
D..#......D
#.........#
#.........#
#.#.....#.#
#.........#
#####D#####

1
1
#####l#####
##........#
#k........#
#.........#
#.........#
#.........d
#.........#
#.........#
#.........#
#......#..#
#####D#####
key : 0

3
4
#####D#####
#.........#
#.#.......#
#.........#
#.###e....#
d..###....#
#...##....#
##.####...#
#..##..#..#
#..#...#..#
#####D#####
boss
enemies 1

