2
3
#####D#####
#.........#
#.#.....#.#
#.........#
#.........#
d.........d
#.........#
#.........#
#.......#.#
#.........#
#####D#####

3
0
#####D#####
#.........#
#...#.#...#
#...#.#...#
#...####..#
#..####...D
#...@##...#
#.........#
#.........#
#?........#
###########
sign What you seek is close.

1
3
###########
#........k#
#..#......#
#.#.......#
#.........#
D.........#
#.........#
#.........#
#.........#
#.........#
#####D#####
key : 2

0
1
###########
#......#..#
#...#.#...#
#.....##..#
#...#...#.#
#....#....D
#.........#
#.........#
#.........#
#.........#
#####d#####

3
4
#####d#####
#.........#
#.........#
#.........#
#.........#
D....e....#
#.........#
#.........#
#.........#
#.........#
#####D#####
boss
enemies 1

4
4
#####D#####
#.........#
#.........#
#.........#
#.........#
#.........#
#.........#
#.........#
#.........#
#X........#
###########

3
1
#####D#####
#k#.....#.#
#.........#
#..#.#...##
#.........#
D...#.....D
#.........#
#..#.#...##
#.........#
#.#.....#.#
#####D#####
key : 1

4
1
#####D#####
#.........#
#..##.....#
#..##.....#
#.###.....#
#..#......D
#.##......#
#####.....#
#...#.....#
#.........#
###########

1
1
#####d#####
#.........#
#..#......#
#.#.......#
#.........#
D.........D
#.......#.#
#.#.......#
#..#......#
#.........#
#####l#####
locked : 1

0
2
###########
#......##k#
#......##.#
#....####.#
#......#..#
D...####..#
#.........#
#.........#
#.........#
#.........#
#####D#####
key : 4

3
2
#####D#####
##.#...#.##
#.........#
#.#.#.#.#.#
#.........#
D..#.#.#..D
#.........#
#...#.#.#.#
#.........#
##.#.....##
#####D#####

2
1
#####l#####
#.........#
##.#.....##
#.........#
#...#.#.#.#
D.........l
#..#......#
#.........#
#.#.#.....#
#.........#
#####D#####

4
2
#####D#####
#.........#
#......#..#
#.......#.#
#.........#
D....#....#
#.....#...#
#.#.....#.#
#.##...#..#
#.........#
###########

2
0
#####D#####
#.........#
#.........#
#.........#
#.........#
#k........D
#.........#
#.........#
#.........#
#.........#
#####D#####
key : 0

3
3
#####D#####
#.........#
#......#..#
#.........#
#.........#
D....#....D
#.........#
#.........#
#.........#
#.........#
###########

1
2
#####D#####
###.......#
#..##.....#
##.##.#...#
#.........#
D..####...D
#.........#
#.........#
#.........#
#.........#
#####D#####

2
4
###########
##.....#..#
#.........#
#.........#
#.#..#..#.#
d.........#
#.........#
##..#..#..#
#.........#
#.........#
#####d#####

1
0
###########
#e........#
#.........#
#..#......#
#.........#
#.........D
#..#......#
#.........#
#.........#
#.........#
#####D#####
enemies 1

2
2
#####D#####
#.........#
#.#.....#.#
#.........#
#.#...#.#.#
l.........d
#.#.#.#.#.#
#.........#
#.#.#.#.#.#
#.........#
#####D#####
locked : 0

