3
2
#####d#####
#.........#
#.........#
#.........#
#.........#
..........#
#.........#
#.........#
#.........#
#.........#
###########

4
1
#####.#####
#.........#
#.........#
#.........#
#.........#
#.........#
#.........#
#.......#.#
#......#..#
#k........#
###########
key : 2

0
2
###########
#.........#
#.........#
#.........#
#.........#
#.........#
#.........#
#.........#
#.........#
#.........#
#####d#####

2
3
#####.#####
#.........#
#.........#
#.........#
#.........#
...........
#.........#
#.........#
#.........#
#.........#
###########

2
2
#####.#####
#.........#
#.........#
#.........#
#.........#
d..........
#.........#
#.#.....#.#
#..#...#..#
#.........#
#####d#####

3
0
#####.#####
#.........#
#..#.....##
#.........#
#.........#
#..#..#....
#.........#
#.........#
#.....#..##
#k........#
###########
key : 1

2
4
#####.#####
#e#.....#e#
#.........#
#.........#
#.......#.#
...........
#.........#
#.#..#....#
#.........#
#?...e....#
###########
enemies 3
sign The dungeon remembers all who enter.

1
6
###########
#........k#
#..#..#..##
#.........#
#.........#
....#..#..#
#.........#
#.........#
#.....#...#
#.........#
###########
key : 3

1
3
###########
#.........#
#.........#
#.#..#..#.#
#.........#
...........
#.#..#..#.#
#.........#
#.........#
#.#.....#.#
#####.#####

3
1
#####l#####
#.........#
#......#..#
#.......#.#
#.........#
...........
#.........#
#.......#.#
#......#..#
#.........#
#####.#####
locked : 1

1
1
###########
#.........#
#.........#
#...#.##..#
#.....##..#
...##......
#...#.##..#
#..##.##..#
#.........#
#.........#
#####.#####

1
5
#####.#####
#.........#
#.........#
#.........#
#..#e.....#
...#.#.#...
#.###.##..#
#..##.##..#
#......#..#
#..#...#..#
#####d#####
boss
enemies 1

1
2
#####d#####
#e........#
#...#.#...#
#.........#
#..#.#....#
...........
#.....#.#.#
#.........#
#..#...#.##
#e.......e#
#####.#####
enemies 3

2
0
#####l#####
#.........#
#.........#
#........##
#.........#
#....@.....
#.......#.#
#.........#
#.........#
#.........#
#####.#####

2
1
#####.#####
#k........#
#.........#
#.........#
#..#......#
...#......d
#.#....##.#
#......##.#
#......##.#
#.........#
#####l#####
key : 0

1
0
###########
#.........#
#......#..#
#.......#.#
#.........#
#..........
#.........#
#.#.......#
#..#......#
#.........#
#####l#####
locked : 0

1
4
###########
#.........#
#...#.#.#.#
#.........#
#..#...#..#
...........
#...#.#.#.#
#.........#
#......#.##
#.........#
#####.#####

2
5
#####d#####
#.........#
#.........#
#.........#
#...##....#
...#..#...#
#..##.....#
#.#?#.....#
#........e#
#.......ee#
###########
enemies 3
sign Many have walked this path.

0
5
###########
#X........#
#.........#
#.....###.#
#.......#.#
#.........#
#.........#
#.........#
#.........#
#.........#
#####.#####

