8
2
#####D#####
#..#......#
##........#
##.#......#
#..#.#....#
#...##....#
#.........#
#.........#
#.........#
#X........#
###########

3
1
#####D#####
#.........#
#..#......#
#k#.......#
#.........#
#....#....D
#.........#
#........##
#.........#
#.........#
#####d#####
key : 1

2
0
#####D#####
#.........#
#.........#
#.........#
#...@.....#
#..#.#....D
#....#....#
#...##....#
#.........#
#.........#
###########

2
2
#####D#####
#k........#
##.....#..#
#.......#.#
#.........#
D.........d
#.........#
#.#.......#
#..#......#
#.........#
#####D#####
key : 0

2
3
###########
#.........#
##.#...#..#
#.........#
#.#.#.#.#.#
d.........#
#..#...#..#
#.........#
#.#.#.#.#.#
#.........#
###########

1
2
###########
#e.......e#
#........s#
#..#.#.#.##
#.........#
#...#.#...#
#.........#
#........##
#.........#
#.#.....#.#
#####D#####
enemies 2
switch 0 : 0 1

0
1
###########
####......#
#.##......#
#.#.......#
#.........#
l.........#
#.........#
#.#.......#
#.........#
#..#......#
###########
locked : 0

1
0
#####D#####
#........##
#.........#
#.........#
#.....#...#
#.........#
#.........#
#.....#...#
#.........#
#.........#
#####D#####

7
1
#####D#####
#.........#
#.....#.#.#
#.........#
#..#.#.#..#
#.........D
#.#.#.#...#
#.........#
#..#...#.##
#k........#
###########
key : 4

6
1
#####D#####
##........#
#...#..#..#
#.......#.#
#.........#
#.........D
#.........#
#.........#
#...#.....#
#.........#
#####D#####

3
2
#####D#####
#.........#
#.........#
#.........#
#..#..#...#
D.........#
#.........#
#..#..#..##
#........?#
#........e#
###########
enemies 1
door 0 : 0 1
sign Those who search shall find.

2
1
###########
#e...e....#
#.........#
#.........#
#.........#
D...#.....D
#.....#...#
#.....#...#
#.........#
#?........#
#####D#####
enemies 2
sign Something glints behind that door…

6
2
#####D#####
#......#.##
#.........#
#.#.#.#.#.#
#.........#
D..#.#.#..d
#.........#
#.#.#.#...#
#.........#
#......#.##
#####l#####

6
3
###########
#.........#
#..#...#..#
#.#.....#.#
#.........#
d.........#
#.........#
#.........#
#.........#
#.........#
###########

5
1
#####D#####
#.........#
#.........#
#.........#
#.........#
#k........d
#.........#
#.......#.#
#......#..#
#.........#
#####D#####
key : 2

7
2
#####l#####
#.........#
#..#......#
######....#
#.####....#
D....e....#
#..##.....#
##.#.#....#
#.........#
#.........#
#####D#####
locked : 2
boss
enemies 1

5
2
###########
#.........#
#.........#
#.........#
#.........#
d.........#
#.........#
#.........#
#.........#
#.........#
#####D#####

0
0
###########
#.........#
#.........#
#.........#
#.........#
#.....#...l
#......#..#
#.....##..#
#.........#
#.........#
#####D#####

4
1
#####d#####
#.........#
#.........#
#.........#
#.........#
#...#.....#
#....#.#..#
#.#.......#
#..#......#
#.........#
#####D#####

