3
1
#####D#####
#.........#
#.........#
#.........#
#.........#
#k........D
#.........#
#.........#
#.........#
#.........#
#####D#####
key : 1

6
0
#####l#####
#.........#
#..#......#
#.#.......#
#.........#
#.........#
#.........#
#.#.....#.#
#..#...#..#
#.........#
#####d#####
locked : 0

4
2
#####l#####
#.........#
#.........#
#..#.....##
#.........#
d.........D
#......#..#
#.........#
#.........#
#..#......#
#####D#####

5
1
#####D#####
#.........#
#.........#
#.........#
#.........#
D.........D
#.........#
#.#.....#.#
#..#...#..#
#..k......#
###########
key : 0

4
3
#####D#####
#e........#
#.........#
#.#.......#
#.........#
D........e#
#.........#
#.........#
#.........#
#s?#......#
#####D#####
enemies 2
switch 0 : 0 1
sign Many have walked this path.

2
2
#####d#####
#.#.....#.#
#.........#
#.#...#.#.#
#.........#
D...#.#...D
#.........#
#.#.#.#...#
#.........#
#.......#.#
#####l#####
locked : 3

1
2
#####D#####
#.........#
#.........#
##........#
#.........#
#....e##..#
#...#####.#
#.....#..##
#.....#.###
#.........#
#####d#####
boss
enemies 1

5
0
###########
#.........#
#.........#
#.........#
#.........#
#....@....D
#.........#
#.........#
#.........#
#.........#
#####l#####

2
3
###########
#.........#
#.........#
#.........#
#.....#...#
D...#.....#
#...#.....#
#.........#
#.........#
#.........#
#####D#####

2
1
###########
#k........#
#.........#
#....#..#.#
#.........#
#.........D
#.#..#..#.#
#.........#
#.........#
#.......#.#
#####D#####
key : 3

7
0
#####d#####
#.........#
#..#......#
#.#.......#
#.........#
#.........#
#.........#
#.........#
#.........#
#.........#
#####d#####

0
2
###########
#X........#
#.........#
#.##.#....#
#.###.#...#
#..#......#
#..#.##...#
#####.#...#
#.##......#
#.........#
#####D#####

3
2
#####l#####
#.........#
#.........#
#.........#
#.........#
D.........D
#.........#
#.........#
#.........#
#.........#
#####l#####
locked : 1

6
2
#####D#####
#.........#
#.........#
#..#..#..##
#.........#
#.........#
#..#......#
#.........#
#.........#
#k.......##
###########
key : 2

5
2
#####D#####
#.........#
#.........#
##..#..#..#
#.........#
D.........D
#.#..#..#.#
#.........#
#.........#
#......#..#
#####D#####

3
3
#####D#####
#e........#
#.........#
##.....#..#
#.........#
D........e#
#.#..#....#
#.........#
#.........#
#?........#
#####D#####
enemies 2
door 0 : 0 1
sign A locked path — look elsewhere first.

5
3
#####D#####
#.........#
#.........#
#.........#
#.........#
D.........#
#.........#
#.#.......#
#..#......#
#.........#
###########

4
1
#####D#####
#.........#
#.........#
#.........#
#.........#
#.........d
#.........#
#.#.......#
#..#......#
#.........#
#####D#####

8
0
#####d#####
#.........#
#..#...#..#
#.#.....#.#
#.........#
#.........#
#.........#
#.........#
#.........#
#.........#
###########

