2
0
#####D#####
#.##......#
#.###.....#
#.#.......#
#..##.....#
#....@....D
#.........#
##....#...#
#.........#
#.........#
#####D#####

2
2
#####D#####
#.........#
#.........#
#.........#
#.#.##....#
D...e##...d
#..p##e...#
#.#e#.#...#
#.........#
#.........#
#####d#####
enemies 3

0
0
###########
#.........#
##........#
#.........#
#..#...#..#
#.........#
#..#.#.#..#
#.........#
#......#.##
#.........#
#####D#####

4
3
#####D#####
#.........#
#.#.#...#.#
#.........#
#.#.#.#.#.#
D.........#
#.#.#...#.#
#.........#
#.#...#.#.#
#........k#
###########
key : 5

5
2
#####D#####
##.....#.##
#........e#
##.#.#.#.##
#........?#
D.........#
#.........#
##.#.#....#
#.........#
##.#...#..#
#####D#####
enemies 1
sign Something glints behind that door…

4
1
#####D#####
#.........#
#.........#
#.........#
#.........#
D.........d
#.........#
#.........#
#.........#
#.........#
#####D#####

6
2
#####D#####
#......#..#
#.........#
#....##...#
#....##.#.#
#..###....#
#..###....#
#.........#
#.........#
#X........#
###########

1
1
###########
#.........#
#.#.#.#.#.#
#.........#
#.#...#.#.#
d.........D
#.#.#.#.#.#
#.........#
#...#.#.#.#
#.........#
#####D#####

2
1
#####D#####
#.........#
#......#..#
#.......#.#
#.........#
D.........D
#.........#
#.#.....#.#
#..#...#..#
#.........#
#####D#####

3
2
#####d#####
#.........#
#.........#
#.........#
#.##......#
D.........D
#.###.....#
#.#.#.....#
#.#.#.....#
#.........#
#####D#####

4
0
#####l#####
#.##...##.#
#.#.#.....#
#.#..######
#..#.#....#
#....#....D
#.........#
#.........#
#.........#
#.........#
###########
locked : 0

3
0
#####D#####
#..#......#
#.........#
#.........#
#.........#
#e........D
#.........#
#..#..#..##
#.........#
#.........#
#####l#####
enemies 1

4
2
#####D#####
#.........#
#.........#
#.........#
#..#......#
d...#e....D
#.#.......#
#.........#
#..#......#
#.........#
#####D#####
boss
enemies 1

3
3
#####D#####
#.........#
#.........#
#.........#
#.........#
D........k#
#.........#
#.........#
#.........#
#.........#
#####D#####
key : 4

3
1
#####D#####
#.........#
#...#.....#
#.........#
#.........#
D...#..#..D
#.........#
#.........#
##..#..#..#
#e........#
#####D#####
enemies 1

1
2
###########
#.........#
#.#.#.#...#
#.........#
#....#.#..#
D.........#
#.#.#.....#
#.........#
#......#.##
#.........#
#####D#####

1
0
#####D#####
#.........#
#...#.#...#
#.........#
#......#..#
#.........d
#k#.#.#.#.#
#.........#
#......#..#
#.........#
#####D#####
key : 0

5
1
#####D#####
#.........#
#.........#
#.........#
#.........#
#.........D
#.........#
#.........#
#.........#
#k........#
###########
key : 3

2
3
###########
#.........#
#.........#
#.........#
#..#......#
d.........#
#.........#
#.#.......#
#..#......#
#......#..#
#####D#####

