3
3
###########
#........k#
#.........#
#..#......#
#.........#
..........#
#..#..#...#
#.........#
#.........#
#..#.....##
#####.#####
key : 5

3
2
#####.#####
#e.......?#
#...#.....#
#.........#
#.........#
.......#...
#.........#
#.........#
##..#..#..#
#e........#
#####.#####
enemies 2
sign A locked path — look elsewhere first.

3
0
#####.#####
#.........#
#.........#
#####.....#
#.#.#.....#
#..........
#.#.#.....#
#..#......#
#.........#
#.........#
#####.#####

4
0
#####.#####
###.......#
#.#.......#
#.#..#....#
#..#......#
#....#....d
#.........#
#.........#
#.........#
#.........#
###########

4
3
#####.#####
#.........#
#.....###.#
#......#..#
#.........#
d.........#
#...##....#
#..##.....#
#.........#
#.........#
#####.#####

6
2
#####l#####
#.........#
#.........#
#.........#
#.........#
#..........
#.........#
#.........#
#.........#
#.........#
###########
locked : 4

2
2
###########
#........e#
#..#..#..##
#.........#
#.........#
#..#......#
#.........#
#.........#
#.....#..##
#.........#
#####.#####
enemies 1

7
3
#####.#####
#......#..#
#...#.#...#
#..####...#
#..#..##..#
#.........#
#.........#
#.........#
#.........#
#X........#
###########

1
1
###########
#........k#
#..#......#
#.#.......#
#.........#
..........#
#.........#
#.#.......#
#..#......#
#.........#
###########
key : 1

5
2
#####d#####
#.........#
#.....#...#
#...###...#
#.....##..#
...........
#.........#
#.........#
#.........#
#.........#
#####l#####

4
2
#####.#####
#.#.....#.#
#.........#
#.........#
#..#..#...#
..........d
#.........#
#....#..#.#
#.........#
#.........#
#####d#####

6
3
#####d#####
#.........#
#.........#
#.........#
#.........#
.....e....#
#.........#
#.........#
#.........#
#.........#
#####.#####
boss
enemies 1

0
0
###########
#.........#
#.........#
#.........#
#.........#
#.........#
#.........#
#.......#.#
#......#..#
#.........#
#####.#####

4
1
#####l#####
#.........#
##.#...#..#
#.........#
#..#.#....#
d..........
#..#.#.#..#
#.........#
##.#...#..#
#.........#
#####.#####

1
0
#####.#####
##........#
#.........#
#.....#..##
#...##..#.#
#...##.#...
#...#@###.#
#.....#...#
#.........#
#.........#
#####.#####

5
1
#####.#####
#.........#
#......#..#
#.......#.#
#.........#
#..........
#.........#
#.......#.#
#......#..#
#.........#
###########

2
0
#####.#####
#k........#
##.#...#..#
#.........#
#.#.#.#...#
#.........#
#..#.#.#..#
#.........#
#...#.....#
#.........#
#####.#####
key : 0

5
3
#####.#####
#.........#
#..#...#..#
#.#.....#k#
#.....#...#
..........#
#.........#
#.#.......#
#..#......#
#.........#
#####d#####
key : 4

3
1
###########
#.........#
#.........#
#.........#
#.........#
...........
#.........#
#.........#
#.........#
#......#..#
#####l#####
locked : 0

