6
2
#####D#####
#.........#
#.........#
#.........#
#.........#
D.........d
#.........#
#.........#
#.........#
#.........#
###########

3
1
#####D#####
#k........#
##.#...#.##
#.........#
#....#.#..#
D.........D
#....#.#..#
#.........#
##.....#.##
#.........#
#####D#####
key : 2

6
3
###########
#.........#
#..#..#...#
#..#####..#
#.....##..#
d......#..#
#..###.#..#
#.........#
#.........#
#.........#
###########

5
1
#####D#####
#k........#
#.........#
#.........#
#.........#
D.........D
#.........#
#.#.......#
#..#......#
#.........#
#####d#####
key : 0

5
0
#####D#####
#.........#
#.........#
#.........#
#.........#
#....@....D
#..#......#
#?##......#
#.........#
#.........#
#####D#####
sign The brave are rewarded.

6
0
#####D#####
#.........#
#.###.....#
###.......#
#.#.......#
#...#.....D
#.#..#....#
#.........#
#.........#
#.........#
###########

1
1
#####D#####
#.........#
#.........#
###.......#
#.##e#....#
D..#.#....#
#.##.#....#
######....#
#...#.....#
#.#.......#
#####d#####
boss
enemies 1

6
1
#####d#####
#.........#
#.#...#.#.#
#.........#
#....#.#..#
D.........D
#.#.#.#.#.#
#.........#
#..#...#.##
#.........#
###########

4
2
#####l#####
#.........#
#.##...#..#
#.#..#..#.#
#.........#
D.........d
#.........#
#.........#
#.........#
#........##
#####D#####

1
0
###########
#.........#
#.#.......#
#.........#
#.........#
#..#......D
#.........#
#.........#
#.#.....#.#
#.........#
#####D#####

4
1
#####D#####
#.........#
#.........#
#......#..#
#.........#
D.........D
#.#..#..#.#
#.........#
#.........#
##........#
#####D#####

3
0
#####D#####
#.........#
#.........#
#.........#
#.........#
#k........D
#.........#
#.........#
#.........#
#.........#
#####D#####
key : 1

4
3
###########
#.........#
#.........#
#...###...#
#...#.#...#
d..##.#...#
#..#..#...#
#...#.#...#
#.........#
#.........#
###########

2
1
#####d#####
#.........#
#.........#
#.........#
#.........#
l.........#
#.........#
#.#.....#.#
#..#...#..#
#.........#
#####D#####
locked : 3

4
0
#####D#####
#e........#
#.........#
#.........#
#.........#
#e........D
#.........#
#.........#
#.........#
#.........#
#####D#####
enemies 2

2
0
#####D#####
#.........#
#..#...#..#
#k#.....#.#
#.........#
#.........l
#.........#
#.#.......#
#..#......#
#.........#
#####D#####
key : 3

0
1
###########
#X........#
#.........#
#.........#
#.........#
#.........#
#....#....#
#.........#
#.........#
#.........#
#####D#####

5
2
#####D#####
#.........#
#.........#
#....##...#
#...###...#
D...##e#..#
#...#.....#
#.........#
#.........#
#.........#
#####D#####
enemies 1

3
2
###########
#.........#
#.........#
#.........#
#.........#
D..#.##...#
#..##.#...#
#.........#
#...#..#..#
#.........#
#####l#####
locked : 1

