2
0
#####D#####
#.........#
#.#.....#.#
#.........#
#.........#
#....#....D
#.........#
#.........#
#.#.......#
#.........#
#####D#####

3
1
#####l#####
#..#......#
#..#......#
#.#..#....#
#.........#
D.........l
#.........#
#......#..#
#.........#
#.........#
#####d#####
locked : 1

6
1
#####D#####
#.........#
#...#.....#
#...###...#
#.........#
#.........#
#.........#
#.........#
#.........#
#X........#
###########

1
1
#####l#####
#k#.......#
#.###.....#
#.#.......#
#.........#
D.........D
#.........#
#.........#
#.........#
#.........#
#####D#####
key : 0

0
1
###########
#.........#
#..#......#
#.#.......#
#.........#
D.........#
#.........#
#.#.......#
#..#......#
#.........#
#####l#####
locked : 0

1
0
#####d#####
#.........#
#.#.#.#...#
#.........#
#.........#
#.........D
#...#.#...#
#.........#
#......#.##
#.........#
#####D#####

2
3
#####D#####
#......#..#
#.....#.#.#
#.........#
#.........#
D.........#
#.........#
#.......p.#
#.........#
#.........#
###########

4
1
#####d#####
#.........#
#.........#
#.........#
#.........#
#.........#
#.........#
#.......#.#
#......#..#
#.........#
#####d#####

1
3
#####D#####
#..#......#
#..##.....#
#..###....#
#..###....#
D..#.#.#..D
#....#....#
#..#.#....#
#...#.##..#
#.........#
#####D#####

2
1
#####D#####
#.........#
##.##.....#
##.#......#
#.........#
D.........D
#.........#
#.........#
#.........#
#.........#
#####l#####

3
2
#####D#####
#.........#
#..#......#
#.#.......#
#.........#
l.........#
#.........#
#.......#.#
#......#..#
#.........#
###########
locked : 4

3
0
#####D#####
#.##......#
#...#.....#
#...#.....#
#.........#
#....@....D
#.....#...#
#...#.....#
#.....#...#
#.........#
###########

0
3
###########
#k........#
#..#......#
#.#.......#
#.........#
#.........#
#.......#.#
#.#.......#
#..#......#
#......#..#
#####D#####
key : 6

1
4
###########
#........e#
#.........#
#.........#
#.........#
D.........#
#.........#
#.........#
#.........#
#........e#
###########
enemies 2

1
2
###########
#.........#
#.#k#.....#
#..####...#
#..#......#
D.........D
#.........#
#.........#
#.........#
#.........#
#####D#####
key : 4

5
1
#####d#####
#.........#
#.........#
#.........#
#.........#
#....e#...#
#.........#
#.#####...#
#.##..#...#
#.##......#
#####D#####
boss
enemies 1

2
2
#####D#####
#k........#
#.........#
#.........#
#.........#
D.........D
#.........#
#.........#
#.........#
#.........#
#####D#####
key : 1

0
0
###########
#.........#
##..#..#..#
#.........#
#.........#
#....#....D
#.........#
#.........#
##..#..#..#
#.........#
#####d#####

