0
0
###########
#.........#
#.........#
#.........#
#..p......#
#.........D
#.........#
#.........#
#.........#
#.........#
#####d#####

3
1
#####D#####
#e........#
#.....#...#
#...##....#
#.........#
D..p.....e#
#.........#
#.........#
#.........#
#e.....p..#
#####D#####
enemies 3

3
0
#####D#####
#.........#
#.......#.#
#.........#
#.........#
#k.#..#...D
#.........#
#.........#
#.#.......#
#.........#
#####D#####
key : 1

1
1
#####d#####
#.........#
#......#..#
#.......#.#
#.........#
D.........l
#.........#
#.#.......#
#..#......#
#.........#
#####d#####

1
0
#####d#####
#.........#
#.........#
#..#..##..#
#..##.....#
#..k##.#..D
#...#.##..#
#.........#
#.........#
#.........#
#####D#####
key : 3

6
2
###########
#........k#
##.#...#.##
#.........#
#..#...#..#
D.........#
#..#...#..#
#.........#
##.#...#..#
#.........#
###########
key : 2

5
0
#####D#####
#.........#
#.........#
#.........#
#.....##..#
#?...@....D
#.....###.#
#.........#
#.........#
#.........#
#####D#####
sign Many have walked this path.

7
1
#####l#####
#........##
#.........#
#.........#
#.......#.#
#.........#
#.........#
#.......#.#
#......#..#
#.........#
###########
locked : 1

6
1
#####D#####
#k........#
#.........#
#.........#
#.........#
D.........D
#.........#
#.......#.#
#......#..#
#.........#
#####l#####
key : 0

2
2
#####D#####
#.........#
#..#...#..#
#.#.....#.#
#.........#
d.........#
#.........#
#.#.....#.#
#..#...#..#
#.........#
###########

5
1
#####D#####
#..#...#.##
#.........#
#.#...#...#
#.........#
D..#.#....#
#.........#
#.#.#.#...#
#.........#
##.....#..#
#####D#####

0
2
###########
#.#......X#
#.........#
#.#.###...#
#...##....#
D...##....#
#...#.....#
#...#.#...#
#.........#
#.........#
#####D#####

1
2
#####D#####
#.........#
#.........#
#.........#
#.........#
l....e....#
#.........#
#.........#
#.........#
#.........#
#####D#####
locked : 2
boss
enemies 1

2
1
#####d#####
#.#.....#.#
#.........#
#.....#...#
#.........#
D...#.....d
#.........#
#.#.#.#.#.#
#.........#
#.#.......#
#####D#####

0
1
###########
#.........#
#.........#
#.........#
#.........#
D.........D
#.........#
#.#.....#.#
#..#...#..#
#.........#
#####d#####

6
0
#####D#####
#.........#
#.#.......#
#.........#
#.........#
#..#......D
#.........#
#.........#
#.#.......#
#.........#
###########

2
0
#####D#####
#.........#
#.........#
#.........#
#.........#
#e........D
#e#..#..#.#
#.........#
#e........#
##.....#..#
#####D#####
enemies 3

4
0
#####D#####
#.........#
#.........#
#.........#
#.........#
#.........D
#.........#
#.........#
#.........#
#.........#
#####D#####

4
1
#####D#####
#e#.....#e#
#.........#
#.........#
#....#..#e#
D.........#
#.........#
#.#..#..#.#
#.........#
#.........#
#####D#####
enemies 3

