2
1
#####l#####
#e.....#..#
#..##.#...#
#..###....#
#..#......#
...#.#.#...
#.........#
#.........#
#.........#
#.........#
#####.#####
enemies 1

2
2
#####.#####
#k........#
#......#..#
#.......#.#
#.........#
...........
#.........#
#.........#
#.........#
#.........#
#####.#####
key : 2

5
0
#####.#####
#.........#
#.........#
#.........#
#.........#
#..........
#.........#
#.........#
#.........#
#.........#
###########

2
0
#####.#####
#.........#
#.........#
#.........#
#.........#
#...#..#...
#.........#
#.........#
#..#.....##
#........e#
#####.#####
enemies 1

4
1
#####.#####
#.#.....#.#
#.........#
#..#.#.#.##
#.........#
d.....#...#
#.........#
#......#..#
#.........#
#.......#.#
#####d#####

3
2
#####.#####
#k#.......#
#.........#
#......#.##
#.........#
....#.#....
#.........#
#..#.#....#
#.........#
#.#.......#
###########
key : 3

4
0
#####.#####
#.........#
#.........#
#.###.....#
#.##......#
#..##@....d
#.###.....#
#.........#
#.........#
#.........#
#####.#####

1
1
###########
#.........#
#.........#
#..#..#...#
#.........#
...........
#...#..#..#
#.........#
#.........#
#..#.....##
#####l#####
locked : 0

2
4
###########
#.........#
#.....#..##
#.........#
#.........#
d...#..#..#
#.........#
#.........#
#.....#...#
#.........#
###########

3
1
#####.#####
#e.......e#
#.........#
#.........#
#.........#
...........
#.........#
#.........#
#.........#
#e........#
#####.#####
enemies 3

0
3
###########
#X........#
#.........#
#.........#
#.........#
#.........#
#.........#
#.........#
#.........#
#.........#
#####.#####

1
3
#####.#####
#.........#
#.........#
#.........#
#.........#
.....e....#
#.........#
#.........#
#.........#
#.........#
#####l#####
locked : 3
boss
enemies 1

6
1
#####.#####
#.........#
##..#..#..#
#.........#
#.........#
#....#....#
#.........#
#.........#
##..#..#..#
#k........#
###########
key : 0

1
2
###########
##........#
#.........#
#.........#
#.........#
...........
#.........#
#.#.......#
#..#......#
#.#.......#
#####.#####

1
0
###########
#k........#
#.........#
###.......#
#...#.....#
#..##......
#..#......#
#...#.....#
#.........#
#.........#
#####.#####
key : 1

2
3
#####l#####
#.........#
#..#......#
#.#.......#
#.........#
..........d
#.........#
#.#.......#
#..#......#
#.........#
#####d#####

5
1
#####d#####
#.........#
#.........#
#.....#...#
#....#..#.#
....#.#...#
#.......#.#
#...##....#
#.........#
#.........#
#####.#####

3
0
#####.#####
#.........#
#......#..#
#...#...#.#
#.........#
#..........
#......#..#
#.#.......#
#.##......#
#.........#
#####.#####

3
3
#####d#####
#.#.....#.#
#.........#
#..#.....##
#.........#
..........#
#.........#
#..#.#.#.##
#.........#
#.#.....#.#
###########

