3
0
#####.#####
#.........#
#.........#
#.........#
#.........#
#.........#
#.........#
#.........#
#.........#
#.........#
#####.#####

5
1
#####.#####
#.........#
#...#.....#
#.........#
#.........#
..........#
#.........#
##........#
#.........#
#........k#
###########
key : 1

6
0
#####l#####
#..#...#..#
#.........#
#..#..##..#
#.##.#....#
#..##.....#
#.........#
#.........#
#.........#
#.........#
###########
locked : 1

0
0
###########
#.........#
#......#..#
#.......#.#
#.........#
#.........#
#.........#
#.........#
#.........#
#.........#
#####d#####

5
3
#####.#####
#.........#
#.........#
#.........#
#.........#
#.........d
#.........#
#.........#
#.........#
#k........#
###########
key : 6

3
2
###########
#.........#
#.........#
#.........#
#.........#
#.........#
#.........#
#.........#
#.........#
#.........#
#####l#####
locked : 0

4
0
#####.#####
#.........#
#.........#
#.........#
#.........#
#?...@.....
#.........#
#...#.....#
#.........#
#.........#
#####.#####
sign What you seek is close.

6
5
#####.#####
#.........#
#.........#
#....#....#
#.........#
#.........#
#.........#
#.........#
#.....#...#
#X........#
###########

2
1
#####.#####
#.........#
#..#...#..#
#.........#
#....##.#.#
..........#
#.........#
#.........#
#.........#
#........e#
###########
enemies 1

4
1
###########
#....k....#
#.........#
#.........#
#.........#
...........
#.........#
#.........#
#.........#
#.........#
#####.#####
key : 0

5
5
###########
#..#...#..#
#...#.#...#
#.........#
#...#.....#
d....e....#
#.........#
#.........#
#.........#
#.........#
#####.#####
boss
enemies 1

5
4
#####l#####
##.....#..#
#.........#
#.........#
#.#..#....#
d.........d
#.........#
##..#..#..#
#.........#
#.........#
###########

5
0
#####.#####
#.........#
#......#.##
#.........#
#..#.#.#..#
#..........
#..#.#.#..#
#.........#
##.#...#.##
#.........#
#####l#####

4
2
#####l#####
##.#......#
##.#......#
#..#.#....#
#.####....#
...##......
#.........#
#.........#
#.........#
#.........#
###########

4
4
###########
#.........#
#..#......#
#.#.......#
#...#.....#
..........#
#.........#
#.......#.#
#......#..#
#.........#
#####l#####
locked : 6

1
0
#####d#####
#.........#
#..#...#..#
#k#.....#.#
#.........#
#.........d
#.........#
#..#....#.#
#.........#
#..#......#
#####.#####
key : 2

1
1
###########
#.........#
#...#.....#
#...##....#
#.....#...#
d.........#
#.........#
#.........#
#.........#
#.........#
#####.#####

2
0
#####.#####
##........#
#..#......#
#.#.......#
#.........#
#....#.....
#.........#
#.#.......#
#..#....#.#
#.........#
#####.#####

4
3
###########
##.....#..#
#.........#
#.........#
#.#..#..#.#
...........
#.........#
#...#..#..#
#.........#
#.........#
#####.#####

