1
0
#####.#####
#.........#
##.#...#.##
#.........#
#.#.#.#.#.#
#..........
#..#.#....#
#.........#
#.#.#.#.#.#
#.........#
#####d#####

2
1
#####.#####
#.........#
#.........#
#...#.....#
#.#.......#
d.........d
#.........#
#.........#
#.........#
#.........#
#####.#####

1
1
###########
#e.e......#
####...#..#
#..#......#
#..##.....#
...##......
#.###.....#
#.##......#
#.........#
#.........#
#####.#####
enemies 2

3
2
#####.#####
#.........#
#..#......#
#.#.......#
#.........#
..........#
#.........#
#.......#k#
#......#..#
#.........#
#####.#####
key : 4

2
2
#####.#####
#.........#
#..#......#
#..#.#....#
#....#....#
d....e.#...
#....###..#
#.........#
#.........#
#.........#
#####.#####
boss
enemies 1

5
2
#####.#####
#e.......e#
#?........#
##..#..#..#
#.........#
...........
#...#..#..#
#.........#
#.........#
#e.....#.s#
#####.#####
enemies 3
switch 0 : 0
sign Those who search shall find.

3
0
#####.#####
#.#.....#.#
#.........#
#.....#.#.#
#.........#
#.....#....
#.........#
#...#.#.#.#
#.........#
#.#.......#
#####.#####

0
0
###########
#k........#
#.........#
#.........#
#.........#
#.........#
#.........#
#.........#
#.........#
#.........#
#####.#####
key : 8

5
3
###########
#.........#
#.#...#.#.#
#.........#
#.#.....#.#
..........#
#.#...#.#.#
#.........#
#.#.#.#.#.#
#.........#
###########

4
1
#####l#####
#e.......e#
#.#.....#.#
#.........#
#.........#
.....#....d
#.........#
#.........#
#.#.....#.#
#e........#
#####.#####
enemies 3

4
2
#####.#####
#.........#
#...#...#.#
#.........#
#...#.#.#.#
d.........#
#.#.#.#.#.#
#.........#
#.#...#.#.#
#.........#
#####.#####

2
3
###########
#.......ee#
#.........#
#.........#
#.........#
..........#
#.........#
#.........#
#.........#
#........e#
###########
enemies 3
door 0 : 0

1
2
###########
#........X#
#.........#
#.##.#....#
#.####....#
...#......#
#...##....#
#.####....#
#.........#
#.........#
#####.#####

5
1
#####.#####
#.........#
#.........#
#.........#
#.........#
...........
#.........#
#.........#
#.........#
#....k....#
###########
key : 0

6
2
#####.#####
#.........#
#.....#.#.#
#.........#
#.#.#.#...#
#.........#
#.#.#.#...#
#.........#
#...#.#.#.#
#k........#
###########
key : 6

3
1
#####.#####
#.........#
#.........#
#.........#
#.........#
...........
#.........#
#.........#
#.........#
#.........#
#####l#####
locked : 0

5
0
#####.#####
#.........#
#.........#
#.........#
#.........#
#..........
#.........#
#.........#
#.........#
#.........#
###########

2
0
#####d#####
#.........#
##.#.....##
#.........#
#.........#
#.........d
#..#.#.#..#
#.........#
##.....#.##
#.........#
#####.#####

4
0
#####.#####
#.........#
#.........#
#.........#
#...@..#..#
#....###...
#.....#...#
#.....###.#
#.....##..#
#.........#
#####.#####

