5
3
###########
#.........#
##.#...#.##
#.........#
#.#.#.#.#.#
D.........#
#..#.#....#
#.........#
#.#.#.#.#.#
#.........#
###########

2
2
#####D#####
#.........#
#.........#
#.........#
#.........#
d....e....D
#.........#
#.........#
#.........#
#.........#
#####D#####
boss
enemies 1

4
0
#####D#####
#.........#
#.........#
#.........#
#.........#
#....@....D
#.........#
#.........#
#.........#
#.........#
#####D#####

3
2
#####D#####
#.........#
#..#......#
#.#.......#
#.........#
D........k#
#.........#
#.#.......#
#..#......#
#.........#
#####D#####
key : 4

1
1
###########
#....e....#
#.........#
#.........#
#.........#
D....#....D
#.........#
#.........#
#.........#
#.......#e#
#####D#####
enemies 2

3
1
#####D#####
#.........#
#......#..#
#.......#.#
#.........#
D.........D
#.........#
#.#.......#
#..#......#
#.........#
#####l#####
locked : 0

4
1
#####l#####
#.......#e#
#.........#
#..#.#.#..#
#.........#
D.....#...d
#.........#
#..#.#.#.##
#.........#
#e#.....#e#
#####D#####
enemies 3

3
0
#####D#####
#.........#
#.........#
#....#.##.#
#.....###.#
#...#.##..D
#....###..#
#......#..#
#.........#
#.........#
#####D#####

1
0
#####D#####
#.........#
#.........#
#.........#
#...#.....#
#...#.....D
#.........#
#.#.......#
#..#......#
#.........#
#####d#####

6
2
#####D#####
#.........#
##.#.....##
#.........#
#....#....#
#.........#
#..#.#....#
#.........#
##.....#.##
#k........#
###########
key : 6

4
2
#####D#####
#.........#
#.........#
##..#..#..#
#.........#
d.........#
#...#..#..#
#.........#
#.........#
#......#..#
#####D#####

2
0
#####d#####
#.........#
#..#......#
#.#.......#
#.........#
#.........d
#.#...#...#
#.#.....#.#
#..#...#..#
#........##
#####D#####

0
0
###########
#k#.....#.#
#.........#
#.#.#.#.#.#
#.........#
#...#.....#
#.........#
#...#...#.#
#.........#
#.......#.#
#####D#####
key : 8

5
0
#####D#####
##........#
##..#.....#
###.##....#
#..###....#
#.........D
#.........#
#.........#
#.........#
#..p......#
###########

5
2
#####D#####
#e.......e#
#.........#
#.........#
#.........#
D.........D
#.........#
#.........#
#.........#
#e......?s#
#####D#####
enemies 3
switch 0 : 0
sign Those who search shall find.

2
3
###########
#.......ee#
#.........#
#.........#
#.........#
D.........#
#.........#
#.........#
#...#.....#
#........e#
###########
enemies 3
door 0 : 0

2
1
#####D#####
#.........#
#.....#..##
#.........#
#.........#
d...#..#..d
#.........#
#.........#
#..#.....##
#.........#
#####D#####

5
1
#####D#####
#.........#
#......#..#
#.......#.#
#.........#
D.........D
#.........#
#.......#.#
#......#..#
#......k..#
###########
key : 0

1
2
###########
##.......X#
#...#.....#
###..#....#
#...#.....#
D..#......#
#..###....#
#..###....#
#.##......#
#.##......#
#####D#####

