3
3
#####.#####
#.........#
#.........#
#.........#
#.........#
..........#
#.........#
#.........#
#.........#
#........X#
###########

2
0
###########
#.........#
#.........#
#.........#
#.........#
#..........
#.........#
#.........#
#.........#
#.........#
#####d#####

3
1
#####.#####
#e........#
##?#...#..#
#.........#
#..#.#.#..#
...........
#..#.#.#..#
#.........#
#..#...#.##
#e.......e#
#####.#####
enemies 3
sign A useful tool lies just ahead.

3
0
#####d#####
#.........#
#.........#
#..###....#
#..#k.....#
#...##.....
#.........#
#.........#
#.........#
#.........#
#####.#####
key : 0

6
0
#####d#####
#.........#
#......#..#
#.#.....#.#
#.#.......#
#.........l
#.........#
#.........#
#.........#
#......#..#
#####.#####

2
1
#####l#####
#k........#
#..#......#
#.#.......#
#.........#
...........
#.........#
#.........#
#.........#
#.........#
#####.#####
key : 3

2
2
#####d#####
#e.#.....##
#.........#
#.........#
#..#..#...#
..........d
#.........#
#.....#..##
#.........#
#e........#
#####.#####
enemies 2
door 0 : 0 1

2
3
###########
#.........#
#.........#
#..#......#
#...e.....#
d..####...#
#.###.#...#
#.....#...#
#.........#
#.........#
#####.#####
boss
enemies 1

7
0
#####.#####
#e........#
##..#..#..#
#e........#
#.........#
#?..#..#..#
#.........#
#s........#
##..#.....#
#e........#
#####.#####
enemies 3
switch 0 : 0 1
sign Beware what lurks ahead.

1
1
#####.#####
#.........#
#..#...#..#
#.#.....#.#
#.........#
#..........
#.........#
#.........#
#.........#
#.........#
#####l#####
locked : 3

8
0
#####.#####
#.........#
#.........#
#......#..#
#.........#
#.........#
#.........#
#.......#.#
#......#..#
#.........#
###########

5
0
#####.#####
#.........#
#.........#
#.........#
#...@.....#
#....###...
#....###..#
#.....##..#
#.........#
#.........#
#####d#####

5
1
#####.#####
#.........#
#..#...#..#
#.#.....#.#
#.........#
..........#
#.........#
#.......#.#
#......#..#
#.........#
#####.#####

6
1
#####.#####
#.........#
##.....#.##
#.........#
#.#.#.#.#.#
l.........#
#..#...#..#
#.........#
#.....#.#.#
#.........#
###########
locked : 1

1
2
###########
#..#.....##
#.........#
#.........#
#..#..#...#
..........#
#.........#
#..#......#
#.........#
#.........#
#####d#####

0
1
###########
#k........#
#.........#
#.........#
#.........#
#.........#
#.........#
#.........#
#.........#
#.........#
#####.#####
key : 4

4
1
#####.#####
#k#.......#
#..#......#
#..##.....#
#..##.#...#
....####..#
#....#.#..#
#....#....#
#.........#
#.........#
#####.#####
key : 1

3
2
#####.#####
#.........#
#.......#.#
#.........#
#.....#...#
...........
#.........#
#.#.......#
#..#......#
#.........#
###########

4
0
#####.#####
#.........#
#..#......#
#.#.......#
#.........#
#..........
#.........#
#.........#
#.........#
#.........#
#####.#####

