1
0
#####D#####
#.........#
#.........#
#.........#
#.........#
#....@....D
#....##...#
#...#.....#
#..p.....p#
#.........#
#####D#####

2
0
#####D#####
#.........#
#.........#
#.........#
#.........#
#.........D
#.........#
#.........#
#.........#
#.........#
###########

0
2
###########
#.........#
#..#......#
#.#.......#
#.........#
D.........#
#......#..#
#.#.......#
#..#......#
#..#......#
#####D#####

0
0
###########
#.........#
#.........#
#.........#
#.........#
#...#.....D
#.##......#
##...#....#
###.#.....#
##........#
#####D#####

7
3
#####D#####
#.........#
#.........#
#.........#
#.........#
#.........#
#.........#
#.........#
#.........#
#X........#
###########

0
1
###########
#....k....#
#.........#
#.........#
#.........#
D.........D
#.........#
#.#.......#
#..#......#
#.........#
#####D#####
key : 1

4
2
#####d#####
#.........#
####......#
##..#.....#
#..###....#
D..##.....D
#.##.#....#
##...#....#
#.#.#.....#
#.........#
#####D#####

4
1
#####d#####
#......p..#
#.........#
#.........#
#.p.......#
#.........D
#.#.......#
#.........#
#.........#
#.........#
###########

4
3
###########
#.......ee#
#..##....e#
#..?##....#
#..#.#....#
D.........#
#.........#
#.........#
#.........#
#.........#
#####D#####
enemies 3
sign Many have walked this path.

1
1
#####D#####
#........k#
#..#..#..##
#.........#
#.........#
D...#..#..D
#.........#
#.........#
#..#..#..##
#.........#
#####l#####
key : 0

2
1
#####l#####
#.........#
##.#...#.##
#.........#
#..#.#.#..#
D.........l
#..#...#..#
#.........#
#..#...#.##
#.........#
#####d#####
locked : 0

6
2
#####D#####
#.........#
#.........#
#.........#
#.........#
#.........D
#.........#
#.........#
#.........#
#k........#
###########
key : 5

2
2
#####D#####
#.#.....#.#
#.........#
#..#.#.#.##
#.........#
l...#.#...#
#.........#
#......#..#
#.........#
#.......#.#
#####D#####
locked : 2

5
3
#####D#####
#.........#
#.........#
#.##......#
#..##.....#
D...##.#e.#
#..#e..e#?#
#.#######.#
#......#..#
#......#..#
#####d#####
enemies 3
sign Beware what lurks ahead.

3
2
#####D#####
#.........#
#.........#
#....#..#.#
#.........#
l.........#
#..#..#...#
#.........#
#.........#
#.#.....#.#
#####d#####
locked : 1

1
2
#####D#####
#.........#
#.........#
#.........#
#.........#
D........k#
#.........#
#.........#
#.........#
#.........#
#####D#####
key : 2

3
1
#####d#####
#.........#
#.........#
#.........#
#.........#
#.........l
#.........#
#.........#
#.........#
#.........#
#####d#####

5
2
#####D#####
#.........#
#.........#
#.........#
#.........#
#.........D
#.##......#
#.#.#.....#
#.#.......#
#.........#
#####D#####

6
3
#####d#####
#.........#
#.........#
#.##.#....#
#.#.e#....#
D...##....#
#.#.......#
#.##.#....#
#.........#
#.........#
#####D#####
boss
enemies 1

