2
1
#####.#####
#..#......#
#...#..####
#..#.###..#
#.......#.#
#..........
#....#.##.#
#.........#
#.........#
#.........#
#####.#####

0
2
###########
#.........#
##.....#..#
#.........#
#.........#
.....#.....
#.........#
#.........#
##..#..#..#
#.........#
#####d#####

3
0
###########
#.........#
#.........#
#.........#
#.........#
#....@.....
#.........#
#.........#
#.........#
#.........#
###########

5
2
#####.#####
#..#.....##
#.........#
#.........#
#.........#
..........#
#...#.....#
#..###....#
#...#.....#
#.........#
#####.#####

6
3
###########
#.........#
#.........#
#.........#
#.........#
d....e....#
#.........#
#.........#
#.........#
#.........#
#####.#####
boss
enemies 1

5
1
#####l#####
#.........#
#..#......#
#.#.......#
#.........#
#..........
#.........#
#.#.......#
#..#......#
#.........#
#####.#####
locked : 0

0
3
###########
#.........#
#.#.#.#.#.#
#.........#
#...#.#.#.#
..........#
#.#...#.#.#
#.........#
#.#...#.#.#
#.........#
#####d#####

2
2
#####.#####
#.........#
#......#..#
#.......#.#
#.........#
..........d
#.........#
#.#.....#.#
#..#...#..#
#..k......#
###########
key : 0

0
1
###########
#k........#
#.......#.#
#.........#
#..#......#
#..........
#.........#
#.........#
#.........#
#.........#
#####.#####
key : 2

4
2
###########
#........k#
#.........#
#.........#
#.........#
.....###..#
#...##....#
#......#..#
#..##.....#
#.........#
#####.#####
key : 1

6
1
#####.#####
#.........#
#.#...#.#.#
#.........#
#...#.#...#
#..........
#...#.#.#.#
#.........#
#...#...#.#
#k........#
###########
key : 3

1
1
#####.#####
#.........#
#.........#
#....###..#
#..##.##..#
#..##..#..l
#..e##....#
#..##..#..#
#.........#
#.........#
#####.#####
enemies 1

1
2
#####d#####
#.........#
#..#......#
#.#.......#
#.........#
l.........l
#.........#
#.#.......#
#..#......#
#.........#
#####.#####
locked : 2

2
3
#####.#####
#.........#
#.........#
#....#..#.#
#.........#
d.........#
#.#..#..#.#
#.........#
#.........#
#.#.....#.#
###########

3
1
#####.#####
#..#...#.##
#........e#
##.#.#.#.##
#........?#
.....#.#..#
#.........#
##.#.#.#.##
#........e#
##.#...#.##
#####.#####
enemies 2
sign Beware what lurks ahead.

1
3
#####d#####
#.........#
#.........#
#.........#
#.........#
l.........#
#.........#
#.#.....#.#
#..#...#..#
#.........#
#####.#####
locked : 1

7
3
#####.#####
#.........#
#.....#...#
#.........#
#.........#
#....#....#
#.........#
#......####
#.........#
#.......#X#
###########

4
1
#####.#####
##.....#..#
#.........#
#.........#
#.#..#..#.#
#..........
#.........#
##.....#..#
#.........#
#.........#
#####l#####

6
2
#####.#####
#......#.##
#.........#
#.#.#...#.#
#.........#
...#.#.#..d
#.........#
#.#.#.#.#.#
#.........#
##.....#.##
###########

