3
0
###########
##.#......#
##........#
#..###....#
#..#.#....#
#..#.@.....
#.........#
#.........#
#.........#
#.........#
#####.#####

4
2
#####.#####
#k........#
#......#..#
#.......#.#
#.........#
..........d
#.........#
#.#.....#.#
#..#...#..#
#.........#
#####l#####
key : 2

5
1
#####d#####
#.........#
#......#..#
#.......#.#
#.........#
#..........
#.........#
#.#.......#
#..#......#
#.........#
###########

2
1
#####.#####
#.........#
#.........#
#.##......#
#..#......#
#..........
#..#......#
#.#.#..##.#
##..#..##.#
#.........#
#####.#####

4
1
#####.#####
#.........#
#.........#
#.........#
#.........#
...........
#.........#
#.........#
#.........#
#.........#
#####d#####

2
2
###########
#....k....#
#.........#
#..#..#..##
#.........#
...........
#..#..#...#
#.........#
#.........#
#..#......#
#####.#####
key : 0

0
1
###########
#.........#
#.........#
#.#..#..#.#
#.........#
#.........#
#..#..#...#
#.........#
#.........#
#.......#.#
#####.#####

3
3
#####.#####
#.........#
#..##.....#
#..##.....#
#.#e#.##..#
....####..l
#.#.......#
#####.....#
#.........#
#.........#
#####.#####
enemies 1

5
2
#####l#####
#......#.##
#.........#
#.#...#.#.#
#.........#
...#.#.#..#
#.........#
#.#.#.#...#
#.........#
##.#.....##
#####l#####
locked : 2

2
3
###########
#....k....#
#.........#
#.........#
#.........#
..........d
#.........#
#.......#.#
#......#..#
#.........#
#####.#####
key : 3

6
2
#####l#####
#.........#
#......#..#
#.......#.#
#.........#
#.........#
#.........#
#.#.......#
#..#......#
#.........#
###########
locked : 3

3
4
#####.#####
#.........#
#.........#
#.........#
#.........#
l....e....#
#.........#
#.........#
#.........#
#.........#
#####.#####
locked : 1
boss
enemies 1

4
4
#####.#####
#.........#
#.........#
#.........#
#.........#
..........#
#.........#
#.........#
#.........#
#........X#
###########

1
1
#####.#####
#.......#.#
#.........#
#..#.#.#.##
#.........#
#...#.....#
#.........#
#......#.##
#.........#
#k#.....#.#
#####.#####
key : 1

4
3
#####.#####
#.........#
#..#...#.##
#.........#
#.#...#.#.#
d..........
#..#...#..#
#.........#
#...#.#.#.#
#.........#
###########

3
2
#####.#####
#.........#
#.........#
#.........#
#.........#
d..........
#.........#
#.........#
#.........#
#.........#
#####.#####

4
0
#####.#####
#.........#
#.........#
#.........#
#.........#
#......#...
#.....##..#
#......#..#
#.........#
#.........#
###########

3
1
#####.#####
#.........#
#.........#
#.........#
#.........#
..........d
#.........#
#.........#
#.........#
#.........#
#####.#####

2
4
###########
#.........#
#.........#
##........#
#.##......#
d.........#
#.........#
#..#......#
#.........#
#.........#
#####.#####

