2
0
###########
#k.#.....##
#.........#
#.........#
#.........#
#..........
#.........#
#.........#
#.........#
#.........#
#####.#####
key : 1

3
0
#####.#####
#.........#
#.........#
#.........#
#...####..#
#...###....
#...@?##..#
#...###...#
#...#.#.#.#
#.........#
#####.#####
sign Those who search shall find.

1
2
###########
#.........#
#......#..#
#.........#
#.........#
..........#
#.........#
#.........#
#.........#
#.........#
#####.#####

1
4
###########
#.........#
##.##.....#
####......#
#.........#
#.........#
#.........#
#.........#
#.........#
#.........#
#####d#####

3
1
#####.#####
#.........#
#.........#
#.........#
#.........#
...###.#..l
#...###...#
#..##.##..#
#..##.....#
#..#k..#..#
###########
key : 0

3
2
#####l#####
#.........#
#.........#
#.........#
#.........#
l..........
#.........#
#.#.......#
#..#......#
#.........#
###########
locked : 1

1
1
#####.#####
#.........#
#.........#
#.........#
#.........#
#k.........
#.........#
#.........#
#.........#
#.........#
#####.#####
key : 2

3
3
#####.#####
#.........#
#.#...#.#.#
#.........#
#.#.#.#.#.#
...........
#.#...#.#.#
#.........#
#...#...#.#
#...k.....#
###########
key : 3

2
4
#####d#####
#.........#
#.........#
#..#.....##
#.........#
d..........
#...#..#..#
#.........#
#.........#
#..#.....##
#####.#####

2
2
#####.#####
#.........#
#.........#
#..#..#..##
#.........#
..........d
#...#..#..#
#.........#
#.........#
#..#.....##
#####l#####
locked : 0

0
1
###########
#.#.......#
#.........#
#.........#
#.....#...#
#.........#
#.........#
#.#..#....#
#.........#
#.........#
#####.#####

2
5
###########
#.......se#
#........?#
#.#.....#e#
#.........#
..........#
#.#..#..#.#
#.........#
#.........#
#.......#.#
#####.#####
enemies 2
switch 0 : 0
sign The dungeon remembers all who enter.

3
5
#####.#####
###.......#
###.......#
#.........#
#.#..#..#.#
...##.....#
#.####....#
#.#.#.....#
###.#....e#
#.......ee#
###########
enemies 3
door 0 : 0

4
4
#####l#####
#.........#
#.........#
#.........#
#.........#
#....e....#
#.........#
#.........#
#.........#
#.........#
#####.#####
locked : 2
boss
enemies 1

5
4
#####.#####
#.........#
#..#..##..#
#.#####...#
#..###....#
#..###.#..#
#.........#
#.........#
#.........#
#X........#
###########

4
0
#####.#####
#.........#
#......#..#
#.......#.#
#.........#
#.........#
#.........#
#.........#
#.........#
#.........#
###########

2
1
#####.#####
#.......#.#
#.....###.#
#...##..#.#
#...##.##.#
...........
#.........#
#.........#
#.........#
#.........#
#####.#####

3
4
#####.#####
#.......#e#
#......##.#
#...##....#
#...###.#.#
....###....
#.........#
#.........#
#.........#
#.........#
#####l#####
enemies 1

2
3
###########
#.........#
#.........#
#.........#
#.........#
d.........d
#.........#
#.........#
#.........#
#.........#
#####.#####

