1
1
###########
#.........#
#...#..#..#
#.........#
#.........#
.....#.....
#.........#
#.........#
##.....#..#
#.........#
#####.#####

5
2
#####.#####
#.........#
#.........#
#.........#
#.........#
......#...#
#......##.#
#.....###.#
#.....#..##
#........X#
###########

2
3
#####.#####
#k........#
#.........#
#.........#
#.........#
...........
#.........#
#.........#
#.........#
#.........#
#####.#####
key : 4

3
0
#####.#####
#.........#
#..#......#
#k#.......#
#.........#
#..........
#.........#
#.........#
#.........#
#.........#
#####l#####
key : 1

1
2
###########
#.........#
#.........#
#.........#
#......#..#
...........
#.........#
##..#..#..#
#.........#
#.........#
#####d#####

4
2
###########
###.......#
###....#.##
##...#.#..#
#...e####.#
d....##....
#.........#
#.........#
#.........#
#.........#
#####.#####
boss
enemies 1

2
1
#####.#####
#.........#
#.#.#...#.#
#.........#
#..#.#.#..#
...........
#.#...#.#.#
#.........#
#..#.....##
#........k#
#####.#####
key : 0

1
0
###########
#.........#
##.#......#
#.#.......#
#.........#
#..........
#.........#
#......##.#
#......#..#
#.........#
#####.#####

2
2
#####d#####
#.........#
#......#..#
#......k#.#
#......#..#
...........
#.........#
#.......#.#
#......#..#
#.........#
###########
key : 2

4
3
#####.#####
##.#...#.##
#.........#
##.#.#.#..#
#.........#
...#......#
#.........#
##.#.#.#.##
#.........#
##.....#e##
###########
enemies 1
door 0 : 0

2
0
#####.#####
#.........#
#.........#
#.........#
#.........#
#..##@.....
#..?#.....#
#..##.....#
#.........#
#..#......#
#####.#####
sign What you seek is close.

3
1
#####.#####
#..#.....##
#........e#
#.........#
#...#.....#
.........e#
#........e#
#..#.....##
#........?#
#.........#
#####.#####
enemies 3
sign A locked path — look elsewhere first.

4
1
#####.#####
#.........#
#..#...#.##
#.........#
#....#.#..#
l.........d
#......#..#
#.........#
#..#...#.##
#.........#
#####d#####
locked : 0

5
1
#####d#####
#.........#
#......#..#
#.......#.#
#.........#
#....#.....
#.........#
#.......#.#
#......#..#
#.........#
###########

0
3
###########
#e..?....e#
#...#.....#
#...#.#...#
#.........#
#.........#
#.........#
#.........#
#.........#
#.........#
#####.#####
enemies 2
sign Beware what lurks ahead.

4
0
#####l#####
#.........#
#.........#
#.........#
#.........#
#...#.....l
#..#......#
#.........#
#.#.......#
#.##......#
###########
locked : 1

1
3
#####.#####
#.##......#
#.###.#...#
#....#....#
#.##.#....#
..........#
#.........#
#.........#
#.........#
#.........#
#####.#####

2
4
###########
#.........#
#......#..#
#.......#.#
#.........#
..........#
#.........#
#.#.......#
#..#......#
#.........#
###########

3
3
#####.#####
#e........#
##........#
#e....#...#
#....###..#
#e.#s###..#
#....#....#
#...#..#..#
#..##.....#
#.........#
#####.#####
enemies 3
switch 0 : 0

