4
0
###########
##.#...#.##
#.........#
#.#.#...#.#
#.........#
#....#.#...
#.........#
#.#...#.#.#
#.........#
##.....#.##
#####d#####

7
2
#####.#####
#.........#
#...#.#...#
#...#.....#
#...##....#
#.........#
#..#......#
##.#......#
###.......#
#k........#
###########
key : 3

3
3
#####.#####
##........#
##e#......#
#..###....#
#.###.....#
...##....e#
#.###.....#
#.........#
#.........#
#e........#
#####.#####
enemies 3
door 0 : 0

2
1
#####l#####
#e........#
#.........#
#..#..#..##
#?........#
#e........d
#...#.....#
#.........#
#.........#
#..#......#
#####.#####
enemies 2
sign Seek the matching key before you proceed.

5
0
#####d#####
#.##......#
#.#.......#
#.........#
#.........#
#..#.@.....
#.#..#....#
##..#.....#
###.#.....#
#.........#
#####.#####

1
1
#####.#####
#.........#
#.........#
#...#..##.#
#.#.###.#.#
#....e....#
#....#.#..#
#...###.#.#
#.........#
#.#.......#
#####l#####
locked : 2
boss
enemies 1

3
1
#####.#####
#.........#
#...#.##..#
#...#####.#
#...#####.#
#...##.#..d
#...#.....#
#.........#
#.........#
#.........#
#####l#####
locked : 0

6
3
#####.#####
#.........#
#......#..#
#.......#.#
#.........#
..........#
#.........#
#.........#
#.........#
#.........#
###########

5
1
#####.#####
#.........#
#..#......#
#.#.......#
#.........#
...........
#.........#
#.......#.#
#......#..#
#.........#
###########

5
2
###########
#..k......#
#..#...#..#
#.#.....#.#
#.........#
...........
#.........#
#.........#
#.........#
#.........#
#####.#####
key : 1

6
0
#####.#####
#.........#
#..#......#
#.#.......#
#.........#
#....#....#
#.........#
#.#.......#
#..#......#
#k........#
###########
key : 0

6
2
#####.#####
#.........#
#..#.....##
#.........#
#.........#
#......#...
#.........#
#.........#
#........##
#.........#
#####.#####

0
1
###########
#X........#
#.........#
#....##...#
#...####..#
#....###..#
#...##..#.#
#....#.##.#
#.........#
#.........#
#####.#####

4
1
#####l#####
#.........#
#......#..#
#.......#.#
#.........#
..........#
#.........#
#.#.......#
#..#......#
#.........#
#####.#####

5
3
#####.#####
#?.#.....##
#........e#
#.........#
#...#..#..#
.........e#
#........e#
#........##
#........s#
#.........#
#####.#####
enemies 3
switch 0 : 0
sign A useful tool lies just ahead.

3
2
#####.#####
#........##
#.........#
#.........#
#.........#
d..........
#.........#
#.........#
#.........#
#.........#
###########

4
3
#####.#####
#.........#
#.........#
#.........#
#.........#
#k........#
#.........#
#.........#
#.........#
#.........#
#####.#####
key : 2

2
2
###########
#.........#
#.........#
#.........#
#.........#
d..........
#.........#
#.#....#..#
#.........#
#.........#
#####.#####

2
3
###########
#.........#
#.........#
#.........#
#.........#
..........#
#.........#
#.........#
#.........#
#.........#
#####.#####

