2
0
#####.#####
#.........#
#..#......#
#.........#
#...#.....#
#....@.....
#.........#
#.........#
#.........#
#.........#
#####.#####

2
2
#####.#####
#k........#
#.........#
#.........#
#.........#
..........d
#.........#
#.#.......#
#..#......#
#.........#
#####.#####
key : 3

1
0
###########
#k........#
#..#...#.##
#.........#
#.....#...#
#..........
#..#.#.#..#
#.........#
#.#.#.#.#.#
#.........#
#####.#####
key : 0

4
1
#####.#####
#.........#
#......#..#
#.......#.#
#.........#
#.........l
#.........#
#.#.......#
#..#......#
#.........#
#####d#####

3
3
#####.#####
#.........#
##........#
#.........#
#......#..#
..........#
#....#.#..#
#.........#
##.....#..#
#.........#
#####.#####

3
1
#####.#####
#.........#
#.........#
######....#
#..#......#
...##.....d
#..#......#
#.........#
#.........#
#.........#
#####.#####

6
2
#####.#####
#.........#
#.........#
#.........#
#.........#
#.........#
#.........#
#.........#
#.........#
#X........#
###########

5
2
#####.#####
#.......#.#
#.........#
#.........#
#.........#
l...#e....#
#.##......#
####......#
##.#......#
#.........#
#####.#####
locked : 3
boss
enemies 1

2
1
#####l#####
#e.......e#
#.........#
#...#..#..#
#.........#
...........
#...#..#..#
#.........#
#.........#
##........#
#####.#####
enemies 2

4
2
#####.#####
#.........#
#.....##..#
#....#..###
#....##.#.#
l.....#....
#....#.#..#
#.........#
#.........#
#.........#
#####.#####
locked : 1

2
3
###########
#.........#
#.........#
#.........#
#.........#
d.........#
#.........#
#.........#
#.........#
#.........#
#####.#####

4
3
#####.#####
#.........#
#.........#
#.#..#..#.#
#.........#
..........#
#..#..#...#
#.........#
#.........#
#.#......k#
###########
key : 5

0
1
###########
#.........#
#.##....#.#
#.#.......#
#.........#
#.........#
#.........#
#........##
#.........#
#.........#
#####.#####

1
1
#####.#####
#.........#
#.........#
#.........#
#.........#
...........
#.........#
#.........#
#.........#
#.........#
#####l#####
locked : 0

1
2
###########
##.....#.##
#.........#
#..#.#.#..#
#.........#
...#.#....#
#.........#
##.#.#.#.##
#.........#
##.#......#
#####.#####

3
2
#####.#####
#.........#
#.........#
#.........#
#.........#
d..........
#.........#
#.........#
#.........#
#.........#
#####.#####

5
1
#####d#####
#.........#
#.........#
#.........#
#.........#
#.........l
#.........#
#.........#
#.........#
#.........#
###########

3
0
#####.#####
#.........#
#.#.#...#.#
#.........#
#.#.#.#.#.#
#..........
#.#...#.#.#
#.........#
#...#.#.#.#
#k........#
###########
key : 1

