2
1
###########
#.........#
#......#.##
#.........#
#.#.#.#.#.#
#.........#
#......#..#
#.........#
#.......#.#
#.........#
#####D#####

0
4
###########
#X........#
#.........#
##..#.....#
#.#.##....#
#...#.....#
#.####....#
###.#.....#
#.........#
#.........#
#####D#####

4
4
#####D#####
#.........#
#.........#
#...#..#..#
#.#.......#
D......#..#
#.........#
#.........#
#.........#
#.........#
###########

3
1
#####D#####
#k........#
##.#...#.##
#.........#
#..#.#.#..#
D.........D
#......#..#
#.........#
##.#...#.##
#.........#
#####D#####
key : 0

3
5
#####D#####
#.........#
#.........#
#.#..#..#.#
#.........#
d.........#
#..#..#...#
#.........#
#.........#
#.......#.#
###########

5
2
#####D#####
#.........#
#......#..#
#.......#.#
#.........#
D.........D
#..#......#
#.........#
#.........#
#....k....#
###########
key : 3

5
1
#####D#####
#.........#
#.........#
#.........#
#.........#
#.........D
#.........#
#.........#
#s........#
#e........#
###########
enemies 1
switch 0 : 0 1

4
2
#####D#####
#.........#
#.........#
#.........#
#.........#
D.........D
#.........#
#.......#.#
#......#..#
#.........#
#####D#####

3
2
###########
#.....k...#
#.#...#...#
#.........#
#.....#.#.#
D.........d
#.#.#.#...#
#.........#
#.#.....#.#
#.........#
#####D#####
key : 1

4
1
#####D#####
#.........#
##.....#.##
#.........#
#...#.#...#
#.........D
#..#.#.#..#
#.........#
#.#.#.#.#.#
#.........#
#####D#####

2
4
#####l#####
#.........#
#......#..#
#.......#.#
#.........#
D.........D
#.........#
#.........#
#.........#
#.........#
#####D#####

3
3
#####d#####
#.........#
#......#..#
#.......#.#
#.........#
d.........l
#.........#
#.#.......#
#..#......#
#.........#
#####D#####

2
3
###########
#.........#
#.........#
#....####.#
#....#.#..#
#....#....D
#....#.##.#
#....##...#
#.........#
#.........#
#####d#####

1
4
#####D#####
#.........#
#.........#
#.###.....#
#..###....#
#..##e....#
#...##....#
#.###.....#
#..##.....#
#.........#
#####l#####
locked : 3
boss
enemies 1

2
5
###########
#.......ee#
#........e#
#.........#
#.........#
D.........#
#.........#
#.........#
#.........#
#.........#
#####D#####
enemies 3
door 0 : 0 1

3
4
#####D#####
##.....#..#
#.........#
#.........#
#.#..#..#.#
l.........d
#.........#
##..#.....#
#.........#
#.........#
#####D#####
locked : 2

4
3
#####D#####
#k........#
#.........#
#......p..#
#.........#
D.........D
#.........#
#.........#
#.........#
#.........#
#####d#####
key : 2

3
0
###########
#?........#
#.........#
#.........#
#.........#
#....@....D
#.........#
#.........#
#.........#
#.........#
###########
sign A useful tool lies just ahead.

5
3
#####d#####
#.........#
#..#...#..#
#.#.....#.#
#....#....#
D.........#
#.........#
#.#.......#
#..#......#
#.........#
###########

