3
5
###########
#.........#
#.........#
#.........#
#.........#
..........#
#.........#
#.#.......#
#..#......#
#.........#
###########

5
1
#####.#####
#..#.....##
#.........#
#.........#
#..#......#
...........
#.........#
#........##
#.........#
#....k....#
###########
key : 1

5
0
#####d#####
#.........#
#.......#.#
#.........#
#.........#
#..#.......
#.........#
#.........#
#.........#
#.........#
###########

3
0
###########
#k........#
#.........#
#.........#
#.........#
#..........
#.........#
#.........#
#.........#
#.........#
#####.#####
key : 0

3
1
###########
#.........#
#..#......#
#.#.......#
#.........#
...........
#.........#
#.#.....#.#
#..#...#..#
#.........#
#####.#####

2
4
#####d#####
#.........#
#.........#
#.........#
#......##?#
.......#e.#
#.......#.#
#.........#
#.........#
#.........#
#####.#####
enemies 1
sign What you seek is close.

1
4
#####.#####
#.........#
#.........#
#.........#
#.##......#
...#.e....#
#.#.......#
#.........#
#.........#
#.........#
#####d#####
boss
enemies 1

4
1
#####.#####
#.........#
#..#......#
#.#.......#
#.........#
...........
#.........#
#.........#
#.........#
#.........#
#####.#####

3
2
###########
#......#..#
#..#......#
#.#.......#
#.........#
..........l
#.........#
#.........#
#.........#
##.......##
#####l#####
locked : 2

4
0
#####.#####
#.........#
#.........#
#.........#
#.........#
#?...@.....
#....#....#
#.........#
#.........#
#..#......#
#####d#####
sign A useful tool lies just ahead.

2
3
#####.#####
#.........#
#.........#
#...###.#.#
#...k#.#..#
#...##.#...
#.........#
#...#.....#
#..#......#
#.........#
#####.#####
key : 3

5
2
#####l#####
#.........#
#.........#
#.........#
#.........#
..........#
#.........#
#.........#
#.........#
#.........#
###########
locked : 0

3
3
#####.#####
#.........#
#.........#
#.##.#....#
#.####....#
l...##....d
#..###....#
#.#.###...#
#.#.......#
#.........#
#####.#####
locked : 1

1
3
###########
#.........#
#..#......#
#.#.......#
#.........#
#..........
#.........#
#.#.......#
#..#......#
#.........#
#####.#####

4
2
#####l#####
#.........#
#.........#
#.........#
#.........#
...........
#.........#
#.........#
#.........#
#.........#
#####l#####

4
4
#####d#####
#.........#
#.........#
#.....#..##
#.........#
..........#
#..#..#...#
#.........#
#.........#
#..#.....##
###########

3
4
#####.#####
#.........#
#.........#
#.........#
#.........#
d..........
#.........#
#.........#
#.........#
#.........#
#####d#####

4
3
#####.#####
##.#...#.##
#.........#
##...#.#.##
#.........#
...#.#.#...
#.........#
##.#.#.#.##
#.........#
##k#...#..#
###########
key : 2

0
4
###########
#X........#
#.........#
#.........#
#.........#
#.........#
#.........#
#.........#
#.........#
#.........#
#####.#####

