3
0
#####D#####
#?........#
##..#.....#
#####..#..#
#..#@..#..#
#....#....D
#.........#
#.........#
#...#.....#
#........##
#####D#####
sign The dungeon remembers all who enter.

2
2
#####D#####
#.........#
#.........#
##..#..#..#
#.........#
l.........d
#....#..#.#
#.........#
#.........#
##.....#..#
#####D#####
locked : 2

6
3
#####D#####
#.........#
#.........#
#.........#
#.........#
#...##....#
#.##......#
#.####....#
#.#.......#
#X#.......#
###########

3
1
#####D#####
#.........#
#.........#
#..#..#..##
#.........#
D.........D
#.....#...#
#.........#
#.........#
#..#.....##
#####D#####

4
1
#####D#####
##........#
#####.....#
######....#
#.####....#
D..#......d
#.##......#
#.........#
#.........#
#.........#
###########

4
0
#####D#####
#.........#
#.........#
#.........#
#...###...#
#....#....D
#...##..#.#
#....##...#
#......##.#
#.........#
###########

2
0
###########
#e.....#..#
#...#?###.#
#...e##...#
#...#.#...#
#...p.....D
#.....#...#
#.........#
#.....#...#
#.........#
#####D#####
enemies 2
sign The dungeon remembers all who enter.

4
3
###########
#.........#
#.........#
#.........#
#.........#
d.........D
#.........#
#.........#
#.........#
#.........#
#####D#####

1
2
###########
#.........#
#.........#
#...#..#..#
#.........#
d.........D
#...#..#..#
#.........#
#.........#
##........#
#####D#####

1
3
###########
#.#.....#k#
#.........#
#.........#
#.....#...#
D.........#
#.........#
#.#..#..#.#
#.........#
#.........#
#####D#####
key : 6

4
4
###########
#........k#
#.........#
#.........#
#.........#
D.........#
#.........#
#.......#.#
#......#..#
#.........#
###########
key : 5

5
3
#####D#####
#.........#
#.........#
#.........#
#.........#
l....e....#
#.....###.#
#.....#.#.#
#.....#.#.#
#.........#
#####D#####
locked : 5
boss
enemies 1

5
2
#####D#####
#.........#
#........##
#....###.##
#....##...#
#.....##..l
#....##.#.#
#.........#
#.........#
#k........#
###########
key : 3

4
2
#####D#####
#.........#
#.........#
#.....#...#
#.........#
d.........d
#..#..#...#
#.........#
#.........#
#..#.....##
#####D#####

1
1
#####l#####
#.........#
#.........#
#.....#####
#....##k#.#
#....##...d
#....###..#
#.....##..#
#.........#
#.........#
#####D#####
key : 2

0
1
###########
#.........#
###.#.....#
#.#.##....#
#.###.....#
#....#....#
#.#.##....#
#.........#
#.........#
#.........#
#####l#####
locked : 3

3
2
#####D#####
#.........#
#.........#
#.#.....#.#
#.........#
D.........#
#.#..#..#e#
#.........#
#.........#
#.......#.#
#####D#####
enemies 1

2
1
#####D#####
##.#...#.##
#.........#
##.......##
#.........#
D..#.#.#..l
#.........#
##.#.#...##
#.........#
##.....#.##
#####D#####

2
3
#####D#####
#.........#
#.........#
#.......#.#
#.........#
d.........#
#.........#
#.#.......#
#..#......#
#.........#
###########

