2
0
#####.#####
##?#......#
#..#......#
#e#....#..#
#e#.......#
#.e##.....d
#.........#
#.........#
#.........#
#.........#
#####.#####
enemies 3
sign A useful tool lies just ahead.

3
1
#####.#####
#k#.....#.#
#.........#
#.........#
#.#..#..#.#
..........d
#.........#
#....#....#
#.........#
#.........#
#####.#####
key : 0

2
3
###########
#........X#
#.........#
#.........#
#.........#
..........#
#.........#
#.........#
#.........#
#.........#
###########

6
0
#####d#####
#.........#
#.........#
#....###..#
#....#....#
#....###...
#....#.#..#
#.........#
#.........#
#.........#
###########

1
1
#####.#####
##.....#..#
#.........#
#.........#
#...#..#..#
...........
#.........#
#...#..#..#
#.........#
#k........#
#####.#####
key : 4

2
1
#####.#####
#.#.....#.#
#.........#
#.........#
#..#..#...#
d.........l
#.........#
#.#..#..#.#
#.........#
#.........#
#####.#####

1
2
###########
#........k#
#.........#
#.......#.#
#.........#
..........#
#.........#
#.#.....#.#
#..#...#..#
#.........#
#####.#####
key : 6

1
0
#####.#####
#.........#
#......#..#
#.........#
#.........#
#......#...
#.........#
#.........#
##..#.....#
#k........#
#####.#####
key : 1

6
1
#####l#####
#.........#
#.........#
#.........#
#.........#
..........#
#.........#
#.........#
#.........#
#.........#
###########
locked : 1

4
0
#####.#####
#.........#
#.........#
#.........#
#.........#
#....@.....
#.........#
#.........#
#.........#
#.........#
#####.#####

2
2
#####.#####
#.........#
#.........#
#.........#
#.........#
l..#.e#....
#.##......#
#.#.......#
#.........#
#.........#
#####.#####
locked : 4
boss
enemies 1

0
0
###########
#e........#
#s........#
#.........#
#.....#...#
#..#.......
#..###....#
#..##.....#
#.........#
#.........#
#####.#####
enemies 1
switch 0 : 0 1

0
1
###########
#.......?e#
#.........#
#.....##..#
#.....#e..#
....#..#..#
#...##.#..#
#...#..#..#
#.........#
#.........#
#####.#####
enemies 2
door 0 : 0 1
sign Something glints behind that door…

4
1
#####.#####
#.........#
#..#...#..#
#.#.....#.#
#.........#
...........
#.........#
#..#..#...#
#.....#...#
#.........#
#####.#####

4
2
#####.#####
#.........#
#.........#
#.........#
#.#.....#.#
..........#
#.........#
#....#..#.#
#.........#
#.........#
###########

3
0
#####.#####
#.........#
#.........#
#.#..#..#.#
#.........#
#..........
#.#..#..#.#
#.........#
#.........#
#.#.....#.#
#####.#####

5
0
#####.#####
#.........#
#.........#
#....#....#
#.........#
#.........d
#.........#
#.........#
#.........#
#.........#
#####d#####

3
2
#####.#####
#.#.....#.#
#.........#
#...#...#.#
#.........#
d...#.#...#
#.........#
#.#...#.#.#
#.........#
#.........#
#####.#####

5
1
#####.#####
#.........#
#.#.#.#.#.#
#.........#
#.#.#.....#
d.........#
#.#.#.#...#
#.........#
#.#...#...#
#.........#
#####l#####

