3
3
###########
#.........#
#.........#
#.........#
#.........#
l.........#
#.........#
#.#.......#
#..#......#
#.........#
#####.#####
locked : 2

0
5
###########
#.....?..e#
####..#...#
###.###...#
#.#..##...#
...#..#...#
#...#.....#
#.........#
#.........#
#........e#
###########
enemies 2
door 0 : 0 1
sign Many have walked this path.

5
0
#####.#####
##.....#..#
#.........#
##...#.#..#
#.........#
#..#.#.#...
#s........#
##?#.#.#.##
#e........#
##e#.....##
###########
enemies 2
switch 0 : 0 1
sign What you seek is close.

5
2
#####.#####
#..#...#.##
#.........#
#.#.#.#.#.#
#.........#
...#.#.#..#
#.........#
#.#.#.#...#
#.........#
##.#...#k##
###########
key : 2

6
1
#####.#####
#.........#
#..#......#
#.#.......#
#.........#
#.........#
#.........#
#.......#.#
#......#..#
#k........#
###########
key : 3

4
2
#####.#####
#......#..#
#.........#
#.........#
#.#..#..#.#
d.........l
#.........#
##..#..#..#
#.........#
#.........#
#####.#####

2
2
#####l#####
#.........#
#.........#
#.........#
#.........#
...#......#
#..#.#....#
#...#.....#
#.........#
#.........#
#####l#####
locked : 1

1
3
#####.#####
##.....#..#
#.........#
#.........#
#.#.....#.#
d..........
#.........#
#......#..#
#.........#
#.........#
###########

0
4
###########
#.........#
#.........#
#.......#.#
#...#.##..#
d...e###...
#.#..#.##.#
#.##......#
##........#
#.........#
#####.#####
boss
enemies 1

0
3
###########
#.........#
#..#...#..#
#.#.....#.#
#.........#
#.........d
#.........#
#.#.......#
#..#......#
#.........#
#####.#####

2
1
###########
#k........#
#.....#.#.#
#.........#
#.#.#.#.#.#
#..........
#.#.#.#...#
#.........#
#.#.#.#.#.#
#.........#
#####.#####
key : 1

4
1
#####.#####
#.........#
##.#...#.##
#.........#
#.#.#.#.#.#
..........d
#....#....#
#.........#
#.#.#.#.#.#
#.........#
#####.#####

4
0
###########
#?........#
#.........#
#.........#
#.........#
#....@.....
#.........#
#.........#
#.........#
#.........#
#####.#####
sign Strange symbols cover the floor.

1
2
###########
#.........#
#......#..#
#.......#.#
#.#.......#
#.........d
#.........#
#.#.......#
#..#.....##
#.........#
#####l#####
locked : 3

3
1
#####.#####
#.........#
#.........#
#.........#
#...###...#
#...###....
#...###...#
#.#####...#
#.#.#.....#
#.#.....#.#
#####.#####

4
3
#####.#####
#.........#
#..#......#
#.#.......#
#.........#
l.........#
#.........#
#.#.....#.#
#..#...#..#
#.........#
###########
locked : 0

3
2
#####l#####
#e........#
#.........#
#.........#
#.........#
...##.....l
#..#e.....#
#...#.....#
#.........#
#e........#
#####.#####
enemies 3

1
4
#####.#####
#.........#
#.........#
#.........#
#.........#
..........#
#.........#
#.........#
#.........#
#........X#
###########

5
1
#####.#####
#k........#
#..#......#
#.#.......#
#.........#
...........
#.........#
#.........#
#.........#
#.........#
#####.#####
key : 0

