0
2
###########
##.#..?#ee#
#........e#
#....#.#.##
#.........#
D....#.#..#
#.........#
##.#.#.#.##
#.........#
##.#...#.##
#####D#####
enemies 3
sign Many have walked this path.

3
4
#####D#####
#.........#
#.........#
#.........#
#.........#
d....e....#
#.........#
#.........#
#.....#...#
#.........#
#####D#####
boss
enemies 1

4
2
#####D#####
#.........#
#......#..#
#....#.#..#
#.........#
#.........#
#.........#
#.........#
#e........#
#e?......e#
###########
enemies 3
door 0 : 0
sign Beware what lurks ahead.

1
1
#####D#####
##.....#..#
#.........#
#.........#
#.........#
D.........D
#.........#
#.#.....#.#
#..#...#..#
#s........#
#####D#####
switch 1 : 1 2

2
1
#####D#####
#.........#
##.#...#.##
#.........#
#....#.#..#
D.........D
#..#.#.#..#
#.........#
#..#.....##
#.........#
#####D#####

2
5
###########
#........k#
#.........#
#..##.....#
#..#......#
D.........#
#.........#
#.........#
#.........#
#.........#
###########
key : 4

1
3
###########
#.......ee#
#........?#
#..##.....#
#.#.#.....#
D.........#
#.........#
#.........#
#.........#
#.........#
#####D#####
enemies 2
door 1 : 1 2
sign The dungeon remembers all who enter.

2
3
#####D#####
#.........#
#......#..#
#.......#.#
#.........#
d.........D
#.........#
#.........#
#.........#
#.........#
#####D#####

2
2
#####d#####
#.........#
#.........#
##.#.#....#
#..#.#....#
D..#.#....d
#..###....#
#####.....#
#.........#
#.........#
#####d#####

1
0
###########
#.........#
#.........#
#.........#
#.........#
#.........D
#.........#
#.#.....#.#
#..#...#..#
#.........#
#####D#####

2
0
#####D#####
#e........#
#...#.....#
#...#.....#
#e.##.....#
#e........D
#s........#
#.........#
#.........#
#.........#
#####D#####
enemies 3
switch 0 : 0

3
1
#####D#####
#.........#
#.........#
#.........#
#.........#
D.........D
#.........#
#.........#
#.........#
#....k....#
###########
key : 0

1
2
#####D#####
#......#..#
#.....##..#
#....###..#
#.....#.#.#
D.........D
#.........#
#.........#
#.........#
#.........#
#####d#####

3
0
#####D#####
#.........#
#.........#
#.........#
#.........#
#....@....D
#.........#
#.........#
#.........#
#.........#
###########

0
1
###########
#.........#
#.........#
#.........#
#.........#
#.........D
#.........#
#.........#
#.........#
#.........#
#####D#####

3
3
#####D#####
#.........#
#.........#
#.........#
#.........#
D..#......d
#.#.#.....#
##..#.....#
##........#
####k.....#
###########
key : 2

2
4
###########
#.........#
#.........#
#...#.....#
#..#k.....#
D..##.....D
#.........#
#.........#
#.........#
#.........#
#####D#####
key : 3

3
2
#####d#####
#.........#
#.........#
#..#..#...#
#.........#
D.........D
#...#..#..#
#.........#
#.........#
#..#.....##
#####D#####

4
4
#####D#####
#.........#
#.........#
#...p.....#
#.........#
#.........#
#.........#
#p........#
#.........#
#X........#
###########

