3
1
#####.#####
#k#.......#
#.##......#
#.#.......#
#.........#
...........
#.........#
#.........#
#.........#
#.........#
#####.#####
key : 0

2
1
#####d#####
#.........#
#.........#
#.........#
#.........#
l..........
#.........#
#.........#
#.........#
#.........#
#####.#####
locked : 1

1
1
#####.#####
#......#..#
#.....###.#
#.....###.#
#....#....#
#....##...l
#......##.#
#.........#
#.........#
#.........#
#####d#####

4
3
###########
##.#......#
#.........#
#.#.#.#.#.#
#.........#
d..#.#.#..#
#.........#
#.#.#.#...#
#.........#
#..#...#..#
#####.#####

6
2
#####.#####
#.#.......#
#..#......#
#.###.#...#
#..###....#
..........#
#.........#
#.........#
#........?#
#.......ee#
###########
enemies 2
sign Only the prepared may pass.

5
0
#####.#####
#.........#
##..#..#..#
#.........#
#.........#
#....#.....
#.........#
#.........#
##..#..#..#
#.........#
###########

1
2
###########
#.........#
#...#.....#
#...##..#.#
#...#.#.#.#
l...#e#...#
#...#..##.#
#...#.###.#
#.........#
#.........#
#####.#####
locked : 2
boss
enemies 1

5
2
#####.#####
#k........#
#.........#
#.........#
#.........#
...........
#.........#
#.......#.#
#......#..#
#.........#
#####.#####
key : 3

4
0
#####l#####
#.........#
#.........#
#.........#
#.........#
#.....#....
#.....##..#
#.....#...#
#.........#
#.........#
#####.#####
locked : 0

5
3
#####.#####
#.#.....#.#
#.........#
#..#.#.#.##
#.........#
....#.#...#
#.........#
#..#.#.#.##
#........?#
#.#......e#
###########
enemies 1
door 0 : 0 1
sign What you seek is close.

4
2
#####d#####
####......#
#.##......#
#....##...#
#.##......#
....##....d
#.........#
#.........#
#.........#
#.......#.#
#####.#####

3
0
#####.#####
#.........#
#.........#
#.........#
#...##.#..#
#...#@#....
#...#.#.#.#
#...#..##.#
#......##.#
#.........#
#####l#####

2
0
###########
#.........#
#.........#
#.........#
#.........#
#.........l
#.........#
#.........#
#.........#
#.........#
#####.#####

4
1
#####.#####
#k........#
#..#......#
#.#.......#
#.........#
...........
#.........#
#.......#.#
#......#..#
#.........#
#####.#####
key : 1

0
1
###########
#e.......e#
##?#......#
#s........#
#..#......#
#.........#
#..#.#.#..#
#.........#
##.....#.##
#.........#
#####.#####
enemies 2
switch 0 : 0 1
sign The dungeon remembers all who enter.

6
1
#####l#####
#.........#
#.........#
#.........#
#.........#
#..........
#.........#
#.........#
#.........#
#.........#
###########
locked : 3

2
2
#####.#####
#X#.......#
#..#......#
#.........#
#.........#
..........#
#.........#
#.........#
#.........#
#.........#
#####.#####

5
1
#####.#####
#k........#
#.........#
#...##....#
#.........#
...#.#.....
#..#......#
##.#......#
#.........#
#.........#
#####l#####
key : 2

3
2
#####.#####
#.##......#
#.#.......#
#...#.....#
#.........#
..........#
#.........#
#.#.#.#...#
#..#......#
##........#
#####d#####

