2
0
#####.#####
#.........#
#......#..#
#.......#.#
#.........#
#..........
#.........#
#.........#
#.........#
#.........#
#####d#####

2
1
#####.#####
#.........#
#..#......#
#.#.......#
#.........#
...........
#.........#
#.#.......#
#..#......#
#.........#
#####.#####

4
2
#####l#####
#.........#
#......#..#
#.........#
#.....#...#
...........
#.........#
#.........#
#.........#
#.........#
###########
locked : 0

3
0
#####d#####
#.#.......#
#.......#.#
#.........#
#.........#
#..........
#.........#
#.#.....#.#
#..#...#..#
##........#
#####.#####

1
0
#####d#####
#.........#
#..##.#...#
#...#.....#
#..##.#...#
#..#k#.....
#.#.......#
#.........#
#.........#
#.........#
#####.#####
key : 1

6
3
#####.#####
#.........#
#...#.....#
##.#......#
#.#.......#
#..#......#
#.........#
#.##......#
#.........#
#X........#
###########

3
3
#####l#####
#.......#k#
#.........#
#........##
#.#.......#
..........#
#.........#
#.#.......#
#..#......#
#.........#
#####d#####
key : 3

5
0
#####.#####
#......#..#
#.....##.##
#....#.#.##
#....#.#..#
#....@....#
#.........#
#.........#
#........##
#.........#
###########

3
2
#####.#####
#.........#
#.........#
#.........#
#.........#
...........
#.........#
#.........#
#.........#
#.........#
#####l#####

3
1
#####.#####
#?........#
#.........#
#.###.....#
#.####....#
...s#......
#.##e.....#
#####.....#
#........##
#........e#
#####.#####
enemies 2
switch 0 : 0
sign Those who search shall find.

4
3
#####d#####
#.........#
#..##.....#
#.#.......#
#.........#
..........#
#.........#
#.........#
#..#......#
#.........#
#####d#####

4
0
#####.#####
#.........#
#.#.#.#.#.#
#.........#
#e#.#.#.#.#
#.?........
#e#.#.#.#.#
#.........#
#.#.#.#.#.#
#.........#
#####.#####
enemies 2
sign Those who search shall find.

5
3
#####d#####
#.........#
#.........#
#.........#
#......#..#
#....e....#
#.........#
#.........#
#.........#
#.........#
#####.#####
boss
enemies 1

4
1
#####.#####
#.........#
#.........#
##..#..#..#
#.........#
...........
#...#.....#
#.........#
#.........#
##....k#..#
###########
key : 0

0
0
###########
#.........#
#.........#
#..#..#...#
#.........#
#.........#
#......#..#
#.........#
#.........#
#........##
#####d#####

2
2
#####.#####
#.#.......#
#.........#
#....#.#.##
#.........#
....#.#....
#.........#
#..#...#.##
#.........#
#.#.....#.#
#####.#####

2
3
###########
#.........#
##.##.#...#
#..#..##..#
#..#......#
....##....#
#.#.......#
#.........#
#.........#
#.........#
#####l#####
locked : 3

1
1
###########
#.........#
#.#.......#
#.#..#....#
#..#......#
...####....
#.######..#
#..#k##...#
#.....#...#
#..#...#..#
#####.#####
key : 2

1
2
###########
#......?ee#
#........e#
#.........#
#.........#
..........#
#.........#
#.........#
#.........#
#.........#
#####.#####
enemies 3
door 0 : 0
sign Those who search shall find.

