5
0
#####d#####
##.#...#.##
#.........#
#.#...#.#.#
#.........#
#..#.#.#..D
#.........#
#.#...#.#.#
#.........#
#......#.##
###########

1
0
#####D#####
#.........#
#......##.#
#.....#?#.#
#....#....#
#....@.#..D
#....#..#.#
#.........#
#........##
#.........#
#####D#####
sign Many have walked this path.

0
0
###########
#.........#
#..#......#
#.#.......#
#.........#
#.........d
#.#....#..#
#.#......##
#..#......#
#.........#
#####D#####

3
0
#####D#####
##........#
#.........#
#.........#
#e#.....#.#
#.........D
#?........#
##..#..#..#
#.........#
#.........#
#####D#####
enemies 1
sign Those who search shall find.

4
4
#####D#####
#.........#
#.........#
#.........#
#.........#
D.........#
#.........#
#.........#
#.........#
#........X#
###########

3
4
###########
#.........#
#.........#
#..#......#
#.#.......#
d....e....D
#.........#
#.........#
#.........#
#.........#
#####D#####
boss
enemies 1

3
5
###########
#........e#
##.#.....##
#.........#
#..#.#....#
D.........#
#......#..#
#.........#
##.#...#.##
#......?.e#
###########
enemies 2
sign The dungeon remembers all who enter.

3
1
#####D#####
#.........#
#...#.....#
#...#.....#
#..#k.....#
D..####...l
#....#....#
#......#..#
#.........#
#.........#
#####D#####
key : 1

3
2
###########
#.........#
#..#...#..#
#.#.....#.#
#.........#
l.....#...l
#.........#
#....#..#.#
#......#..#
#.........#
###########
locked : 1

4
0
#####D#####
#.........#
#..#......#
#..#....#.#
#..#..##..#
#k....##..D
#.........#
#.........#
#.........#
#.........#
#####d#####
key : 0

3
3
###########
#.........#
#.#.#.#.#.#
#.........#
#.#.#.#...#
l.........d
#...#.#.#.#
#.........#
#.#.#.#.#.#
#.........#
#####D#####
locked : 2

4
1
#####D#####
#.........#
##.......##
#.........#
#...#.#...#
D.........#
#..#.#.#..#
#.........#
#...#.#.#.#
#.........#
#####D#####

5
1
#####D#####
#.........#
#.........#
#.........#
#.........#
D......#..#
#....###..#
#.......#.#
#.....##..#
#........k#
###########
key : 2

4
3
#####D#####
#.........#
#.........#
#.........#
#.........#
#.........D
#.........#
#.........#
#p........#
#k........#
###########
key : 3

0
1
###########
#.........#
#.#.#.#.#.#
#.........#
#...#...#.#
d.........#
#.#.#...#.#
#.........#
#.#...#.#.#
#.........#
#####D#####

2
0
#####D#####
#.........#
##.#.....##
#.........#
#..#.#.#..#
#.........D
#......#..#
#.........#
##.#.....##
#.........#
#####D#####

2
1
#####D#####
##.#...#.##
#.........#
#.#...#.#.#
#.........#
D..#.#....#
#.........#
#.#.#.#.#.#
#.........#
##.#...#.##
#####D#####

1
1
#####D#####
#.........#
#......#..#
#...####..#
#.....##..#
D.........#
#.........#
#.........#
#.........#
#.........#
#####D#####

