3
0
###########
#k........#
#.........#
#.........#
#.........#
#.........D
#.........#
#.#.......#
#..#......#
#.........#
#####D#####
key : 0

6
2
#####D#####
##........#
#.........#
#.........#
#.#.....#e#
D........s#
#.........#
##..#.....#
#.........#
#.........#
#####D#####
enemies 1
switch 0 : 0

1
2
###########
#.......ee#
#........e#
#.........#
#.........#
D...#.....#
#.##?.....#
#...#.....#
#.........#
#.........#
#####D#####
enemies 3
sign A locked path — look elsewhere first.

7
1
#####D#####
#.#.......#
#.........#
#.#.#.#.#.#
#.........#
#...#.....D
#.........#
#.#.#.#...#
#.........#
#.......#.#
###########
door 0 : 0

7
2
#####D#####
#.........#
##..#.....#
#.........#
#.........#
D...#.....#
#.........#
#.........#
##..#..#..#
#......e.e#
###########
enemies 2
door 1 : 1 2

4
2
#####D#####
##.#.....##
#.........#
##.#.#.#.##
#.........#
d..#.#.#..d
#.........#
#..#......#
#.........#
#..#...#.##
#####D#####

4
3
###########
#.........#
#......#.##
#.........#
#..#...#..#
d.........#
#..#.#.#..#
#.........#
##.#.....##
#.........#
###########

4
0
#####D#####
#.........#
#.........#
#.........#
#.........#
#...p@....D
#......#..#
#....#...##
#.......###
#........?#
#####D#####
sign The brave are rewarded.

5
1
#####D#####
#.........#
#..#......#
#.#.......#
#.........#
D.........D
#.........#
#.......#.#
#......#..#
#.........#
#####D#####

4
1
#####D#####
#.........#
#.#.....#.#
#.........#
#.........#
D.....#...d
#.........#
#.........#
#.......#.#
#.........#
#####D#####

2
1
#####l#####
#.........#
#.........#
#.........#
#.........#
#.........D
#.........#
#.#.......#
#..#......#
#.........#
#####l#####
locked : 0

5
0
#####D#####
#......#..#
#.p.......#
#......#..#
#.........#
#.........D
#.........#
#.........#
#.........#
#.........#
###########

6
1
#####D#####
##........#
#.........#
#.........#
#k#..#..#.#
#.........D
#.........#
##.....#..#
#.........#
#.........#
#####D#####
key : 3

2
2
#####D#####
##e#......#
#.?##.....#
#.###.....#
#..##.....#
D..#e....e#
#...#.....#
#.........#
#.........#
#s........#
#####D#####
enemies 3
switch 1 : 1 2
sign This door will not yield without a key.

0
1
###########
#X........#
#......#..#
#.....###.#
#....####.#
#....##...#
#.........#
#.........#
#.........#
#.......###
#####D#####

1
1
#####D#####
#..#......#
#..##.....#
#..####...#
#....##...#
#..#.e.#..D
#....###..#
#.........#
#.........#
#.........#
#####l#####
locked : 3
boss
enemies 1

3
1
#####l#####
#k........#
#..#......#
#.#.......#
#.........#
D.........d
#.........#
#.#.......#
#..#......#
#.........#
#####D#####
key : 1

3
2
#####D#####
#.........#
#..#......#
#.#.......#
#.........#
d.........#
#.........#
#.#.......#
#..#......#
#.........#
#####D#####

5
2
#####D#####
#.........#
#.........#
#.........#
#.........#
D........k#
#.........#
#.........#
#.........#
#.........#
#####D#####
key : 2

