5
0
#####D#####
#.........#
#..#...#..#
#.#.....#.#
#.........#
#.........D
#.........#
#.#.....#.#
#..#...#..#
#.........#
###########

2
1
#####D#####
#e.......?#
#.........#
#.........#
#..##.....#
D..#e#.#..d
#..#......#
#.....###.#
#.........#
#e........#
#####l#####
enemies 3
sign Turn back; you are not yet ready.

0
2
###########
#......k..#
#......#..#
#.......#.#
#.........#
D.........D
#.........#
#.........#
#.........#
#.........#
#####D#####
key : 4

1
3
#####D#####
#......#..#
#......#..#
#....#.?#.#
#....###..#
D..##.....#
#...#.....#
#.........#
#........e#
#.......ee#
###########
enemies 3
door 0 : 0
sign What you seek is close.

2
2
#####D#####
#.........#
#.#.......#
#.........#
#....#.#..#
d.........#
#.#...#.#.#
#.........#
#..#...#.##
#.........#
###########

4
1
#####D#####
#.........#
#.........#
##.....#.##
#.........#
D..#.#.#..D
#.........#
##...#...##
#.........#
##.#...#.##
#####d#####

1
1
#####D#####
#.........#
#...#...#.#
#.........#
#.#.....#.#
D.........D
#...#.#...#
#.........#
#.#.#.#.#.#
#.........#
#####D#####

5
1
#####d#####
#.........#
#......#..#
#.......#.#
#.........#
D.........D
#.........#
#.........#
#.........#
#.........#
###########

2
0
#####D#####
###.......#
##.##.....#
#..#...##.#
#.#?@##.#.#
#..#.#....D
#....#....#
#.....###.#
#.........#
#.........#
#####D#####
sign The brave are rewarded.

1
0
###########
#k........#
#.........#
#....##...#
#...#.....#
#....##...D
#.........#
#.........#
#.........#
#.........#
#####D#####
key : 0

1
2
#####D#####
#s........#
#.........#
#....#e##.#
#.....###.#
D.....e#..D
#.##..###.#
#....###..#
#.........#
#?........#
#####D#####
enemies 2
switch 0 : 0
sign Those who search shall find.

0
1
###########
#e#.....#.#
#.........#
#e#.#.#.#.#
#.........#
#...#.#...D
#.........#
#...#...#.#
#.........#
#.......#.#
#####D#####
enemies 2

4
2
###########
#........k#
#...#.#...#
#.........#
#....#....#
D.........#
#...#.#.#.#
#.........#
#..#...#.##
#.........#
#####d#####
key : 6

3
0
#####D#####
#.#.......#
#.........#
#.........#
#.#..#....#
#.........D
#.........#
#.......#.#
#.........#
#.........#
#####d#####

6
2
#####D#####
#.........#
##........#
#..#......#
#.........#
#.........#
#.........#
#.........#
#.........#
#X........#
###########

3
1
#####l#####
#.........#
#......#..#
#.......#.#
#.........#
D.........#
#.........#
#.........#
#.........#
#.........#
#####D#####
locked : 0

5
2
#####d#####
#.........#
#.........#
#.....p...#
#.........#
D....e....#
#..p......#
#.........#
#.........#
#.........#
#####D#####
boss
enemies 1

4
0
#####d#####
#.........#
#.........#
#....#....#
#.........#
#.....#...D
#.........#
#.........#
#........##
#.........#
#####D#####

0
3
###########
#........k#
#...#.....#
#...p.#...#
#.........#
D.........#
#...p.....#
#.........#
#.........#
#.........#
#####D#####
key : 8

