1
0
#####l#####
#.........#
#......#..#
#.......#.#
#.........#
#..........
#.........#
#.#...#k#.#
#..#...#..#
#.........#
#####.#####
key : 0

2
3
#####.#####
#.........#
#..#......#
#..#......#
#.........#
d.........l
#.........#
#.......#.#
#.........#
#.........#
#####d#####

1
2
#####l#####
#k........#
#.........#
#.........#
#.........#
...........
#.........#
#.......#.#
#......#..#
#.........#
#####.#####
key : 2

4
2
#####.#####
#.........#
#......#..#
#.....##..#
#......#..#
#....##...#
#k#...###.#
#####.....#
#...#.....#
#.........#
###########
key : 4

0
2
###########
#.........#
#.........#
#.....#...#
#.....#...#
#.........d
#....##...#
#......#..#
#......#..#
#.........#
#####l#####
locked : 2

0
3
###########
#.........#
#......#..#
#.......#.#
#.........#
d.........#
#.........#
#.........#
#.........#
#.........#
#####.#####

1
3
#####.#####
#.........#
#.........#
#.........#
#.........#
..........#
#.........#
#.........#
#.........#
#.........#
#####.#####

2
1
#####.#####
#.........#
#.........#
#..####...#
#..#..##..#
...#.#.....
#..#.#.#..#
#..#.#.#..#
#.........#
#.........#
#####.#####

0
0
###########
#......#..#
#.##..#...#
#.###..#..#
#...###...#
#..#.#.#..#
#..#......#
#.........#
#.........#
#.........#
#####l#####
locked : 0

3
2
#####.#####
##.....#k##
#.........#
#.#...#.#.#
#.........#
...#.#.#...
#.........#
#.#.#.#.#.#
#.........#
##.....#..#
#####.#####
key : 3

2
0
#####.#####
#.........#
#.........#
#.........#
#.........#
#?...@.....
#.........#
#.........#
#.........#
#.........#
#####.#####
sign A useful tool lies just ahead.

3
0
#####.#####
#.##......#
#.##......#
#.####....#
#.##.#....#
#.?#.......
#.##......#
#.........#
#.........#
#e........#
###########
enemies 1
sign The dungeon remembers all who enter.

3
3
#####d#####
#.........#
#........##
#.........#
#.........#
...#..#...d
#.........#
#.........#
#..#..#..##
#.........#
###########

2
4
###########
#.#.......#
#.........#
#.###.#...#
#...##....#
l.........#
#.........#
#.#.......#
#.........#
#.........#
#####.#####
locked : 4

3
4
#####.#####
#.........#
#.........#
#.........#
#.........#
d....e....#
#.........#
#.........#
#.........#
#.........#
#####.#####
boss
enemies 1

3
1
#####.#####
#.......#.#
#..#...#..#
#.#.....#.#
#.........#
.....##....
#.........#
#.......#.#
#......#..#
#.........#
###########

4
4
#####.#####
#.........#
#.........#
#.....#...#
#.........#
#.........#
#.........#
#.........#
#........##
#........X#
###########

2
2
#####.#####
#.........#
#.........#
#.........#
#.#.......#
.....#....d
#.........#
#.........#
#.........#
#.........#
#####.#####

1
1
###########
#.........#
#.........#
#...#.....#
#..##.#...#
...####....
#..#...#..#
#..#......#
#..##.#.#.#
#.........#
#####.#####

