0
2
###########
#.........#
#...#.....#
#...##....#
#.####.#..#
...###.....
#.###..#..#
######....#
###.#.....#
#k........#
#####.#####
key : 4

1
2
#####.#####
#..#...#.##
#.........#
#..#.#.#.##
#.........#
d..#.#.#..d
#.........#
##.#.#.#.##
#.........#
##.#...#..#
#####d#####

0
3
###########
#........e#
#.....#..##
#........e#
#.........#
......#...#
#.........#
#.........#
#..#..#..##
#.........#
#####.#####
enemies 2
door 0 : 0

3
3
#####.#####
#.........#
#.........#
#.........#
#..#.#....#
....#.....#
#..####...#
#..#####..#
#...#.##..#
#........X#
###########

1
1
#####.#####
#.........#
#......#..#
#..###k#..#
#...####..#
#....#.#..d
#.........#
#.........#
#.........#
#.........#
#####.#####
key : 2

3
1
#####.#####
#.........#
#..#......#
###......##
#.........#
...........
#.........#
#.#.......#
#..#......#
#.........#
#####.#####

4
0
#####.#####
#.........#
#..#......#
#.#.......#
#.........#
#.....#....
#.....#...#
#.#.......#
#..#......#
#.......#.#
###########

3
2
#####.#####
#.........#
#.........#
#.........#
#.........#
...#.......
#.#.##....#
###..#....#
#..#......#
#.........#
#####l#####
locked : 2

2
3
#####.#####
####......#
#e##......#
#.#e#.....#
#.........#
...#.....?#
#.........#
#.........#
#.........#
#.........#
#####.#####
enemies 2
sign The dungeon remembers all who enter.

2
0
###########
#.........#
#.........#
#.#.....#.#
#.........#
#..........
#.....#...#
#.........#
#.........#
#.#.....#.#
#####d#####

1
4
###########
#........k#
#.........#
#.........#
#.........#
...#......#
#..#####..#
#....#.#..#
#.........#
#..#......#
###########
key : 5

0
1
###########
#.........#
#...#.##..#
#.........#
#..####.#.#
#..#.......
#...#.....#
#.........#
#.........#
#.........#
#####.#####

2
2
#####d#####
#.#.......#
#.........#
#..#.#.#..#
#.........#
....#......
#.........#
#..#.#.#.##
#.........#
#.#.....#.#
#####.#####

3
0
#####d#####
#......#..#
#...#.###.#
#...####..#
#...#####.#
#....@.#...
#.........#
#.........#
#.........#
#.........#
#####.#####

4
1
#####.#####
#e.......e#
#?........#
#.........#
#.........#
...........
#.........#
#.........#
#.........#
#e.......s#
#####.#####
enemies 3
switch 0 : 0
sign Those who search shall find.

1
3
#####.#####
#.........#
#.........#
#.........#
#.........#
d...#e.....
#...#.....#
####......#
#.#.#.....#
#.........#
#####.#####
boss
enemies 1

2
1
#####.#####
#.........#
#.........#
#.........#
#.........#
...........
#.........#
#.........#
##.#......#
#.........#
#####.#####

5
1
#####.#####
#.........#
#.........#
#.....#..##
#.........#
#.........#
#..#......#
#.........#
#.........#
#k.#......#
###########
key : 1

4
2
#####l#####
#.........#
#.........#
#..#.#....#
#....#....#
...#.##...#
#.......#.#
#...#..#..#
#...#.##..#
#.......#.#
###########

