7
3
#####.#####
##.....#..#
#.........#
#.........#
#.#.....#.#
..........#
#.........#
##..#..#..#
#........e#
#.......ee#
###########
enemies 3

5
2
#####.#####
#.........#
#......#..#
#.......#.#
#.........#
d..........
#.........#
#.........#
#.........#
#.........#
#####.#####

1
0
#####d#####
#.........#
#.........#
#.........#
#..#......#
#....#.....
#..#.#....#
#.........#
#.........#
#.........#
#####.#####

5
0
#####.#####
#.........#
#..#...#..#
#k#.....#.#
#.........#
#..........
#.........#
#.........#
#.........#
#.........#
#####l#####
key : 1

3
0
#####.#####
#.........#
#.........#
#.........#
#.........#
#k........#
#.........#
#.........#
#.........#
#.........#
#####.#####
key : 0

6
0
#####l#####
#.........#
#.#.....#.#
#.........#
#.........#
#....#....l
#.........#
#.........#
#.#.....#.#
#.........#
###########
locked : 1

0
0
###########
#.........#
#.........#
#.........#
#.........#
#...#.....#
#...#.....#
#.#.......#
#####.....#
####......#
#####d#####

4
0
#####.#####
#.........#
#.........#
#.....###.#
#.....#...#
#..#.@.....
#?........#
##........#
#.........#
#.........#
#####.#####
sign Those who search shall find.

5
1
#####.#####
#......#..#
#......##.#
#.....##..#
#......#..#
..........d
#.........#
#.........#
#.....#...#
#.........#
#####.#####

2
1
#####.#####
#..#...#.##
#.........#
#....#.#.##
#.........#
l..#.#.#..#
#.........#
##...#.#.##
#.........#
##.#.....##
###########
locked : 0

6
1
#####.#####
#.........#
#......#..#
#.......#.#
#.........#
l..........
#.........#
#.......#.#
#......#..#
#.........#
###########
locked : 2

7
2
#####.#####
#.........#
#..#..#..##
#.........#
#.........#
#..#..#....
#.........#
#.........#
#..#..#..##
#.........#
###########

2
0
#####.#####
#.......#e#
#.....#s#.#
#.....###.#
#...##..#.#
#?.##.....l
#.........#
#e.##.....#
##........#
#e........#
#####.#####
enemies 3
switch 0 : 0 1
sign Seek the matching key before you proceed.

4
1
###########
#......k..#
#......#..#
#.......#.#
#.........#
...........
#.........#
#.........#
#.........#
#.........#
#####.#####
key : 2

1
1
###########
#........k#
#.........#
#.........#
#.........#
..........#
#.........#
#.........#
#.........#
#.........#
#####.#####
key : 5

6
2
#####.#####
#e.......e#
#.........#
#.........#
#.........#
..........d
#.........#
#.........#
#.........#
#e.......?#
#####.#####
enemies 3
door 0 : 0 1
sign Only the prepared may pass.

4
2
###########
####......#
#..##.....#
#.##......#
#...#.....#
....#.....#
#...#.....#
#..##.....#
##.#......#
#.........#
#####.#####

6
3
#####.#####
#.........#
#.........#
#.........#
#.........#
d....e....#
#.........#
#.........#
#........##
##........#
#####.#####
boss
enemies 1

5
3
###########
#..#.....X#
#.........#
#......#..#
#.........#
..........#
#.........#
#.........#
#.........#
#.........#
#####.#####

