3
0
#####D#####
#.........#
####......#
#.........#
#.........#
#....@....D
#.........#
#.........#
#.........#
#?........#
###########
sign The dungeon remembers all who enter.

2
0
#####D#####
#.........#
#.#.#.....#
#......##.#
#..##.#.#.#
#.....#...D
#...#.....#
#.........#
##.##.....#
#e........#
#####D#####
enemies 1

1
0
#####D#####
#.........#
#..#......#
#.#.......#
#.........#
#.........l
#.........#
#.#.......#
#..#......#
#.........#
#####D#####

5
2
#####D#####
#e........#
#.........#
#.........#
#.........#
D.........D
#.........#
#.........#
#.........#
#e..?e....#
###########
enemies 3
sign Beware what lurks ahead.

3
1
#####d#####
#.........#
#.........#
#.........#
#.........#
D.........D
#.........#
#.........#
#.........#
#.........#
#####D#####

1
1
###########
#.........#
#.........#
#.#..#..#.#
#.........#
l.........#
#.....#...#
#.........#
#.........#
#.......#.#
#####D#####
locked : 0

5
1
#####d#####
#.........#
#...#.##..#
#...#..#..#
#..#.#.#..#
#.........D
#.#.......#
##..#.....#
#.##......#
#.........#
###########

5
3
#####d#####
#.........#
#..#......#
#..#.##...#
#..#.###..#
D....e....#
#.........#
#.........#
#.........#
#.........#
#####D#####
boss
enemies 1

4
1
#####D#####
#.........#
#..#......#
#k#.......#
#.........#
#.........D
#.........#
#.........#
#.........#
#.........#
#####d#####
key : 0

6
3
#####D#####
#.........#
#.........#
#.........#
#.........#
#.........#
#.........#
#.........#
#.........#
#X........#
###########

3
2
###########
#.........#
##.#...#..#
#.#.#...#.#
#.........#
D.........D
#.........#
#.........#
#.........#
#.#.......#
#####D#####

4
3
#####D#####
#.........#
#..#......#
#.#.......#
#.........#
d.........D
#.........#
#.......#.#
#......#..#
#.........#
#####d#####

3
4
###########
#.#.....#k#
#.........#
#..#.#.#.##
#.........#
D...#.#...#
#.........#
#..#...#.##
#.........#
#.#.....#.#
#####D#####
key : 3

0
0
###########
#.........#
##.#......#
#.........#
#.....#.#.#
#.........#
#..#.#.#..#
#.........#
#.#.#...#.#
#.........#
#####D#####

4
2
#####D#####
#e.......e#
#.......###
#.........#
#.........#
D.....##..d
#.........#
#.......#.#
#.........#
#.........#
#####D#####
enemies 2

3
3
###########
#.........#
#.........#
#.........#
#.........#
D.........D
#.........#
#.........#
#.........#
#.........#
#####D#####

2
1
#####D#####
#.........#
#......#..#
#.......#.#
#.........#
D.........#
#.........#
#.#.......#
#..#......#
#.........#
#####d#####

4
5
###########
#..#.....k#
##.....#..#
##......#.#
#.........#
D.........#
#.........#
#.........#
#.........#
#.........#
###########
key : 2

4
4
#####D#####
#.........#
#.#.....#.#
#.........#
#..#.#.#..#
D.........D
#.#...#.#.#
#.........#
#..#...#.##
#........k#
###########
key : 1

