5
0
#####.#####
#.........#
#..#......#
#..#.#....#
#.........#
#k........d
#.........#
#.........#
#.........#
#.........#
#####.#####
key : 0

2
4
#####d#####
#.........#
#..#...#..#
#.........#
#...#.#.#.#
l.........#
#..#.#.#..#
#.........#
#.#.#.#.#.#
#.........#
#####.#####
locked : 3

4
0
#####.#####
#.........#
#..#......#
#..#......#
#..##.....#
#....@.....
#.........#
#.........#
#.........#
#.........#
#####.#####

4
1
#####d#####
####...#..#
##k.#.###.#
###..##...#
#..#..#...#
...#.......
#.........#
#.........#
#.........#
#.........#
#####.#####
key : 1

5
1
#####.#####
#.........#
#.........#
#.........#
#.........#
d.........#
#.........#
#.........#
#.........#
#.........#
###########

3
4
#####.#####
#.........#
#.........#
#.........#
#.........#
..........#
#.........#
#.........#
#.........#
#........k#
###########
key : 3

1
5
###########
#........X#
#.........#
#.##...#..#
#.#.#.....#
....#.....#
#.........#
#.........#
#......#..#
#.........#
###########

3
1
###########
#.........#
#.........#
#.........#
#.........#
......#....
#....###..#
#......#..#
#.........#
#.........#
#####d#####

1
4
#####.#####
#........##
#.....#...#
#...###...#
#.....#...#
.....e.....
#.........#
#.........#
#.........#
#.........#
#####d#####
boss
enemies 1

2
2
###########
#.........#
#......#..#
#.......#.#
#.........#
#..........
#.........#
#.#.......#
#..#......#
#.........#
#####l#####
locked : 0

2
3
#####.#####
#.........#
##........#
#.........#
#.#.......#
..........l
#..#.#.#..#
#.........#
#.#.#...#.#
#.........#
#####.#####

3
0
###########
#.........#
#..#......#
#.#.......#
#.........#
#..........
#.........#
#.#.......#
#..#......#
#.........#
#####.#####

4
3
#####.#####
#.........#
#.........#
#.........#
#.........#
..........#
#.........#
#.........#
#.........#
#.........#
###########

3
2
#####l#####
#.........#
#......#..#
#.......#.#
#.........#
..........l
#.........#
#.........#
#.........#
#.........#
#####l#####
locked : 2

6
0
#####.#####
#.#.....#.#
#.........#
#.........#
#.#..#..#.#
#.........#
#.........#
#.#..#..#.#
#.........#
#k........#
###########
key : 2

0
4
###########
#e.#e....?#
#..##.....#
#..#.#....#
#.........#
#.........#
#.........#
#.........#
#.........#
#.........#
#####.#####
enemies 2
sign The dungeon remembers all who enter.

1
3
###########
#.##....#.#
#..#......#
##.#......#
#.........#
#..........
#.......#.#
#.....##..#
#.........#
#.........#
#####.#####

4
2
#####l#####
#.........#
#.........#
#.....#...#
#.........#
...........
#....#....#
#.##....#.#
#..#...#..#
#.........#
###########

3
3
#####.#####
#.#.....#.#
#.........#
#.#.#.#.#.#
#.........#
l...#.#....
#.........#
#.#.#.#.#.#
#.........#
#.......#.#
#####.#####
locked : 1

