6
1
#####D#####
#.........#
##........#
#.#.......#
#...#.....#
#.........#
#.........#
#.........#
#.........#
#.........#
###########

4
1
#####D#####
#.........#
#......#..#
#.......#.#
#.........#
#.........#
#.........#
#.#.......#
#..#......#
#.........#
#####D#####

3
0
#####D#####
#.........#
#.........#
#.........#
#.........#
#....@....D
#.........#
#.........#
#.........#
#.........#
###########

1
0
###########
#e........#
##.....#..#
#?........#
#..#.#.#..#
#.........D
#....#.#..#
#.........#
##.#.....##
#.........#
#####D#####
enemies 1
sign Beware what lurks ahead.

1
4
#####D#####
#.........#
#.........#
#.##..#...#
#.#..#....#
D...#e#...#
#..##.....#
#.#.#.....#
#.....#...#
#.........#
#####d#####
boss
enemies 1

0
4
###########
#X#.......#
#.###.....#
#.###.....#
#.#.#.....#
#.........#
#.........#
#.........#
#.........#
#.........#
#####D#####

3
2
#####l#####
#.........#
#......#..#
#.......#.#
#.........#
D.........D
#.........#
#.#.....#.#
#..#...#..#
#.........#
###########
locked : 0

1
1
###########
#.........#
#.........#
#.........#
#.........#
D.........D
#.........#
#.........#
#.........#
#.........#
#####d#####

1
2
###########
#e..?e....#
#.........#
#.........#
#.........#
D.........D
#.........#
#.........#
#.........#
#e........#
#####D#####
enemies 3
sign This door will not yield without a key.

2
1
#####d#####
#.........#
#...#.#...#
#.....#...#
#.###.....#
D..##.....l
#.#.......#
##..#.....#
#k#.#.....#
#.........#
#####D#####
key : 1

2
2
#####D#####
#.........#
#......#..#
#...#####.#
#.....###.#
l....###..d
#...#####.#
#....##...#
#.........#
#.........#
#####l#####
locked : 1

3
1
#####D#####
#k........#
#.........#
#.........#
#.........#
D.........D
#.........#
#.........#
#.........#
#.........#
#####D#####
key : 0

1
3
###########
#.........#
#......#..#
#.......#.#
#.........#
D.........D
#.........#
#.#.......#
#..#......#
#.........#
#####D#####

2
4
#####d#####
#.........#
#.........#
#.........#
#.........#
D.........d
#...#.....#
#.#.......#
#.........#
#....k....#
###########
key : 4

2
5
###########
#.........#
#......#..#
#.......#.#
#.........#
d......#..#
#...#.....#
#.#.....#.#
#......#..#
#.........#
###########

2
3
#####D#####
#.........#
##.....#..#
#.........#
#....#.#..#
d.........D
#..#.#....#
#.........#
##.....#.##
#.........#
#####D#####

2
0
#####D#####
#.........#
#.........#
#.........#
#.........#
#e.###....D
#..##.....#
#..#e.....#
#..##.....#
#e#.......#
#####D#####
enemies 3

3
3
#####D#####
#.........#
#.........#
#.........#
#.........#
D.........#
#.........#
#.........#
#.........#
#........k#
###########
key : 3

5
1
#####D#####
#.........#
#..#......#
#.#.......#
#.........#
#.........#
#.........#
#.#.....#.#
#..#...#..#
#.........#
#####D#####

