4
1
#####l#####
#.........#
#..#...#..#
#k#.....#.#
#.........#
#.........D
#.........#
#.........#
#.........#
#.........#
#####D#####
key : 2

1
2
#####D#####
#.........#
#.........#
#.........#
#.........#
d....e#...#
#.....#...#
#.....#...#
#.........#
#.........#
#####D#####
boss
enemies 1

8
0
#####d#####
#.........#
#.##......#
#...#.#..##
#.........#
#..#.##...#
#.###.#...#
#.........#
#.........#
#.........#
###########

5
1
#####D#####
#e.......e#
#.#.......#
#.........#
#.........#
D....#....D
#.........#
#.........#
#.#.....#.#
#e........#
#####D#####
enemies 3

0
2
###########
##.#.....X#
##.#......#
#...#.....#
#..##.....#
D..##.....#
#..##.....#
#..#......#
#.........#
#.........#
#####D#####

7
0
#####D#####
#.........#
#.........#
#.........#
#.........#
#k........D
#.........#
#.........#
#.........#
#.........#
#####d#####
key : 0

7
1
#####D#####
#.........#
#.........#
#.........#
#.........#
D.........#
#.........#
#.........#
#.........#
#.........#
###########

4
2
#####l#####
#.......#.#
#..#......#
#.#.......#
#.........#
D.........D
#.........#
#.#.......#
#..#......#
#.........#
#####D#####

5
0
###########
#.#.....#.#
#.........#
#.#...#.#.#
#.........#
#.....#...D
#.........#
#...#.#.#.#
#.........#
#.#.......#
#####D#####

4
3
###########
#........k#
#.........#
#.........#
#.........#
D...#.#...#
#.....#...#
#.........#
#.........#
#.........#
###########
key : 5

2
2
#####D#####
#.........#
#...#.#.#.#
#.........#
#..#.#.#..#
D.........#
#.#.....#.#
#.........#
#..#.....##
#.........#
#####D#####

1
1
#####d#####
#.........#
#..#...#..#
#.#...#.#.#
#.........#
#......#..d
#.........#
#..#......#
#.........#
#.........#
#####d#####

6
0
#####D#####
#.........#
#.........#
#.........#
#.........#
#?...@....D
#.........#
#.........#
#.........#
#.........#
#####D#####
sign Those who search shall find.

3
1
#####D#####
#.........#
#.........#
#.#.#.#.#.#
#.........#
#...#.#...D
#.........#
#.#...#.#.#
#.........#
#.#.....#.#
#####l#####
locked : 0

2
1
#####d#####
#e........#
#.........#
#.........#
#e........#
#e........D
#.........#
#.........#
#.........#
#.........#
#####D#####
enemies 3

6
1
#####D#####
#.........#
#.........#
#......#..#
#....##k..#
D..#......#
#......#..#
#..#.###..#
#.........#
#.........#
#####D#####
key : 1

5
2
#####D#####
#.........#
#..#.....##
#.........#
#.#.#.#.#.#
D.........#
#..#.#....#
#.........#
#.#.#.#...#
#.........#
###########

3
2
#####D#####
#.........#
#..#......#
#.#.......#
#.........#
D.........#
#.........#
#.#.......#
#..#......#
#.........#
#####l#####
locked : 2

0
1
###########
#.........#
#.........#
#..#..#...#
#.........#
#.........D
#...#..#..#
#.........#
#.........#
#.........#
#####d#####

