3
2
#####.#####
#.........#
#......#..#
#.......#.#
#.........#
...........
#.........#
#.......#.#
##.....#..#
#k........#
#####.#####
key : 0

2
4
#####l#####
#.........#
#.........#
#.........#
#.........#
d..........
#.........#
#.#.....#.#
#..#...#..#
#.........#
#####.#####

1
1
###########
#.........#
#..#......#
#.#.......#
#.........#
..........#
#.........#
#.........#
#.........#
#.........#
#####.#####

4
1
#####d#####
#.......#.#
#.........#
#.........#
#.........#
#....#.#...
#....#.#..#
#...#######
#...#.#.###
#.........#
###########

3
4
#####.#####
##.....#..#
#.........#
#.........#
#......#..#
..........#
#.........#
##..#..#..#
#.........#
#.........#
###########

2
5
###########
#.......ee#
#.#.#.#.#.#
#.........#
#.#.#.....#
..........#
#.#...#.#.#
#.........#
#.#.#...#.#
#.......?e#
###########
enemies 3
door 0 : 0 1
sign Many have walked this path.

2
2
###########
#....k....#
#.........#
#..#......#
#.........#
...........
#..#......#
#.........#
#.........#
#..#......#
#####.#####
key : 3

3
1
#####d#####
#.........#
#.#.#.#.#.#
#.........#
#..#.#....#
#..........
#.#.#...#.#
#.........#
#..#...#..#
#.........#
#####d#####

1
3
###########
#k........#
#..#...#..#
#.#.....#.#
#.........#
#..........
#.........#
#.......#.#
#......#..#
#.........#
#####.#####
key : 5

2
0
#####.#####
#.##......#
#.##......#
#.###.....#
#..#......#
#..##@.....
#..#......#
#.......#.#
#.........#
#?........#
###########
sign Many have walked this path.

3
3
#####d#####
#k........#
#......#..#
#.......#.#
#.........#
...........
#.........#
#.........#
#.........#
#.........#
#####.#####
key : 2

4
3
#####.#####
#.........#
##..#..#..#
#.........#
#.........#
.....#....#
#.........#
#.........#
##..#....s#
#.......ee#
###########
enemies 2
switch 0 : 0 1

5
2
#####l#####
##.#.....##
#.........#
#.#.#.#.#.#
#.........#
#..#.#.#..#
#.........#
#.#...#.#.#
#.........#
##.#.....##
###########
locked : 3

1
0
###########
#.........#
#..#......#
#.#.......#
#.........#
#..........
#....#.#..#
#...#.....#
#.........#
#.........#
#####.#####

4
2
#####.#####
##.....#..#
#.........#
#.........#
#...#..#..#
...........
#.........#
##.....#..#
#.........#
#.........#
#####l#####

0
4
###########
#X........#
#.........#
#.........#
#.........#
#.........#
#.........#
#.........#
#.........#
#.........#
#####.#####

2
3
#####.#####
#.........#
#.........#
#.........#
#.........#
..........d
#.........#
#.........#
#.........#
#.........#
#####d#####

1
4
#####.#####
#.#.......#
#.#.#.....#
#.####....#
#.####....#
.....e....#
#....###..#
#.........#
#.....#...#
#.........#
#####l#####
locked : 0
boss
enemies 1

2
1
#####.#####
##.#...#.##
#.........#
#...#.#.#.#
#.........#
...#.#.#...
#.........#
#...#...#.#
#.........#
##.....#.##
#####d#####

