4
2
###########
#.#.....#.#
#.........#
#..#.#.#..#
#.........#
......#...#
#.........#
#..#.#.#.##
#.........#
#.......#.#
#####d#####

2
2
###########
#.....e..e#
#.....#...#
#...#.#...#
#.....#...#
.....#.#..#
#......#..#
#....#....#
#.........#
#........e#
###########
enemies 3

7
1
#####.#####
##.....#.##
#.........#
##...#.#.##
#.........#
...#.#.#...
#.........#
##.#.#.#..#
#.........#
##.......##
###########

6
0
#####.#####
##.#...#.##
#.........#
#.#.#.#.#.#
#.........#
#..#...#...
#.........#
#.#.#.....#
#.........#
##.#.....##
#####.#####

5
0
#####d#####
#.........#
#.#....#..#
#.......#.#
#.........#
#.....#....
#.........#
#.#.......#
#..#......#
#........##
#####.#####

6
2
#####.#####
#.........#
#.....###.#
#......#..#
#.........#
.....#k#..d
#.....#...#
#.........#
#.........#
#.........#
#####l#####
key : 1

4
0
#####.#####
#.........#
#.........#
#.........#
#.........#
#..........
#.........#
#.......###
#......#..#
#.........#
#####d#####

7
0
#####.#####
###.......#
##.#......#
#..##.....#
#...#.....#
#..##@.....
#.....#...#
#.........#
#.........#
#?........#
###########
sign Beware what lurks ahead.

2
1
###########
#.........#
#.........#
#.........#
#.........#
...........
#..#.###..#
#....#....#
#.#.#e.#..#
#...e..e..#
###########
enemies 3
door 0 : 0

0
0
###########
#X........#
#.........#
#.........#
#.........#
#......#..#
#.....#.#.#
#...###.#.#
#.........#
#.........#
#####.#####

4
1
###########
##....k#..#
#.........#
#.........#
#.#.......#
...........
#.........#
##.....#..#
#.........#
#.........#
#####.#####
key : 5

1
0
#####.#####
#.........#
#.........#
#.....##..#
#....##...#
#....e.#..#
#.........#
#.........#
#.........#
#.........#
#####d#####
boss
enemies 1

5
2
#####d#####
#.........#
#.....#...#
#.........#
#.........#
......#..s#
#.........#
#........e#
#..#.....##
#........e#
#####.#####
enemies 2
switch 0 : 0

6
3
###########
#.........#
#.........#
#.........#
#.........#
d..#.#....#
#..#.#....#
#...##....#
#.........#
#.........#
###########

5
1
#####.#####
#k#.....#.#
#.........#
#.........#
#..#......#
...........
#.........#
#.#..#..#.#
#.........#
#.........#
#####.#####
key : 0

2
0
#####d#####
#.........#
#.........#
#.#..#..#.#
#.........#
#..........
#..#......#
#.........#
#.........#
#e#.....#e#
#####.#####
enemies 2

6
1
#####.#####
##.....#.##
#.........#
#.#.#...#.#
#.........#
...#.#.....
#.........#
#.#.#.#...#
#.........#
#......#.##
#####.#####

7
2
#####l#####
#.........#
#.........#
#.#..#..#.#
#.........#
..........#
#.#..#..#.#
#.........#
#.........#
#.......#.#
###########
locked : 0

3
0
#####.#####
#.......#.#
#......#k.#
#.......#.#
#.......#.#
#.........#
#....#....#
#.........#
#.........#
#.........#
#####.#####
key : 4

