7
0
#####l#####
#..#......#
#..#......#
#k#.......#
#....#....#
#.........#
#.........#
#.........#
#..#......#
#.........#
#####D#####
key : 0

8
1
###########
#..#......#
#.........#
#.........#
#...#.....#
D.........D
#.........#
#........##
#.........#
#.........#
#####d#####

2
0
#####d#####
#.........#
#.........#
#.........#
#.........#
#k........D
#.........#
#.........#
#.........#
#.........#
#####D#####
key : 4

2
1
###########
#.......ee#
#........e#
#.........#
#.........#
D.........#
#.........#
#.........#
#.........#
#.........#
#####D#####
enemies 3
door 0 : 0 1

5
0
#####D#####
#.........#
#.........#
#..#.#.#.##
#.........#
#.....#...#
#.........#
#....#.#.##
#.........#
#.#.......#
#####D#####

6
1
###########
#.........#
##........#
##........#
#..#......#
D.........#
#....#....#
#.#.##....#
#..#......#
#.#.......#
###########

0
0
###########
#X........#
#.##......#
#..#......#
#.###.....#
#.........#
#.........#
#.........#
#.........#
#.........#
#####D#####

9
0
#####D#####
#..#......#
#.###.....#
#.#.#.#...#
#.........#
#.........l
#.........#
#.........#
#.........#
#k........#
###########
key : 1

6
0
#####D#####
#.##......#
#...#.....#
#...#.....#
#.........#
#.........D
#.........#
#.........#
#.......p.#
#.........#
#####l#####
locked : 0

8
2
###########
#.........#
#.#.....#.#
#.........#
#.........#
D..#..#...#
#.........#
#.........#
#.......#.#
#.........#
#####d#####

4
1
#####D#####
#.........#
#.#.#.#...#
#.........#
#..#.#.#..#
d.........#
#...#.#.#.#
#.........#
#..#...#.##
#.........#
###########

1
0
#####D#####
#.........#
#.........#
##..#.#...#
#...###...#
#..###....#
#...e.....#
#.........#
#.........#
#.........#
#####d#####
boss
enemies 1

3
1
#####D#####
##........#
#e.#......#
###e......#
#s##......#
D..##....e#
#..###....#
#..##.....#
#..##.....#
#.........#
#####D#####
enemies 3
switch 0 : 0 1

8
0
#####D#####
#.........#
#.........#
#.........#
#.........#
#?...@....D
#.........#
#.........#
#.........#
#.........#
#####D#####
sign The brave are rewarded.

9
1
#####d#####
#.........#
#...#..#..#
#.......#.#
#.........#
l......#..D
#.........#
#.#.......#
#..#......#
#......#..#
#####D#####
locked : 1

10
1
#####D#####
#.........#
#..#...#..#
#.#.....#.#
#.........#
#.........#
#.........#
#.........#
#.........#
#k........#
###########
key : 2

3
0
#####D#####
#..#......#
#.....#...#
#...##.#..#
#..#......#
#.........D
#.........#
#.........#
#.........#
#.........#
#####l#####
locked : 2

9
2
#####d#####
#.........#
#...#.....#
#.........#
#.........#
D.........#
#.........#
#.#.....#.#
#..#...#..#
#.........#
###########

4
0
#####l#####
#.........#
#.........#
#.........#
#.........#
#.........d
#.........#
#.........#
#.........#
#.........#
#####D#####

