5
0
#####D#####
#......#..#
#.........#
#.........#
#......#..#
#.........d
#.........#
##..#..#..#
#.........#
#.........#
###########

4
0
#####D#####
#.........#
#......#..#
#.......#.#
#.........#
#.........D
#.........#
#.........#
#.........#
#.........#
#####D#####

5
1
#####D#####
#.........#
#...#.....#
#....#....#
#..#..##..#
d..##.....#
#......#..#
#.........#
#.........#
#.........#
#####D#####

6
2
###########
#.......ee#
#.........#
#.........#
#.........#
D...#.....#
#...###...#
#...#.....#
#.........#
#........e#
###########
enemies 3
door 0 : 0 1

6
1
#####D#####
#.........#
#.........#
#.........#
#.........#
#.........D
#.........#
#.#...#.#.#
#..#...#..#
#.........#
###########

3
3
###########
#........k#
#......#..#
#.......#.#
#.........#
D.........#
#.........#
#.......#.#
#......#..#
#.........#
###########
key : 4

1
0
#####d#####
#.........#
#......#.##
#.........#
#.#.......#
#.........D
#..#.#.#..#
#.........#
#.#.#...#.#
#.........#
#####l#####
locked : 2

3
2
#####D#####
#.........#
#..#...#..#
#.#.....#.#
#.........#
D.........D
#.........#
#.#.......#
#..#......#
#.......#k#
#####D#####
key : 2

0
0
###########
#.........#
#...#...#.#
#.........#
#.#.#.#.#.#
#.........#
#...#.#.#.#
#.........#
#.#.#.#.#.#
#.........#
#####d#####

3
0
#####l#####
#.........#
#.........#
#.........#
#.........#
#....@....D
#.........#
#.........#
#.........#
#.........#
#####D#####

4
1
#####D#####
#k........#
#..#......#
#.#.......#
#.........#
D.........D
#.........#
#.........#
#.........#
#.........#
#####D#####
key : 1

1
2
#####D#####
#.........#
#.........#
#.........#
#.........#
d....e....#
#.........#
#.........#
#.........#
#.........#
#####D#####
boss
enemies 1

2
1
#####d#####
#.........#
#.........#
#.........#
#.........#
D.........D
#.........#
#.#.......#
#..#......#
#.........#
#####l#####
locked : 1

3
1
#####l#####
#.........#
#.##......#
#.k#.##...#
#.#.###...#
D...#.....D
#.........#
#.........#
#.........#
#.........#
#####D#####
key : 0

4
2
#####D#####
##.#...#.##
#.........#
##.#.....##
#.........#
D..#......#
#........?#
##.#.#.#s##
#........e#
##.#.....e#
###########
enemies 2
switch 0 : 0 1
sign A useful tool lies just ahead.

0
2
###########
#X........#
#.........#
#.........#
#.........#
#.........#
#.........#
#.........#
#.........#
#.........#
#####D#####

2
2
#####D#####
##.#.....##
#.........#
#.#.....#.#
#.........#
D..#...#..#
#.........#
#.#.#.#.#.#
#.........#
##.......##
#####D#####

1
1
###########
#.........#
#..#..#..##
#.........#
#.........#
D..#..#...d
#.........#
#.........#
#.........#
#.........#
#####d#####

2
0
#####l#####
#.........#
##.#...#..#
#.........#
#.#.#...#.#
#.........D
#..#.#....#
#.........#
#.#.#.....#
#.........#
#####l#####
locked : 0

