0
0
###########
#.........#
#.###.....#
#.#.#.....#
#.........#
#....#....#
#.......#.#
#.........#
#.........#
#.........#
#####d#####

7
2
#####l#####
#.........#
#.........#
#.........#
#......#..#
#....e##..#
#....#....#
#.........#
#.........#
#.........#
#####.#####
locked : 3
boss
enemies 1

6
3
#####d#####
#.........#
#..#...#..#
#.#.....#.#
#..#......#
..........#
#.........#
#.........#
#.........#
##........#
###########

3
1
#####.#####
#.........#
#.........#
#.........#
#.........#
...........
#.........#
#.........#
#.........#
#.........#
#####d#####

3
0
#####.#####
#.........#
#.........#
#......#..#
#.........#
#k...###...
#.........#
#.........#
#.........#
#.........#
#####.#####
key : 0

4
2
#####.#####
#.........#
#..#...#..#
#.#.....#k#
#.........#
..........#
#.........#
#.........#
#.........#
#.........#
#####l#####
key : 1

6
0
#####.#####
#.........#
#.#.#.#.#.#
#.........#
#.#.#.#.#.#
#.........#
#.#.#...#.#
#.........#
#.#.#.#.#.#
#e.......e#
###########
enemies 2

8
2
#####.#####
#.........#
#.##......#
#####.....#
#.##......#
#..###....#
#.####....#
#..##.....#
#.........#
#X........#
###########

5
0
#####.#####
#.........#
#.........#
#.........#
#.........#
#....@....#
#.........#
#.........#
#.........#
#.........#
#####.#####

5
2
#####l#####
#.........#
##.....#..#
#.......#.#
#.......#.#
#.....#...l
#.........#
#.........#
#.........#
#.........#
#####.#####
locked : 1

5
3
###########
#.........#
#......#..#
#.......#.#
#.........#
l.........#
#.........#
#.#.....#.#
#..#...#..#
#.........#
#####d#####
locked : 2

1
0
#####d#####
#.........#
#k#.....#.#
#.........#
#.........#
#....#....d
#.........#
#.........#
#.#.....#.#
#.........#
#####.#####
key : 2

4
1
#####d#####
#.........#
#..#...#..#
#.#.....#.#
#.........#
l..........
#.........#
#.......#.#
#......#..#
#.........#
###########
locked : 0

4
0
#####.#####
#.........#
#......#..#
#.......#.#
#.........#
#.........l
#.........#
#.........#
#.........#
#.........#
#####.#####

1
1
###########
#.........#
#.........#
#.........#
#.........#
d.........#
#.........#
#.........#
#.........#
#.........#
#####.#####

2
1
#####.#####
##.#......#
##.##.....#
##...#....#
#..#.####.#
...#.#.#..#
#......#..#
#.........#
#.........#
#.........#
#####.#####

2
0
#####.#####
#.........#
#.........#
#.#..#....#
#.........#
#..........
#.#..#..#.#
#.........#
#.........#
#.#.....#.#
#####.#####

6
2
#####.#####
#.........#
#......#..#
#.......#.#
#.........#
#k.........
#.........#
#.........#
#.........#
#.........#
#####l#####
key : 3

3
2
###########
#.........#
#......#..#
#.......#.#
#.........#
..........#
#.........#
#.........#
#.........#
#.........#
#####.#####

