5
0
#####l#####
#.........#
#..#...#..#
#.#.....#.#
#.........#
#..........
#.........#
#.#.....#.#
#..#...#..#
#.........#
#####.#####
locked : 2

0
0
###########
#.........#
##.....#..#
#.........#
#.........#
#...#..#..#
#.........#
#.........#
#...#..#..#
#.........#
#####.#####

5
1
#####.#####
#e........#
#.........#
#.........#
#.........#
..........d
#.#.......#
#.........#
#.........#
#......#..#
#####d#####
enemies 1

6
1
#####d#####
#..#......#
#.........#
##.#......#
#...#.....#
...#......d
#.........#
#.........#
#.........#
#.........#
#####.#####

4
1
#####.#####
##.....#.##
#k........#
##.#.#...##
#.........#
...#.#.#...
#.........#
##.#...#.##
#.........#
##.#...#.##
#####.#####
key : 2

6
0
#####.#####
#.........#
#.#.......#
#.........#
#.........#
#..........
#.........#
#.........#
#.........#
#.........#
###########

4
2
###########
#........k#
#.........#
#.........#
#.........#
..........#
#.........#
#.........#
#.........#
#.........#
#####.#####
key : 3

1
2
###########
#.........#
#..#...#..#
#.#.....#.#
#.........#
d.........#
#.........#
#.........#
#.........#
#.........#
###########

3
1
#####.#####
#.........#
#.........#
#....#....#
#.........#
..........#
#..#......#
#.........#
#.........#
#.........#
#####.#####

2
0
#####.#####
#.........#
#.........#
#.........#
#.........#
#k.........
#.........#
#.........#
#.........#
#.........#
#####l#####
key : 0

3
0
#####l#####
#.........#
#.........#
#.........#
#.........#
#..........
#.........#
#.#.......#
#..#......#
#.........#
#####.#####
locked : 0

1
0
#####.#####
#.........#
#.........#
#.........#
#...@.....#
#..###.....
#..##.....#
#..##.....#
#...#.....#
#.........#
#####.#####

5
2
#####.#####
#.........#
#.#.....#.#
#.........#
#.........#
d.........#
#.........#
#.........#
#.#.....#.#
#.........#
#####.#####

1
1
###########
#e#e.?....#
#.........#
#.........#
#.#..#..#.#
..........d
#.........#
#....#..#.#
#.........#
#.........#
#####.#####
enemies 2
sign Many have walked this path.

6
2
#####.#####
#.........#
#.........#
#.........#
#.........#
d....e....#
#.........#
#.........#
#.........#
#.........#
#####.#####
boss
enemies 1

7
1
#####.#####
#.#.....#.#
#.........#
#.........#
#.#.....#.#
#..........
#.........#
#e#.......#
#e........#
#e........#
###########
enemies 3

2
1
#####.#####
#.........#
#.#.....#.#
#.........#
#.........#
.....#....#
#.........#
#.........#
#.#.......#
#.........#
#####.#####

4
0
#####.#####
#.........#
#.#.#.#.#.#
#.........#
#..#...#..#
#..........
#k#...#...#
#.........#
#......#..#
#.........#
#####l#####
key : 1

7
2
#####.#####
#.........#
#.........#
#.........#
#.........#
..........#
#.........#
#.........#
#.........#
#........X#
###########

