3
3
#####D#####
#.........#
#.........#
#.........#
#.........#
D.........D
#.........#
#.......#.#
#......#..#
#.........#
###########

1
1
###########
#.........#
#.........#
##..#..#..#
#.........#
l.........#
#...#.....#
#.........#
#.........#
#.........#
#####D#####
locked : 0

2
4
###########
#.#.......#
#.........#
#..#.#.#.##
#.........#
D.....#...#
#.........#
#..#.#.#..#
#.........#
#.#.....#.#
#####l#####
locked : 1

0
0
###########
#e.....?.e#
#...#..#..#
#.........#
#.........#
#....#....#
#.........#
#.........#
##..#.....#
#.........#
#####D#####
enemies 2
sign The brave are rewarded.

2
0
#####D#####
#.........#
#.........#
#.........#
#.........#
#?...@....D
#.........#
#.........#
#.........#
#.........#
#####D#####
sign Something glints behind that door…

5
5
#####D#####
#.........#
#.........#
#.........#
#....#....#
#..###....#
#..##.#...#
#...#.##..#
#..#......#
#X.#...#..#
###########

3
0
#####D#####
#.........#
#..#......#
#.#.......#
#.........#
#.........D
#.........#
#.......#.#
#......#..#
#.........#
###########

4
1
#####D#####
#.........#
#.........#
#.........#
#....#....#
#...#.#...#
#...#.....#
#.........#
#.........#
#k........#
###########
key : 2

3
4
#####l#####
#.......#.#
#.........#
#....#.#.##
#.........#
D...#.#...d
#.........#
#..#.#.#.##
#.........#
#.......#.#
#####l#####

2
1
#####D#####
#.........#
#..#......#
#.#.......#
#.........#
D.........D
#.........#
#.#.......#
#..#......#
#.........#
#####D#####

3
2
#####D#####
#.........#
#..#......#
#.#.......#
#.........#
d.........D
#.........#
#.#.......#
#..#......#
#.........#
###########

1
3
###########
#.........#
#.........#
#.........#
#.........#
#.........#
#.......#.#
#.........#
#.........#
#.........#
#####d#####

4
5
#####d#####
#.........#
#.##......#
#.........#
#.###.....#
D..##e....#
#.#.......#
##.##.....#
#.........#
#.........#
#####D#####
boss
enemies 1

1
0
#####D#####
#.........#
#..#......#
#k#.......#
#.........#
#.........l
#.........#
#.#.......#
#..#......#
#.........#
#####D#####
key : 0

3
1
#####D#####
#e.......?#
#.........#
#.........#
#.........#
D.........d
#.........#
#.........#
#.........#
#e........#
#####D#####
enemies 2
sign What you seek is close.

2
3
#####d#####
#.........#
#.##......#
#.p#......#
#.###.....#
D.........D
#.........#
#.........#
#.........#
#kp.......#
#####D#####
key : 3

4
4
#####l#####
#.........#
#.........#
#.....#..##
#.........#
#.........D
#.....#...#
#.........#
#.........#
#........##
###########
locked : 3

2
2
###########
##.....#k##
#.........#
#...#...#.#
#.........#
D..#......D
#.........#
#...#...#.#
#.........#
##.#...#..#
#####D#####
key : 1

3
5
###########
#.........#
##.....#..#
#.........#
#.........#
d...#..#..#
#.........#
#.........#
##..#..#..#
#.........#
#####d#####

