1
2
#####D#####
#.........#
##........#
#.........#
#.........#
D....#....D
#.........#
#.........#
##..#.....#
#.........#
#####d#####

7
0
#####D#####
#.#.....#.#
#.........#
#.#...#.#.#
#.........#
#.....#...#
#.........#
#.#...#.#.#
#.........#
#.#.......#
###########

6
1
#####D#####
#.........#
#..#......#
#.#.......#
#.........#
D.........#
#.........#
#.........#
#.........#
#.........#
###########

3
2
#####D#####
#.........#
#...#.....#
#...k#....#
#..###....#
D.........D
#.........#
#........##
#.........#
##........#
#####D#####
key : 5

2
3
#####D#####
#.........#
#.........#
#.........#
#......##.#
d....e.#..#
#.....#...#
#.........#
#.........#
#.........#
#####D#####
boss
enemies 1

1
1
###########
##........#
#k........#
###.......#
#.##......#
#.........D
#..#......#
#..#......#
#..##.....#
#.........#
#####D#####
key : 9

3
1
#####D#####
#.........#
#...#.#.#.#
#...#.###.#
#..####...#
#..###....D
#.#.####..#
#...###...#
#..#..#...#
#.........#
#####l#####
locked : 2

1
3
###########
#........k#
#.........#
#.........#
#.........#
D.........#
#.........#
#.........#
#.........#
#.........#
#####D#####
key : 13

4
1
#####l#####
#.........#
#..#..###.#
#..e###.#.#
#..##.#...#
D.........D
#.........#
#.........#
#.........#
#.........#
#####D#####
enemies 1

5
1
#####D#####
#..#...#..#
#..##.....#
#..#e###..#
#..#.##...#
D.........d
#.........#
#.........#
#.........#
#.........#
#####D#####
enemies 1

4
2
#####D#####
#.........#
#.........#
#.........#
#.##......#
D...#.....#
#..#......#
#.........#
#.........#
#k#.......#
#####D#####
key : 2

2
1
#####D#####
#e........#
#.........#
#.........#
#e........#
#e........D
#s........#
#.........#
#.........#
#.........#
#####D#####
enemies 3
switch 0 : 0

2
2
#####d#####
#.........#
##..#..#..#
#.........#
#.........#
D......#..d
#.........#
#.........#
##..#..#..#
#.........#
#####D#####

6
0
#####d#####
#.........#
#.........#
#.........#
#.........#
#?...@....D
#.........#
#.........#
#.........#
#.........#
#####D#####
sign Beware what lurks ahead.

5
2
#####D#####
#.........#
#.......#.#
#..#......#
#.........#
d.........#
#.........#
#.........#
#.........#
#.........#
###########

4
0
###########
#.........#
#.........#
#.........#
#.........#
#..#......D
#.........#
#.........#
#.....#..##
#.........#
#####D#####

0
2
###########
##e....#.e#
#e........#
#.........#
#...#.....#
#.........#
#.........#
#...#..#..#
#.........#
#.........#
#####D#####
enemies 3
door 0 : 0

5
0
#####D#####
#.........#
#..#..#...#
#.........#
#.........#
#...#.....D
#.........#
#.........#
#..#..#...#
#.........#
#####d#####

3
3
#####D#####
#.........#
#.........#
#.........#
#.........#
D.........#
#.........#
#.........#
#.........#
#........X#
###########

