1
1
#####l#####
#.........#
#.........#
#....#....#
#.........#
#...#s#...D
#...e####.#
#...#.#?#.#
#.....#...#
#e#....#..#
#####D#####
enemies 2
switch 0 : 0 1
sign Only the prepared may pass.

1
2
###########
##........#
#.#.#.#...#
#.#..###..#
#....##...#
D.........D
#.........#
#.........#
#.........#
#.........#
#####D#####

2
0
###########
#k##...#..#
#......#..#
#....#.#..#
#..#.#....#
#.........D
#.........#
#.........#
#.........#
#.........#
#####D#####
key : 0

0
1
###########
##.....#..#
#.........#
#.........#
#.........#
#.........#
#.........#
##..#..#..#
#.........#
#.........#
#####l#####
locked : 3

3
2
#####D#####
#.........#
#.........#
#.........#
#..##.....#
D.........d
#...#.....#
#.........#
#.........#
#.........#
#####d#####

2
5
###########
#.........#
#.........#
#.........#
#...e.....#
d..#.##...#
#.####....#
#..#.#.#..#
#..#......#
####......#
#####D#####
boss
enemies 1

3
5
#####D#####
#.........#
#.........#
#....#.#..#
#..#.#.#..#
#..##..#..#
#..#...#..#
#..##.....#
#..#...#..#
#X........#
###########

4
0
#####D#####
#..#......#
#.........#
#..#.#.#..#
#.........#
#..#.#.#..D
#.........#
##.#.#....#
#k........#
##.#...#.##
###########
key : 1

2
4
#####D#####
#.........#
#.........#
#.........#
#.........#
d.........d
#.........#
#.........#
#.........#
#.........#
###########

4
2
#####d#####
#.........#
#..#......#
#.#.......#
#.........#
D.........#
#.........#
#.#.....#.#
#..#...#..#
#.........#
###########

1
4
###########
#.......ee#
#.#.#.#.#.#
#.........#
#..#...#..#
D.........#
#.#...#...#
#.........#
#..#...#.##
#.........#
#####D#####
enemies 2
door 0 : 0 1

2
2
#####D#####
#.........#
#.........#
#.........#
#.........#
D.........D
#.........#
#.#.....#.#
#..#...#..#
#.........#
#####D#####

3
0
#####D#####
#.#p......#
#..#......#
##.###....#
#..###....#
#..#@#....l
#.........#
#.....p...#
#.........#
#.........#
#####D#####

3
1
#####D#####
#..#......#
#.........#
#.........#
#.........#
l.........D
#.........#
#.........#
#.........#
#.........#
#####l#####
locked : 1

2
3
#####D#####
#.........#
#.........#
#.........#
#..#..#...#
D.........d
#.........#
#.#..#..#.#
#.........#
#.........#
#####D#####

1
3
###########
#....k....#
#.......#.#
#.........#
#.........#
D....#....D
#.........#
#.........#
#.#.....#.#
#.........#
#####D#####
key : 4

4
1
#####l#####
##.......##
#.........#
#...#...#.#
#.........#
D....#.#..D
#.........#
#.#.#.....#
#.........#
##.....#..#
###########
locked : 0

3
3
#####D#####
#.........#
#..#......#
#.#.......#
#.........#
d.........#
#.........#
#.#.......#
#..#......#
#.........#
###########

2
1
#####D#####
#......#..#
#.........#
#.#.#.....#
#.........#
D.........D
#.........#
#.#.#.#.#.#
#.........#
##k#...#.##
#####D#####
key : 3

