4
1
#####d#####
#..#...#..#
#...#.#...#
#....#....#
#...###...#
D....#....#
#....##...#
#.....#.###
#.......###
#.........#
###########

3
0
#####D#####
#.#.....#.#
#.........#
#.........#
#..#..#...#
#.........D
#.........#
#.#..#....#
#.........#
#.........#
#####D#####

0
3
###########
##.....#.e#
#?........#
#.........#
#.#.......#
#.........#
#.........#
#...#..#..#
#.........#
#.........#
#####D#####
enemies 1
sign Those who search shall find.

2
1
#####D#####
####......#
#..#......#
##..#.....#
#...##.#..#
D..##.##..D
#.....#...#
#...##.#..#
#...#...#.#
#.........#
#####D#####

2
3
#####D#####
#.........#
#.........#
#.........#
#.........#
d.........l
#.........#
#.........#
#.........#
#.........#
###########

1
4
###########
#.........#
#.#.#.#...#
#.........#
#.#.#.#.#.#
D.........#
#.#.#.#...#
#.........#
#.#.#.#.#.#
#.........#
#####d#####

2
0
#####d#####
#.........#
#.........#
#.........#
#..###.#..#
#..#@#.#..D
#.......p.#
#.p###.#..#
#..##.##..#
#.........#
#####D#####

5
0
#####D#####
#.........#
#.........#
#.........#
#....###..#
#...#.##..#
#...#.###.#
#.........#
#.........#
#k........#
###########
key : 2

4
0
#####D#####
#.........#
#.........#
#.........#
#.........#
#k........D
#.........#
#.........#
#.........#
#.........#
#####D#####
key : 1

3
5
#####D#####
#.........#
#.........#
#.........#
#.........#
D.........#
#.........#
#.........#
#.........#
#........X#
###########

1
1
###########
#........k#
#.........#
#.........#
#.........#
D.........#
#.........#
#.......#.#
#......#..#
#.........#
#####D#####
key : 0

2
2
###########
#.........#
#..#...#..#
#.#.....#.#
#.........#
D.........d
#.........#
#.........#
#.........#
#.........#
#####D#####

1
0
###########
#.#.....#.#
#.........#
#.#.#.#...#
#.........#
#.....#...D
#.........#
#.#...#.#.#
#.........#
#.......#.#
#####d#####

3
2
#####D#####
####......#
##..#.....#
#....#....#
#....#....#
D....#....#
#.###.....#
##..##....#
###.......#
##........#
###########

3
1
#####D#####
#.......#.#
#......#..#
#....#.#..#
#......##.#
D.........D
#.........#
#.........#
#.........#
#.........#
#####d#####

1
3
#####D#####
#.........#
#.........#
#..###k#..#
#..####...#
#..#####..D
#..#####..#
#...####..#
#.........#
#.........#
#####D#####
key : 3

3
4
#####l#####
#.#.......#
#.........#
#....#.#.##
#.........#
#.........D
#.........#
#..#.#.#..#
#.........#
#.#.......#
###########
locked : 1

2
5
###########
#.........#
#.........#
#..###....#
#..##.....#
l....e....#
#.........#
#.........#
#.........#
#.........#
#####D#####
locked : 3
boss
enemies 1

2
4
#####d#####
#.........#
#..#...#..#
#.#.....#.#
#.........#
l.........l
#.........#
#.........#
#.........#
#.........#
#####l#####
locked : 2

