4
0
###########
#.........#
#.........#
#..#.#....#
#.##......#
#....#....D
#..###....#
#.#.##....#
#.........#
#.........#
#####D#####

1
2
###########
#.#.....#k#
#.........#
#.........#
#.#.....#.#
D.........#
#.........#
#....#....#
#.........#
#.........#
#####D#####
key : 8

2
3
###########
#........X#
#.........#
#.........#
#.#.......#
D..#......#
#.........#
#.#.#.....#
#..##.....#
#.........#
###########

2
1
#####d#####
#.........#
#..#......#
#.#.......#
#.........#
#.........d
#.........#
#.#.....#.#
#..#...#..#
#.........#
#####d#####

3
1
#####d#####
#.........#
#..#...#.##
#.........#
#....#....#
#.........D
#..#...#..#
#.........#
#......#.##
#.........#
#####D#####

8
0
#####D#####
#.........#
#.........#
#.........#
#.........#
#.........#
#.........#
#.#.....#.#
#..#...#..#
#?........#
###########
door 0 : 0 1
sign The ceiling is higher than it looks.

7
0
#####D#####
#..#......#
#.........#
#.........#
#...#..#..#
#.........D
#.........#
#..#..#..##
#.........#
#.........#
#####D#####

4
2
#####D#####
#.........#
#..#......#
#.#.......#
#.........#
D.........#
#.........#
#.......#k#
#......#..#
#.........#
#####D#####
key : 1

0
1
###########
#e.......e#
#?........#
##..#.....#
#.........#
#.........#
#....#..#.#
#.........#
#.........#
##.....#..#
#####D#####
enemies 2
sign The dungeon remembers all who enter.

5
1
#####D#####
#e.......e#
#.......p.#
#.........#
#.........#
D.........D
#...##....#
#.........#
#..#......#
#e........#
#####D#####
enemies 3

6
1
#####D#####
#.........#
#.....#...#
#....##...#
#....e#...#
D....#e...#
#...##....#
#...####?.#
#...#..##.#
#......s#e#
#####D#####
enemies 3
switch 0 : 0 1
sign Many have walked this path.

3
2
#####D#####
#.........#
#..#...#..#
#.#.....#k#
#.........#
D.........#
#.........#
#.#.......#
#..#..#...#
#.........#
#####D#####
key : 5

6
0
#####d#####
#.........#
#..#...#..#
#.#.....#.#
#.........#
#.........D
#.........#
#.......#.#
#......#..#
#.........#
#####D#####

5
0
#####D#####
#.........#
#.........#
#.........#
#..#@#....#
#..####...D
#.#####...#
#.##.#....#
#.##......#
##........#
#####d#####

5
2
#####D#####
##.#......#
##.#......#
#..#......#
#.........#
D.........#
#.##......#
##........#
#.###.....#
#........k#
###########
key : 0

1
1
#####D#####
#.........#
#.........#
#.........#
#.........#
#.........D
#.........#
#.........#
#.........#
#.........#
#####d#####

4
1
#####D#####
##.......e#
#.........#
#.........#
#...#..#..#
D.........D
#.........#
##..#..#..#
#.........#
#e........#
#####D#####
enemies 2

2
2
#####D#####
#.........#
#.........#
#.........#
#.........#
d....e....D
#....##...#
#....###..#
#.....##..#
#.........#
#####D#####
boss
enemies 1

7
1
#####D#####
#.......#.#
#.........#
#.........#
#.#..#....#
D.........#
#.........#
#.#..#....#
#.........#
#.........#
###########

