3
0
#####d#####
#.p.......#
#.........#
#.#.#.#...#
#.#.##....#
#.........D
#.##.#....#
#...##....#
#.p.......#
#.........#
#####D#####

2
0
#####D#####
#.........#
#.#...#.#.#
#.........#
#.....#.#.#
#.........D
#.#.#.#...#
#.........#
#.#.#...#.#
#.........#
#####d#####

7
2
#####D#####
##.....#..#
#e........#
#.........#
#e#..#..#.#
#?........D
#e........#
##..#..#..#
#.........#
#.........#
#####D#####
enemies 3
door 1 : 1 2
sign Only the prepared may pass.

1
1
#####D#####
#.........#
#.........#
#.........#
#...#.....#
d.........D
#.........#
#...#..#..#
#.........#
#.........#
#####D#####

7
3
#####D#####
#.........#
#..#...#..#
#.#.....#?#
#.........#
D.........#
#.........#
#.........#
#.........#
#.........#
#####D#####
sign The brave are rewarded.

3
1
#####D#####
#.........#
#......#..#
#.......#.#
#.........#
D.........#
#.........#
#.......#.#
#......#..#
#........k#
###########
key : 1

1
2
###########
#........k#
##..#..#..#
#.........#
#.........#
D...#..#..#
#.........#
#.........#
#...#.....#
#.........#
###########
key : 3

1
0
###########
#ee.......#
#e........#
#s........#
#?........#
#.........d
#.........#
#.........#
#.........#
#.........#
#####D#####
enemies 3
switch 1 : 1 2
sign Beware what lurks ahead.

4
0
#####D#####
#.........#
#.........#
#.........#
#.........#
#...#@##..#
#.#.#.#.#.#
#.#.#...#.#
#.##......#
##........#
#####D#####

5
1
###########
#.........#
#.........#
#.#..#..#.#
#.........#
D.........D
#.#..#..#.#
#.........#
#.........#
#.#.....#.#
#####l#####

6
2
#####D#####
#..#......#
#.###.....#
#.###.....#
#..###....#
l....e....D
#..###....#
#.........#
#.........#
#.........#
#####D#####
locked : 1
boss
enemies 1

2
1
#####D#####
#e#.....#s#
#.........#
#.#.#.#.#.#
#.........#
D.....#...#
#.........#
#.#.#...#.#
#.........#
#e#.....#.#
#####D#####
enemies 2
switch 0 : 0

8
2
#####D#####
#.........#
##.#......#
#e#.......#
#.###.#.#.#
#.e##..#..D
#.#######.#
#...####..#
#...#.....#
#e........#
###########
enemies 3
door 0 : 0

6
1
#####l#####
#.........#
#..#......#
#.#.......#
#.........#
#.........l
#.........#
#.#.......#
#..#......#
#.........#
###########
locked : 0

5
2
###########
#........X#
#......#..#
#.....#...#
#......#..#
D.........#
#..#......#
#..##.....#
#...#.....#
#.........#
#####D#####

8
3
#####D#####
#........p#
#.........#
#.........#
#.......p.#
D..##.....#
#.##......#
##..#.....#
###.#.....#
#.........#
###########

0
1
###########
#.##......#
#...#.....#
#...#.....#
#.##......#
#.........#
#.........#
#.........#
#.........#
#.........#
#####D#####

6
3
###########
#......##k#
#.........#
#...#.#.#.#
#....##...#
D.........#
#......#..#
#.........#
#.........#
#.........#
#####D#####
key : 4

5
0
#####D#####
#.........#
#.........#
#.........#
#...##.##.#
#.....##..D
#.......#.#
#...#.##..#
#...#.#.#.#
#k........#
###########
key : 0

