8
0
#####l#####
#.........#
#...#.#...#
##....#...#
#...###...#
#....e....#
#.........#
#.........#
#.........#
#.........#
#####D#####
locked : 4
boss
enemies 1

4
3
###########
#.#.......#
#.........#
#.#.#.#.#.#
#.........#
d...#.#...#
#.........#
#.#.#.#.#.#
#.........#
#.#.....#.#
###########

5
1
#####D#####
#.........#
#.........#
#.........#
#.........#
D.........d
#.........#
#.........#
#.........#
#.........#
#####D#####

4
2
#####d#####
#..#......#
#..k#.....#
#..#.#.#..#
#....#.#..#
D..###.#..d
#.........#
#.........#
#.........#
#.........#
#####D#####
key : 3

2
0
#####D#####
#s........#
#.........#
#.........#
#.........#
#e........D
#.........#
#.........#
#ep.......#
#.........#
#####D#####
enemies 2
switch 0 : 0

3
2
###########
##.....#..#
#.........#
#.........#
#.#.....#.#
#.........#
#.........#
#......#..#
#.........#
#.........#
#####d#####

1
1
###########
#........e#
#..#...#..#
#.........#
#..#...#..#
D.........#
#....#.#..#
#.........#
##.#.....##
#.........#
#####D#####
enemies 1

1
0
#####D#####
##.#......#
#.........#
#k#.....#.#
#.........#
#..#.#.#..D
#.........#
#.....#...#
#.........#
##.#...#..#
#####D#####
key : 4

6
1
#####D#####
#.........#
#.........#
#.........#
#.........#
D.........#
#.........#
#.........#
#.........#
#.........#
###########

0
0
###########
#e.......?#
#.........#
#.....###.#
#.##..###.#
#.....##..#
#.#.#.....#
#.........#
#.........#
#.........#
#####D#####
enemies 1
door 0 : 0
sign A useful tool lies just ahead.

5
2
#####D#####
#.......#.#
#.........#
#.#...#.#.#
#.........#
d...#.....#
#.........#
#.#.#.#.#.#
#.........#
#.#.....#.#
###########

6
0
#####l#####
#.........#
#.##......#
#...#.....#
#.........#
#.........D
#.........#
#.........#
#.........#
#.........#
#####l#####
locked : 1

5
0
#####D#####
#.........#
#.........#
#.........#
#..#..#...#
#..###.#..D
#...##....#
#...k#.#..#
#...#..#..#
#.........#
#####l#####
key : 0

7
0
#####l#####
#.........#
#......#..#
#.......#.#
#.........#
#.........#
#.........#
#.......#.#
#......#..#
#.........#
#####l#####
locked : 3

9
0
#####D#####
#.........#
#.........#
#.........#
#...##....#
#.........#
#...###...#
#.........#
#.........#
#X........#
###########

4
1
###########
#.k.......#
#.#.....#.#
#.........#
#.........#
D....#....D
#.........#
#.........#
#.#.....#.#
#.........#
#####D#####
key : 1

2
1
#####D#####
#.........#
#.........#
#.........#
#.........#
D..####...#
#....#....#
#...###...#
#.........#
#.##......#
###########

4
0
#####D#####
#.........#
#.....#...#
#.........#
#.........#
#....@....D
#.........#
#.........#
#..#......#
#.........#
#####D#####

3
0
#####D#####
#.........#
#...#.#...#
#...#.....#
#.........#
#.........#
#.....###.#
#.........#
#.....###.#
#.........#
#####D#####

