6
0
#####l#####
#.........#
##.#...#..#
#.........#
#..#.#.#..#
#..........
#..#.#.#..#
#.........#
##.#.....##
#.........#
#####l#####
locked : 1

4
0
#####.#####
#..#......#
#.........#
#.........#
#.........#
#....@.....
#.#.##....#
#.##......#
#...#.....#
#.........#
#####.#####

3
2
###########
#.........#
#..#......#
#.#.......#
#.........#
#.........#
#.........#
#.......#.#
#......#..#
#.........#
#####d#####

8
0
#####l#####
#.........#
#.........#
#.##......#
#.##......#
#..#.e....#
#.........#
#.........#
#.........#
#.........#
#####.#####
locked : 4
boss
enemies 1

5
1
#####.#####
#.........#
#..#...#..#
#.#.....#.#
#..#......#
..........d
#.........#
#.......#.#
#......#..#
#.........#
#####.#####

4
2
#####d#####
#k#.....#.#
#.........#
#.........#
#..#..#...#
..........d
#.........#
#.#..#....#
#.........#
#.........#
#####.#####
key : 3

7
0
#####l#####
#.........#
#.........#
##..#..##.#
#....###..#
#..##..#..#
#....#.##.#
#...##.##.#
#.........#
#.........#
#####l#####
locked : 3

2
1
#####.#####
#.........#
#.........#
#.........#
#.........#
..........#
#.........#
#.........#
#.........#
#.........#
###########

1
1
###########
#........e#
##........#
#.........#
#..#.#.#..#
..........#
#..#.#.#..#
#.........#
#..#...#.##
#.........#
#####.#####
enemies 1

5
2
#####.#####
#.........#
#.........#
#.........#
#.........#
d...#.....#
#.........#
#......#..#
#.........#
#.........#
###########

0
0
###########
##e#...#?##
#.........#
#.#.#.#...#
#.........#
#..#......#
#.........#
#...#.#...#
#.........#
##.#...#..#
#####.#####
enemies 1
door 0 : 0
sign A useful tool lies just ahead.

3
0
#####.#####
#.........#
##..#..#..#
#.........#
#.........#
#....#....#
#.........#
#.........#
##..#..#..#
#.........#
#####.#####

5
0
#####.#####
#.........#
#.........#
#.........#
#.........#
#....#.....
#.........#
#.........#
##.....#..#
#k........#
#####l#####
key : 0

9
0
#####.#####
#.........#
#.........#
#.##......#
#.#.#.....#
#.........#
#.##......#
#.#.......#
#.........#
##.......X#
###########

4
1
###########
#....k....#
#.........#
#.........#
#.......#.#
...........
#...#.....#
#.......#.#
#......#..#
#.........#
#####.#####
key : 1

6
1
#####.#####
#.........#
#.........#
#.........#
#.........#
..........#
#.........#
#.........#
#.........#
#.........#
###########

2
0
#####.#####
#.........#
#.#...#.#.#
#.........#
#e#...#.#.#
#.s........
#e#.#.#.#.#
#.........#
#.#.#.#.#.#
#.........#
#####.#####
enemies 2
switch 0 : 0

1
0
#####.#####
#.........#
#.........#
#.........#
#.........#
#k.........
#.........#
#.........#
#.........#
#.........#
#####.#####
key : 4

4
3
###########
#.........#
#..#..#...#
#.........#
#.........#
d.....#...#
#.........#
#.........#
#........##
#.........#
###########

