0
1
###########
#.......#.#
#.........#
#.#.#...#.#
#.........#
D...#.....#
#.........#
#.#...#.#.#
#.........#
#.#.....#.#
#####l#####
locked : 0

1
2
###########
#........e#
#.........#
#.........#
#...#..#..#
D.........#
#.........#
#..#.....##
#.........#
#.........#
#####D#####
enemies 1

0
0
###########
#.........#
#..#..#...#
#.#..##...#
#.........#
#..#.#....D
#.........#
#.........#
#.........#
#.........#
#####d#####

6
2
#####D#####
#.........#
#...#.#...#
#..##.#...#
#.....#...#
#..#......D
#.........#
#.........#
#.........#
#k........#
###########
key : 9

3
2
#####D#####
#......#..#
#...#.#.#.#
#...#.#...#
#..####.#.#
D..##.#...D
#.#.#.....#
#....##...#
#..#......#
#.........#
#####D#####

4
2
#####D#####
#......#..#
#..#..#...#
#..#.....p#
#....#.#..#
D....#.#..d
#.........#
#p........#
#.........#
#.........#
#####D#####

2
1
#####D#####
##.....#.?#
#.........#
#.........#
#...#..#..#
D.........D
#.........#
##..#..#..#
#.........#
#e........#
#####D#####
enemies 1
sign Those who search shall find.

5
3
#####d#####
#.........#
#.........#
#.........#
#.........#
D....e....#
#....##...#
#....#.#..#
#.........#
#.........#
#####D#####
boss
enemies 1

6
3
#####D#####
#......#..#
#...#.###.#
#.....#.#.#
#.......#.#
D.........#
#.........#
#.........#
#.........#
#........X#
###########

1
0
#####d#####
#.........#
#.........#
#p........#
#?........#
#....@....D
#.........#
#.......p.#
#.........#
#.........#
#####D#####
sign The brave are rewarded.

1
1
#####l#####
#k........#
#.........#
#.........#
#.........#
D.........D
#.........#
#.........#
#.........#
#.........#
#####D#####
key : 0

5
2
#####D#####
#k........#
#.........#
#.........#
#.........#
D.........D
#.........#
#.........#
#.........#
#.........#
#####D#####
key : 7

2
0
#####D#####
#.........#
#.........#
#.........#
#.........#
#.........D
#.........#
#.........#
#.........#
#.........#
###########

4
3
#####D#####
#.........#
#......#..#
#.......#.#
#.........#
d.........#
#.........#
#.#.......#
#..#......#
#.........#
#####d#####

3
3
###########
#.....e#e##
#.....##.##
#.....?#..#
#.....###.#
D.........#
#.........#
#.........#
#.........#
#.........#
#####D#####
enemies 2
sign Beware what lurks ahead.

4
1
#####d#####
#.........#
#.....#...#
#...#.....#
#.........#
#.........D
#.........#
#.........#
#.........#
#.........#
#####D#####

2
2
#####D#####
#.........#
#.........#
#.........#
#.........#
D..#.#....#
#.#.##k#..#
###..###..#
#.##..##..#
#.........#
#####D#####
key : 1

3
1
#####D#####
#.........#
#..#...#.##
#.#.....#.#
#.........#
#...#.....D
#.........#
#.......#.#
#......#..#
#.........#
#####d#####

5
1
#####D#####
#.........#
#.........#
#.........#
#.........#
#.........D
#.........#
#?........#
#e........#
#ee.......#
###########
enemies 3
sign A useful tool lies just ahead.

