3
1
#####.#####
#k........#
#.........#
#.........#
#.........#
...........
#.........#
#.........#
#.........#
#.........#
#####.#####
key : 0

1
0
#####d#####
#e#.....#e#
#.........#
#.#...#.#.#
#.........#
#.....#....
#.........#
#...#.#.#.#
#.........#
#e#.....#.#
#####.#####
enemies 3

1
2
#####.#####
##.#......#
##..#.....#
#..##.....#
#.#.##....#
....e#....#
#.........#
#.........#
#.........#
#.........#
#####d#####
boss
enemies 1

2
3
###########
#..#.....e#
#.........#
#.........#
#..#..#...#
..........#
#.........#
#.....#..##
#.........#
#.........#
###########
enemies 1

0
1
###########
#...?.....#
#..##.....#
#..#e#....#
#.........#
...........
#.........#
#.........#
#.........#
#.........#
#####.#####
enemies 1
sign Something glints behind that door…

5
3
###########
#........k#
#......#..#
#.......#.#
#.........#
..........#
#.........#
#.......#.#
#......#..#
#.........#
###########
key : 2

3
2
#####.#####
#.........#
#.#.....#.#
#.........#
#.........#
......#...#
#.........#
#.........#
#.#.....#.#
#.........#
#####d#####

1
1
#####.#####
#k........#
#.........#
#.........#
#.........#
...........
#.##......#
#.#.......#
#.........#
#.........#
#####.#####
key : 4

2
2
#####d#####
#k........#
#.........#
#.........#
#.........#
.....#.....
#.........#
#.........#
#.#.....#.#
#.........#
#####.#####
key : 1

4
0
#####d#####
#.........#
#.........#
#.........#
#.....###.#
#....@##...
#.....#?#.#
#.....#...#
#......#..#
#.........#
#####.#####
sign The dungeon remembers all who enter.

4
1
#####.#####
##.#.....##
#.........#
##...#...##
#.........#
...#.#.#...
#.........#
##...#.#.##
#.........#
##.#.....##
###########

3
0
#####.#####
#.#.......#
#.........#
#.....#.#.#
#.........#
#...#......
#.........#
#.#.#.#.#.#
#.........#
#.......#.#
#####d#####

2
1
#####.#####
#e#.......#
#.........#
#..#.#.#..#
#.........#
....#.#....
#.........#
#..#.#.#.##
#.........#
#e#.....#e#
#####.#####
enemies 3

5
0
#####.#####
#.........#
#.........#
#..#.#....#
#.....#...#
#..#......#
#....##...#
#....#.#..#
#.........#
#.........#
###########

0
0
###########
#.........#
#.........#
#.........#
#.........#
#..#.#.....
#.#..#..#.#
#.#...###.#
#.......#.#
#.........#
#####d#####

0
2
###########
#.##.....X#
#..##.#...#
#....##...#
#.###.#...#
....#.#...#
#.###.....#
#.........#
#.........#
#.........#
#####.#####

5
2
#####.#####
#.........#
#.........#
#.........#
#.........#
#.....##...
#......#..#
#....#.#.##
#.....#####
#.........#
###########

4
2
#####d#####
#.........#
#.........#
#.........#
#......##.#
.....##...#
#.....##..#
#....#....#
#.....#####
#.........#
#####.#####

2
0
#####.#####
#..#...#.##
#.........#
##.#...#..#
#.........#
#....#.#...
#.........#
##...#.#.##
#.........#
##.......##
#####.#####

