4
0
#####.#####
#..#.....##
#.........#
#.........#
#.....#...#
#k.........
#.........#
#.....#...#
#.........#
#.........#
#####.#####
key : 1

1
1
###########
#...k.....#
#.#.#.....#
#.#.......#
#...#.....#
...........
#.........#
#.........#
#.........#
#.........#
#####.#####
key : 0

3
2
#####.#####
#.........#
#.........#
#.........#
#.........#
#.........#
#.........#
#.#.......#
#..#......#
#.........#
#####d#####

1
2
#####.#####
#.........#
#.........#
#.........#
#..##.....#
....####..d
#..#...#..#
#..###.#..#
#...#..#..#
#.........#
#####.#####

7
1
#####.#####
#.........#
#.........#
#.........#
#.........#
#.........#
#.##......#
#..##.....#
#..#......#
#X........#
###########

4
3
###########
#.........#
#.........#
#.........#
#.........#
l.........#
#.........#
#.#.....#.#
#..#...#..#
#.........#
###########
locked : 0

4
2
#####d#####
#.........#
#.........#
#......#..#
#.........#
l.........l
#.........#
#.#.......#
#..#......#
#.........#
#####l#####
locked : 2

2
2
#####.#####
#?........#
#.........#
#.........#
#.##......#
...#.....e#
#.........#
#.........#
#.........#
#.........#
#####.#####
enemies 1
sign Many have walked this path.

4
1
###########
#......k..#
#......#..#
#.......#.#
#.........#
..........l
#.........#
#.........#
#.........#
#.........#
#####l#####
key : 2

3
0
#####d#####
#.......#.#
#.....##..#
#......#..#
#.....###.#
#..##.....#
#.##......#
#####.....#
#####.....#
##........#
#####.#####

0
2
###########
##.....#.k#
#.........#
#.........#
#...#..#..#
#.........#
#.........#
##..#..#..#
#.........#
#.........#
#####.#####
key : 3

5
0
#####.#####
#.........#
#.........#
#..#..#..##
#.........#
#..........
#..#..#...#
#.........#
#.........#
#..#......#
###########

1
0
###########
##........#
#......#..#
#.......#.#
#..#......#
#..........
#.........#
#.........#
#.........#
#.........#
#####.#####

2
1
#####.#####
#.........#
#.........#
##..#..#..#
#.........#
...........
#.#..#....#
#.........#
#.........#
#......#..#
###########

5
1
#####l#####
#.........#
#.....###.#
#......#..#
#.........#
...........
#....###..#
#.....##..#
#......#..#
#.........#
#####d#####
locked : 3

5
2
#####l#####
#.........#
#.........#
#.........#
#.........#
..........#
#.........#
#.........#
#.........#
#.........#
###########
locked : 1

1
3
###########
#.........#
#.........#
#.........#
#.........#
d.........#
#.........#
#.......#.#
#......#..#
#.........#
###########

6
1
#####d#####
#.........#
#.........#
#.........#
#.....##..#
#...#e....#
#.....##..#
#.....###.#
#.....##..#
#.........#
#####.#####
boss
enemies 1

2
0
#####.#####
#?........#
##.##.....#
#.........#
#.#..#....#
#....@.....
#.........#
#.........#
#.........#
#.........#
#####d#####
sign Beware what lurks ahead.

