8
1
#####D#####
#.........#
#.........#
#.#.......#
#.........#
#....#....#
#...##....#
#...##....#
#...#.#...#
#e......?s#
###########
enemies 1
switch 0 : 0
sign The dungeon remembers all who enter.

3
3
#####D#####
#........##
#..#......#
#.#.......#
#.........#
D.........#
#.........#
#.........#
#.........#
#........k#
###########
key : 3

2
2
#####D#####
#.........#
#.......#.#
#.........#
#.........#
D.........D
#....#....#
#.........#
#.........#
#k#.......#
#####D#####
key : 2

1
2
###########
#.......?e#
#.........#
#.........#
#.#.......#
D..#.#....#
#..##.....#
#######...#
#..#..#...#
#.........#
#####D#####
enemies 1
door 0 : 0
sign A locked path — look elsewhere first.

4
2
#####D#####
#.......#.#
#.........#
#.........#
#..#..#...#
D.........#
#.........#
#.......#.#
#.........#
#.........#
#####d#####

1
0
###########
#X........#
#.........#
#.........#
#...##....#
#....###..D
#.......#.#
#....##...#
#...#.#.#.#
#.........#
###########

6
1
#####D#####
#.........#
#.........#
#.........#
#.........#
#....@....#
#.........#
#.........#
#.........#
#.........#
#####D#####

1
1
#####D#####
#.........#
#.........#
#.........#
#...e.#.#.#
D...##....D
#....#.##.#
#...###.#p#
#...#.#.#p#
#.........#
#####l#####
locked : 3
boss
enemies 1

3
1
#####d#####
#.........#
#.........#
#.........#
#.........#
#.........D
#.........#
#.........#
#......p..#
#.........#
#####d#####

7
2
###########
#........p#
#.........#
#.........#
#.........#
D.........d
#.........#
#.........#
#.........#
#.........#
###########

5
1
#####l#####
#.........#
#..#...#..#
#k#.....#.#
#.........#
#.........D
#.........#
#.#.......#
#..#......#
#.........#
#####D#####
key : 0

4
1
#####d#####
#.........#
#.........#
#.........#
#.........#
#....#....D
#...##....#
#####.....#
####......#
#.........#
#####l#####
locked : 0

7
3
###########
#.........#
#.........#
#.#.......#
#.........#
d.........#
#.#..#..#.#
#.........#
#.........#
#.#.......#
###########

5
2
#####d#####
#.........#
#..#......#
#.#.....#.#
#.........#
D.........#
#.......#.#
#.......#.#
#......#..#
#.........#
###########

3
2
#####D#####
#.........#
#.........#
#.........#
#.........#
D.........D
#.........#
#.........#
#.........#
#.........#
#####D#####

0
1
###########
#k#.....#.#
#.........#
#..#...#.##
#.........#
#...#.....#
#.........#
#..#.#.#.##
#.........#
#.#.....#.#
#####D#####
key : 4

7
1
#####D#####
#.........#
#......#..#
#.......#.#
#.........#
#.........D
#.........#
#.........#
#.........#
#.........#
#####D#####

2
3
###########
#........e#
#.......#.#
#.........#
#.........#
D..#......#
#.........#
#.........#
#.#.....#.#
#.........#
#####D#####
enemies 1

2
1
#####l#####
#.........#
#.........#
#.........#
#.........#
#.........D
#.........#
#.#.......#
#..#......#
#.........#
#####d#####

