4
2
#####D#####
#k........#
#......#..#
#.......#.#
#.........#
D.........D
#.........#
#.#.......#
#..#......#
#.........#
#####D#####
key : 2

3
1
#####D#####
#.##......#
#.###.....#
#.#####...#
#.#..#....#
D....e....D
#.........#
#.........#
#.........#
#.........#
#####d#####
boss
enemies 1

3
2
#####D#####
#.........#
#......#..#
#.......#k#
#.........#
D.........#
#.........#
#.#.......#
#..#......#
#.........#
#####D#####
key : 3

1
1
###########
#.........#
#.........#
#.........#
#.##......#
D..#.##...D
#.##k##...#
#..####...#
#...#.#...#
#.........#
#####D#####
key : 0

5
2
#####D#####
#.........#
##.#.....##
#.........#
#..#.#....#
D.........#
#..#.#....#
#........e#
##.#.....##
#........e#
###########
enemies 2
door 0 : 0 1

0
3
###########
#.........#
#.........#
#.........#
#.........#
d.........#
#.........#
#.#.......#
#..#......#
#.........#
###########

2
1
#####D#####
#.........#
##.#.....##
#.........#
#.#.......#
D.........D
#..#.#....#
#.........#
#.#.#.#.#.#
#.........#
#####D#####

1
2
#####d#####
#.#.......#
#..#..#...#
#..#.#....#
#.##.##...#
D.........#
#..##.....#
#....#....#
#.........#
#.........#
#####D#####

1
0
#####D#####
#.........#
#.........#
#.........#
#.........#
#?...@....D
#.........#
#.........#
#.........#
#.........#
#####l#####
sign Seek the matching key before you proceed.

3
0
#####D#####
#.........#
#..#...#..#
#.#.....#.#
#.........#
#.........D
#.........#
#.........#
#.........#
#.........#
#####d#####

5
1
#####D#####
####......#
###.......#
##.#......#
#..##.....#
#...#.....D
#.....##..#
#....##...#
#.....##..#
#.........#
#####D#####

4
0
#####d#####
#.........#
#..#......#
#.#.......#
#.........#
#.........D
#.........#
#.#.....#.#
#..#...#..#
#.........#
###########

6
1
#####D#####
#.........#
#.........#
#.........#
#.........#
#.........#
#.........#
#.......#.#
#......#..#
#k........#
###########
key : 4

0
0
###########
#......#..#
#..#..#...#
#..##.#.#.#
#...##.#..#
#..#.#.#..#
#.........#
#.........#
#.........#
#.........#
#####D#####

4
3
###########
#.......?e#
#.........#
#.........#
#.........#
D.........#
#.........#
#.........#
#.........#
#........e#
###########
enemies 2
sign Something glints behind that door…

2
2
#####D#####
#.........#
#.........#
#.........#
#.........#
D..#......#
#..#.#..#X#
#.#..#.#..#
###.......#
###.......#
#####D#####

0
2
###########
#.........#
#.........#
#.........#
#.........#
#.........d
#.........#
#.#.......#
#..#......#
#.........#
#####d#####

4
1
#####d#####
#e.......s#
#.........#
#.........#
#.........#
D.........D
#.........#
#.........#
#.........#
#e.......?#
#####D#####
enemies 2
switch 0 : 0 1
sign What you seek is close.

2
0
#####l#####
#.........#
#.#...#...#
#.........#
#.#.#.#.#.#
#.........D
#.#...#...#
#.........#
#.#.#.#...#
#.........#
#####D#####
locked : 0

