2
1
#####D#####
#.........#
#.........#
#.........#
#.........#
D.........#
#.........#
#.........#
#.........#
#.........#
#####D#####

4
1
#####D#####
#?.......e#
#.....#..##
#.........#
#.........#
D..#..#...D
#.........#
#.........#
#..#..#..##
#........e#
#####D#####
enemies 2
sign This door will not yield without a key.

5
4
###########
#.........#
#.......#.#
#.....##..#
#.....##..#
d....e....#
#.........#
#....#....#
#.........#
#.........#
#####D#####
boss
enemies 1

4
0
#####d#####
##.....#..#
#.........#
#.........#
#.#.....#.#
#.........D
#.........#
##..#..#..#
#.........#
#.........#
#####D#####

1
0
#####D#####
#s........#
#?........#
#.........#
#.........#
#e........D
#....p....#
#.........#
#.........#
#.........#
#####D#####
enemies 1
switch 0 : 0 1
sign The dungeon remembers all who enter.

3
2
###########
#.........#
#..#...#.##
#.........#
#.....#...#
d.........D
#..#.#....#
#.........#
#...#.#.#.#
#.........#
#####D#####

2
0
#####D#####
#.........#
#.........#
#..###....#
#..#?.....#
#..##@....D
#.........#
#.........#
#.........#
#.........#
#####D#####
sign Those who search shall find.

1
1
###########
#.........#
#..#..#...#
#..####...#
#...###...#
D..###.#..#
#..###.#..#
#.........#
#.........#
#.........#
#####D#####

3
0
#####D#####
#.........#
#k#.#.#.#.#
#.........#
#..#...#..#
#.........l
#.....#.#.#
#.........#
#..#...#..#
#.........#
#####d#####
key : 0

3
3
###########
#........k#
#.........#
#.........#
#.........#
D.........#
#.........#
#.#.....#.#
#..#...#..#
#.........#
#####D#####
key : 6

5
3
#####d#####
#.........#
#......#..#
#.......#.#
#.........#
#.........d
#.........#
#.......#.#
#......#..#
#.........#
#####D#####

6
3
#####D#####
#.........#
#.#.....#.#
#.........#
#..#...#..#
#.........D
#.#.....#.#
#.........#
#......#.##
#k........#
###########
key : 11

0
0
###########
#e........#
#.........#
#.....#...#
#.........#
#.........#
#...#..#..#
#.........#
#.........#
#..#.....##
#####D#####
enemies 1
door 0 : 0 1

6
4
#####D#####
#.........#
#.........#
#.........#
#..##.....#
D.........#
#.##......#
##.##.....#
##........#
#........X#
###########

3
1
#####D#####
#.........#
#.........#
#.........#
#.........#
l.........d
#.........#
#.........#
#.........#
#.........#
#####D#####
locked : 0

4
2
#####D#####
#..#...#..#
#.###.##..#
#...##....#
#.######..#
D.........D
#.##.#....#
#.........#
#.........#
#.........#
###########

5
0
#####D#####
#.........#
#.#.....#.#
#.........#
#.........#
#.....#...D
#.........#
#.........#
#.#.......#
#.........#
###########

5
1
#####D#####
#.#.......#
#.........#
#....#.#.##
#.........#
D...#.#...#
#.........#
#..#.#.#.##
#.........#
#.#.....#k#
###########
key : 4

4
3
#####D#####
#......#.##
#........e#
##.#.#.#.##
#........e#
D....#....#
#........?#
#....#.#.##
#........e#
#..#...#.##
#####d#####
enemies 3
sign Something glints behind that door…

