5
0
#####.#####
#.........#
#.........#
#.........#
#.........#
#..........
#.........#
#.........#
#.........#
#.........#
###########

3
0
#####.#####
#..#......#
#......#..#
#k#.....#.#
#.........#
#...#.....l
#.........#
#.#.......#
#..#......#
#.........#
#####d#####
key : 0

4
1
#####.#####
#e.....#.?#
#.........#
#.........#
#.#.....#.#
...........
#.........#
##..#..#..#
#.........#
#e........#
#####.#####
enemies 2
sign This door will not yield without a key.

6
3
#####.#####
#.........#
#.........#
#.........#
#.........#
#..#.......
#....###..#
#....###..#
#...#.##..#
#k........#
###########
key : 11

6
4
#####.#####
#.........#
#.........#
#....#.#..#
#.........#
..........#
#.........#
#.........#
#.........#
#.#......X#
###########

2
1
#####.#####
#.........#
#.........#
#.........#
#.........#
...#......#
#...#.....#
#..##.....#
#.........#
#.........#
#####.#####

5
4
###########
#..#...#..#
#..##.##..#
#..#......#
#....#....#
d..##e.#..#
#.........#
#.........#
#.........#
#.........#
#####.#####
boss
enemies 1

3
1
#####.#####
#.........#
#.....#...#
#.........#
#.........#
l.....#...d
#.........#
#.......#.#
#......#..#
#.........#
#####.#####
locked : 0

3
2
###########
#......#..#
#..#......#
#.#.......#
#.........#
d..........
#.........#
#.........#
#.........#
#.........#
#####.#####

3
3
###########
#........k#
#......#..#
#.......#.#
#.........#
..........#
#.........#
#.......#.#
#......#..#
#.........#
#####.#####
key : 6

1
0
#####.#####
#.........#
#...#..#..#
#.........#
#.........#
#?..#..#...
#.........#
#s........#
##.....#..#
#e........#
#####.#####
enemies 1
switch 0 : 0 1
sign The dungeon remembers all who enter.

4
2
#####.#####
#.........#
#.........#
#.........#
#.........#
...........
#.........#
#.........#
#.........#
#.........#
###########

2
0
#####.#####
#.........#
#.....##..#
#...#.....#
#.........#
#?...@.....
#.........#
#.........#
#.........#
#.........#
#####.#####
sign Those who search shall find.

5
3
#####d#####
#.........#
#.........#
#.........#
#.........#
#.........d
#.........#
#.#.......#
#..#......#
#.........#
#####.#####

5
1
#####.#####
#.........#
#.#.#...#.#
#.........#
#..#...#..#
..........#
#.#.#...#.#
#.........#
#......#.##
#........k#
###########
key : 4

1
1
###########
#.........#
#.#...#.#.#
#.........#
#..#...#..#
..........#
#.#.#.#.#.#
#.........#
#..#...#..#
#.........#
#####.#####

4
0
#####d#####
#.........#
##.#...#.##
#.........#
#...#...#.#
#..........
#......#..#
#.........#
#.#.#.#.#.#
#.........#
#####.#####

4
3
#####.#####
#e#.......#
#.........#
#...#.#.#?#
#.........#
....#.#...#
#.........#
#.#.#.#.#.#
#.........#
#e#.....#e#
#####d#####
enemies 3
sign Something glints behind that door…

0
0
###########
#e........#
#.........#
#.........#
#.........#
#...###...#
#...###...#
#.##...#..#
#..##.##..#
#..#......#
#####.#####
enemies 1
door 0 : 0 1

