3
2
#####D#####
#..#...#..#
#.........#
##.#.#.#..#
#.........#
D..#......D
#.........#
##.#.#.#..#
#.........#
#..#...#.##
#####l#####
locked : 1

0
3
###########
#........X#
#.........#
#..#......#
#..##.....#
D...#.#...#
#.##.#....#
#....#....#
#.........#
#.........#
#####D#####

5
1
#####D#####
#.........#
#.....#...#
##.##.....#
#.#.......#
D...##....#
#.###.....#
######....#
##.##.....#
#.........#
#####D#####

4
1
#####d#####
#.........#
#.........#
#.........#
#....#....#
d.........D
#.........#
#.........#
#.........#
#......#..#
#####D#####

2
2
#####D#####
#.........#
#...#.....#
#..#.#..#.#
#..#..#...#
D.........d
#....#.#..#
#.....##.##
#.........#
#.........#
#####D#####

1
3
#####D#####
#.........#
#.........#
#.........#
#.........#
D....e....#
#.........#
#.........#
#.........#
#.........#
#####d#####
boss
enemies 1

2
1
###########
#.........#
#.........#
#.........#
#...#..#..#
#.........D
#.........#
#..#..#...#
#.........#
#.........#
#####D#####

0
2
###########
#.........#
#......#..#
#.......#.#
#.........#
#.........D
#.........#
#.........#
#.....#...#
#........##
#####D#####

4
2
#####l#####
#..#......#
#......#..#
#.......#.#
#.........#
D.........D
#....#....#
#.........#
#.........#
#.........#
###########

6
1
#####D#####
#.........#
#..#......#
#.#.......#
#..#......#
#.........#
#.........#
#.........#
#.........#
#k........#
###########
key : 1

4
3
#####D#####
#.........#
#.........#
#.........#
#......#..#
D....##...#
#....##...#
#......#..#
#.....#####
#.......?e#
###########
enemies 1
sign Many have walked this path.

4
0
#####D#####
#..#......#
#.###.....#
#.####....#
#.####....#
#..##@....d
#.#.#.....#
#.........#
#.........#
#.........#
#####D#####

1
2
#####D#####
##........#
#..#...#..#
#k#.....#.#
#.........#
#.........D
#.........#
#.........#
#......#..#
#.........#
#####D#####
key : 2

3
0
###########
#k........#
#......#..#
#.......#.#
#.........#
#.........D
#.........#
#.#.......#
#..#......#
#.........#
#####D#####
key : 0

2
4
###########
#........k#
#.........#
#.........#
#.........#
D.........#
#.........#
#.#.....#.#
#..#...#..#
#.........#
###########
key : 6

3
3
#####D#####
#.........#
#.##..#...#
#.e##.#...#
#.#.e##...#
D...##e...#
#...###...#
#..#......#
#.#.#.....#
#.........#
#####D#####
enemies 3

3
1
#####D#####
#.........#
#..#......#
#.#.......#
#.........#
D.........D
#.........#
#.........#
#.........#
#.........#
#####d#####

2
3
#####d#####
#.........#
#..#.....##
#.........#
#.#.#.#.#.#
d.........D
#..#.#.#..#
#.........#
#.#.#.#.#.#
#.........#
#####D#####

5
0
#####D#####
#..#.....##
#.........#
#..#.#.#.##
#.........#
#......#..D
#.........#
##.....#..#
#.........#
#..#...#.##
###########

