0
1
###########
#.........#
#.........#
#.........#
#.........#
D..##.##..D
#..##..#..#
#...###...#
#..##.....#
#..#......#
#####d#####

0
2
###########
#....k....#
#.........#
#.........#
#.........#
D.........D
#.........#
#.........#
#.........#
#.........#
#####D#####
key : 3

1
3
#####D#####
##.#...#.##
#.........#
#.....#...#
#.........#
d..#.#.#..d
#.........#
#.#.....#.#
#.........#
##.#...#.##
#####d#####

3
4
#####D#####
#......#..#
#.........#
#.........#
#e#.......#
#e.......?#
#.........#
#.........#
#.........#
#.........#
#####D#####
enemies 2
sign This door will not yield without a key.

2
3
#####d#####
#.........#
#.........#
#.....#..##
#.........#
#.........D
#...#..#..#
#.........#
#.........#
#..#.....##
###########

4
0
#####D#####
#.........#
#......#..#
#.......#.#
#.........#
#.........#
#.........#
#........##
#.........#
#.........#
###########

1
0
#####D#####
#.p.......#
#.........#
#.........#
#.........#
#....@##..D
#......##.#
#....#.#.##
#......#..#
#........##
#####D#####

1
2
#####D#####
#.........#
#.........#
#.........#
#.........#
l.........d
#.........#
#.........#
#.........#
#.........#
###########
locked : 0

1
4
###########
#.........#
#.........#
#.........#
#.........#
d.........#
#.........#
#.#.......#
#..#......#
#.........#
#####l#####

0
0
###########
#.........#
#..#......#
#.#.......#
#.........#
#.........D
#....#....#
#.#.....#.#
#..#...#..#
#.........#
#####D#####

4
4
#####D#####
#..#......#
#.....##..#
#...####..#
#..#.#.#..#
#.........#
#.........#
#.........#
#.........#
#X........#
###########

1
1
#####d#####
#k........#
#..#......#
#.#.......#
#.........#
D.........l
#.........#
#.#.......#
#..#......#
#.........#
#####D#####
key : 1

2
4
#####l#####
#.........#
#.........#
#.........#
#.........#
D....e....D
#.........#
#.........#
#.........#
#.........#
#####D#####
locked : 1
boss
enemies 1

2
5
###########
#..#.....?#
#.........#
#.........#
#...##.#..#
D....##...#
#..#.##...#
#..###....#
#..##.#...#
#.....e#..#
###########
enemies 1
door 0 : 0
sign Only the prepared may pass.

3
0
#####D#####
#.........#
#...#.....#
#...#.##..#
#......#..#
#....##...D
#....#....#
#.........#
#.........#
#.........#
#####D#####

0
3
###########
#.#.....#k#
#.........#
#.#...#.#.#
#.........#
D.....#...#
#.........#
#.#.#.#.#.#
#.........#
#.......#.#
#####D#####
key : 5

3
1
#####D#####
#.........#
#.###.....#
#.#.#.....#
#.#.......#
D.........#
#......#..#
#....##s..#
#.........#
#........e#
###########
enemies 1
switch 0 : 0

2
1
#####D#####
#.........#
#..#......#
#.........#
#.#.......#
D.........#
#.........#
#...#...#.#
#......#..#
#.........#
#####D#####

2
0
#####D#####
#.........#
#..#......#
#k#.......#
#.........#
#.........D
#.........#
#.........#
#.........#
#.........#
#####D#####
key : 0

