4
1
#####D#####
#.........#
#.........#
#.........#
#.........#
l.........D
#.........#
#.........#
#.........#
#.........#
#####l#####
locked : 0

7
1
#####D#####
#.........#
#.....#..##
#.........#
#.........#
#...#.....#
#.........#
#.........#
#.....#..##
#........k#
###########
key : 3

3
1
#####D#####
#.........#
#.........#
#......##.#
#......##.#
D....###..D
#.........#
#.........#
#.........#
#.........#
#####D#####

4
2
#####d#####
#.........#
#..#......#
#.#.......#
#.........#
D.........#
#.........#
#.........#
#.........#
#.........#
#####D#####

3
2
#####D#####
#.........#
#..#......#
#.#.......#
#.........#
D.........#
#.........#
#.......#.#
#......#..#
#.........#
#####d#####

3
0
#####d#####
#.........#
#..p......#
#.........#
#.........#
#.........D
#.........#
#.........#
#.........#
#.........#
#####D#####

6
0
#####D#####
#.#.....#.#
#.........#
#.#.#...#.#
#.........#
#...#.....D
#.........#
#.#.#.#.#.#
#.........#
#k#.....#.#
###########
key : 1

2
0
#####D#####
#.........#
#......#..#
#.......#.#
#.........#
#.........d
#.........#
#.........#
#.........#
#.........#
#####d#####

6
1
#####D#####
#s........#
#.#.#.#.#.#
#.........#
#..#.#.#..#
D.........D
#.#.#.....#
#.........#
#..#.....##
#........e#
#####D#####
enemies 1
switch 0 : 0 1

2
2
###########
#........k#
#.........#
#.........#
#......#..#
D.........#
#.........#
#.......#.#
#......#..#
#.........#
#####D#####
key : 2

2
1
#####d#####
#.........#
#.........#
#.........#
#.........#
d.........D
#.#.......#
#.........#
#.........#
#.........#
#####D#####

6
2
#####D#####
#.#.....#.#
#.........#
#.........#
#..#..#...#
D.........#
#.........#
#.#..#..#e#
#.........#
#.......ee#
###########
enemies 3

5
1
#####l#####
#.........#
#......#.##
#....##..##
#....#.##.#
D....#.#..D
#......##.#
#.........#
#.........#
#.........#
#####D#####
locked : 1

5
0
#####D#####
#.........#
#.#...#.#.#
#.........#
#..#.#.#..#
#.........D
#k#.#.#...#
#.........#
#..#...#.##
#.........#
#####D#####
key : 0

1
0
###########
#.........#
#.........#
#.........#
#.........#
#.........D
#.........#
#.........#
#.........#
#.........#
#####D#####

4
0
#####D#####
#.........#
#.........#
##........#
#?##@###..#
#....##...l
#.###.....#
#.#..##.#.#
#.##..#####
#.........#
#####D#####
sign Strange symbols cover the floor.

5
2
#####D#####
#.........#
#.........#
#.#..#....#
#.........#
D........e#
#.....#...#
#.........#
#.........#
#e#.......#
#####D#####
enemies 2
door 0 : 0 1

0
1
###########
#X##......#
#..##.....#
#..#.#....#
#.........#
#.........#
#.#.#.....#
#..##.....#
#.#.#.....#
#.........#
#####D#####

1
1
#####D#####
#.........#
#.##......#
###..#....#
#..#e#....#
D..#.#....#
#.#.#.....#
#.........#
#.........#
#.........#
#####d#####
boss
enemies 1

