4
3
#####D#####
###.......#
###e#.....#
#e####....#
#.#.......#
D.........D
#.........#
#.........#
#.........#
#e........#
#####d#####
enemies 3

0
1
###########
#.........#
#.#.#.#.#.#
#.........#
#.....#.#.#
D.........D
#.#.#...#.#
#.........#
#.#.#...#.#
#.........#
#####D#####

3
3
###########
#........k#
#.........#
#.........#
#.........#
D.........#
#.........#
#.........#
#.........#
#.........#
#####D#####
key : 5

3
2
#####D#####
#e........#
##..#..#..#
#.........#
#.........#
D.........D
#.........#
#.........#
##.....#..#
#e........#
#####D#####
enemies 2

4
4
###########
#........k#
#.........#
#.........#
#.........#
D.........#
#.........#
#.......#.#
#......#..#
#.........#
###########
key : 4

0
0
###########
#.........#
#......#..#
#.#.....#.#
#.........#
#.........D
#.........#
#.........#
#.........#
#.........#
#####D#####

4
1
#####d#####
#.........#
#.#.#.#...#
#.........#
#..#...#..#
#.........D
#.#.#...#.#
#.........#
#........##
#.........#
###########

2
2
#####d#####
#......#..#
#......#..#
#......##k#
#.........#
D.........#
#.........#
#.........#
#......#..#
#.........#
#####D#####
key : 1

3
0
#####d#####
#.........#
#.........#
#.........#
#....#.#..#
#......#..D
#....##...#
#..#......#
#.........#
#.........#
###########

2
1
#####D#####
#.#.....#.#
#.........#
#.........#
#.....#...#
D.........D
#.........#
#....#..#.#
#.........#
#.........#
#####l#####

5
3
#####d#####
#.........#
#.........#
#.........#
#.........#
#....e....#
#.........#
#.........#
#.........#
#.........#
#####D#####
boss
enemies 1

1
0
#####D#####
#.........#
#.........#
#...#..##.#
#...##....#
#...@#.#..D
#...#.##..#
#...#.#?#.#
#.........#
#.........#
#####D#####
sign The brave are rewarded.

4
2
#####D#####
#?........#
#.........#
#.........#
#......#..#
D.........D
#.........#
#...#..#..#
#.........#
#....e....#
###########
enemies 1
sign Beware what lurks ahead.

1
2
#####D#####
#.........#
##.....#..#
#.........#
#.........#
D...#..#..#
#.........#
#.........#
##..#..#..#
#.........#
#####d#####

2
0
#####D#####
#.........#
#.........#
#.........#
#.........#
#.........D
#.........#
#.........#
##........#
#.........#
#####d#####

6
3
#####D#####
#.........#
#...#.#.#.#
#...#.###.#
#...#...#.#
#....#....#
#.......#.#
#.......#.#
#.........#
#X........#
###########

1
1
#####D#####
#k........#
##..#..#..#
#.........#
#.........#
D...#..#..D
#.........#
#.........#
#...#..#..#
#.........#
#####D#####
key : 0

0
2
###########
#.......ee#
#..#.....e#
#.........#
#.........#
D.........#
#.........#
#.........#
#..#.....##
#.........#
#####D#####
enemies 3

3
1
#####l#####
#.........#
#..#......#
#.#.......#
#.......#.#
D.........D
#.....#...#
#....#....#
#.........#
#.........#
#####d#####
locked : 1

