5
2
#####D#####
#........##
#.........#
#.........#
#.........#
D.........D
#.........#
#.........#
#.........#
#.......#k#
#####d#####
key : 2

5
0
#####D#####
#?##......#
#.#.#.#...#
#.....#...#
#.##..#...#
#..##@....D
#.........#
#.........#
#.........#
#.........#
#####D#####
sign Those who search shall find.

6
0
#####D#####
#.........#
#.........#
#.........#
#.........#
#k........D
#.........#
#.........#
#.........#
#.........#
#####D#####
key : 0

1
1
#####D#####
#.........#
#.........#
#.........#
#.........#
#....e....#
#..#......#
##........#
#.#.#.....#
#.........#
#####d#####
boss
enemies 1

3
1
#####D#####
#.........#
#.........#
#.........#
#.........#
D..#......D
#..##.....#
#.#.......#
#.........#
#.........#
#####d#####

2
1
#####d#####
#.........#
#.........#
#.........#
#.........#
#...##e#..#
#?#####e..#
#..#.###..#
##....##..#
#......#..#
#####D#####
enemies 2
sign The dungeon remembers all who enter.

0
1
###########
#X........#
#.........#
#.........#
#.........#
#.........#
#.........#
#.........#
#.........#
#.........#
#####D#####

6
2
#####d#####
#.........#
#..#...#.##
#.........#
#..#......#
D.........#
#.........#
#.........#
#..#...#..#
#.........#
###########

5
1
#####D#####
#e.#...#e##
#.........#
#.#.#.#.#.#
#.........#
D....#.#..D
#.........#
#.#.#...#.#
#.........#
##.......##
#####D#####
enemies 2

7
1
#####D#####
##.....#..#
#.........#
#.........#
#...#..#..#
l.........#
#.........#
##..#..#..#
#.........#
#.........#
###########
locked : 1

6
1
#####D#####
#.........#
#.........#
#.........#
#.........#
D.........D
#.........#
#.........#
#.........#
#.........#
#####D#####

4
0
#####D#####
##.#...#.##
#.........#
##.#.#.#..#
#.........#
#..#.#....D
#.........#
#....#.#.##
#.........#
##.#...#..#
#####D#####

7
0
#####D#####
#.........#
#.........#
#.#..#....#
#.........#
#.........l
#..#..#...#
#.........#
#.........#
#e#?......#
###########
enemies 1
sign Turn back; you are not yet ready.

4
1
#####d#####
#.........#
##.....#..#
#.........#
#.........#
D.........D
#.........#
#.........#
#...#..#..#
#.........#
#####D#####

3
0
###########
#k........#
##..#..#..#
#.........#
#.........#
#...#..#..D
#.........#
#.........#
##..#..#..#
#.........#
#####D#####
key : 1

4
3
###########
#.........#
#.........#
#.........#
#.........#
d.........#
#.........#
#.........#
#.........#
#.........#
#####D#####

4
2
#####D#####
#.........#
#.....#...#
#....###..#
#..#.#.#..#
D....#....d
#.........#
#.........#
#.........#
#.........#
#####D#####

3
2
###########
#.........#
#......##.#
#...#.#.#.#
#...#.....#
D.........#
#.#.#.....#
#...##....#
#.#.......#
#.........#
#####D#####

5
3
#####D#####
##.....#.##
#.........#
#...#.#.#.#
#.........#
D..#.#.#..#
#.........#
#.#.#.....#
#.........#
##.#.....k#
###########
key : 3

