2
0
#####.#####
#.........#
#.........#
#.........#
#.........#
#....@.....
#.........#
#.........#
#.........#
#?........#
###########
sign Many have walked this path.

1
0
#####.#####
#......#..#
#...#..##.#
#...#.....#
#...#..#..#
#...####...
#.........#
#.........#
#.........#
#.........#
#####.#####

1
2
#####l#####
#.........#
#.........#
#...#..##.#
#....####.#
...#k#.#..d
#...#..##.#
#...#.##..#
#.....#...#
#..#......#
#####.#####
key : 1

3
3
#####.#####
#.........#
#.........#
#.........#
#.........#
l....e.....
#.#.......#
#.........#
#.........#
#.........#
#####.#####
locked : 3
boss
enemies 1

3
2
#####d#####
#.........#
#.#.......#
#.........#
#.........#
...#......l
#.........#
#.........#
#.#.....#.#
#.........#
#####.#####

0
2
###########
#.........#
#.........#
#.........#
#.#.......#
..........#
#.........#
#.........#
#..#......#
#.........#
#####l#####
locked : 2

0
0
###########
#k........#
#......#..#
#.......#.#
#.........#
#.........d
#.........#
#.........#
#.........#
#.........#
#####.#####
key : 0

4
1
#####.#####
#.........#
#.........#
#.........#
#.........#
#..........
#.........#
#.........#
#.........#
#k........#
###########
key : 2

3
1
#####d#####
##.#...#.##
#.........#
#.#.#.#.#.#
#.........#
#..#.#.#...
#.........#
#.#.#.....#
#.........#
##.#...#.##
#####.#####

2
1
#####.#####
#e........#
#.........#
#.........#
#.........#
...........
#.........#
#.........#
#.........#
#.........#
#####d#####
enemies 1

2
3
#####.#####
#.........#
#..#......#
#.#.......#
#.........#
...........
#.........#
#.#.....#.#
#..#...#..#
#.........#
#####.#####

2
2
#####.#####
#.........#
#.........#
#.........#
#.........#
...........
#.........#
#.........#
#.........#
#.........#
#####d#####

0
1
###########
#.........#
#...#.....#
#.........#
#.........#
d..........
#.........#
#.........#
#..#......#
#.........#
#####.#####

1
3
###########
#.#.....#.#
#.........#
#.#.#.#.#.#
#.........#
d...#.#...#
#.........#
#.#.#.#.#.#
#.........#
#.......#.#
#####.#####

4
2
#####.#####
#.........#
#......#..#
#.......#.#
#.........#
...........
#.........#
#.........#
#.........#
#....k....#
###########
key : 3

4
3
#####.#####
#.........#
#.........#
#.........#
#.........#
..........#
#.........#
#.........#
#........e#
#......?ee#
###########
enemies 3
sign This door will not yield without a key.

3
4
#####.#####
#.........#
#.........#
#.......#.#
#.........#
..........#
#.........#
#.........#
#.........#
#........X#
###########

1
1
#####.#####
#..#...#.##
#.........#
#.....#.#.#
#.........#
.....#.#...
#.........#
#.#.#.#...#
#.........#
#..#.....##
#####.#####

2
4
###########
#........e#
##..#..#..#
#.........#
#.........#
.......#..#
#.........#
#.........#
#.........#
#.........#
#####.#####
enemies 1

