3
5
###########
#.........#
#.........#
#.........#
#.........#
d....e....#
#.........#
#.........#
#.........#
#.........#
#####D#####
boss
enemies 1

2
2
#####D#####
#k........#
#.#.#.#.#.#
#.........#
#.#.....#.#
D.........D
#.#...#...#
#.........#
#.#.#.#.#.#
#.........#
#####D#####
key : 1

3
2
#####D#####
#e........#
#.....##..#
#.....#e..#
#....###..#
D.....#e..D
#.....##..#
#.........#
#.........#
#.........#
#####d#####
enemies 3

1
2
###########
#.........#
#.....#..##
#....######
#.....###.#
d....##...#
#....#.#..#
#.........#
#.........#
#........p#
#####D#####

2
4
###########
#.#.....#k#
#.........#
#...#.#.#.#
#.........#
D.........#
#.........#
#...#...#.#
#.........#
#.#.....#.#
#####D#####
key : 3

4
5
#####D#####
#.........#
#.........#
#.........#
#.........#
D.........#
#.........#
#.........#
#.........#
#........X#
###########

3
4
#####D#####
#k........#
#.........#
#.........#
#.........#
D.........d
#.........#
#.........#
#.........#
#.........#
#####D#####
key : 2

1
1
#####d#####
#..#...#..#
#.........#
#.#.#.#.#.#
#.........#
D..#.#.#..d
#.........#
#.#...#.#.#
#.........#
##.#......#
#####D#####

3
1
#####D#####
#.........#
#.........#
#.........#
#.........#
#.........D
#.........#
#.#......##
#..#.....##
#.........#
#####l#####

3
3
#####l#####
#.......#.#
#...#...#.#
#....####.#
#.....#.#.#
D....##...D
#....#.#..#
#....#...##
#........##
#.........#
#####D#####

2
0
#####D#####
#.........#
#.........#
#.........#
#..#......#
#..#.@....D
#?##......#
#p........#
#.....p...#
#.........#
###########
sign Those who search shall find.

2
3
###########
#.........#
#.........#
#.........#
#...#..#..#
D..#.##...D
#.....##..#
#....###..#
#..#......#
#.........#
#####l#####
locked : 2

4
4
#####D#####
#e........#
#.........#
#.........#
#.........#
D.........D
#.........#
#.........#
#.........#
#....e....#
###########
enemies 2

4
3
#####D#####
#.........#
#.........#
#.........#
#.........#
D.........D
#.........#
#.........#
#.........#
#....e....#
###########
enemies 1

4
1
#####l#####
#.........#
#.........#
#..#..#..##
#.........#
#.........D
#..#..#...#
#.........#
#.........#
#........##
###########
locked : 0

0
1
###########
#.........#
#..#......#
#.#.......#
#.........#
#.........#
#.........#
#.....#...#
#.........#
#.........#
#####d#####

4
2
#####d#####
#.........#
#.........#
#.........#
#..#.#....#
D...##....D
#...##....#
#.##.#....#
#.##......#
#.........#
###########

1
0
###########
#k........#
#..#...#..#
#.#.....#.#
#.........#
#.........D
#.........#
#.........#
#.........#
#........##
#####D#####
key : 0

2
1
#####D#####
#.........#
#.........#
#.........#
#.........#
D.........D
#.........#
#.........#
#.........#
#.........#
#####D#####

