4
2
#####d#####
#.........#
#.........#
##........#
#.........#
D.........D
#......#..#
#.........#
#.........#
##........#
###########

2
0
###########
#.........#
#.........#
#...#####.#
#...#..#..#
#....#....D
#.....#.#.#
#....####.#
#.........#
#.........#
#####D#####

5
1
#####D#####
#.........#
#.#.#.#...#
#.........#
#.#.#.#.#.#
#.........#
#.#.#.#.#.#
#.........#
#e#...#.#.#
#e.......e#
###########
enemies 3

3
3
#####D#####
#.........#
#...#..#..#
#.........#
#.........#
D....#....d
#.........#
#.........#
##..#..#..#
#k........#
#####D#####
key : 1

2
3
#####D#####
#........e#
#........##
#.........#
#.........#
D...#.....#
#.#.......#
##e##.....#
#e........#
####......#
#####D#####
enemies 3

1
2
#####D#####
#.........#
#.........#
#.........#
#.........#
#.........l
#.........#
#.........#
#.........#
#.........#
#####d#####

1
3
#####D#####
#.........#
#...#.#...#
#..#.###.##
#...e..#..#
l..#.#....D
#.#.......#
#.........#
#.........#
#.........#
#####D#####
locked : 1
boss
enemies 1

4
0
#####D#####
#.........#
#.#.......#
#.........#
#.........#
#.....#...D
#.........#
#.........#
#.#.....#.#
#.........#
###########

0
2
###########
##.#...#.##
#k........#
##.#.#.#.##
#.........#
#..#...#..D
#.........#
#......#.##
#.........#
#..#...#.##
#####D#####
key : 6

4
1
#####D#####
#e.......e#
#.........#
#.........#
#.........#
D....##...D
#....?#...#
#.........#
#.........#
#e.......s#
#####D#####
enemies 3
switch 0 : 0 1
sign The dungeon remembers all who enter.

3
4
###########
#.........#
#......#..#
#.......#.#
#.......#.#
d.........#
#.........#
#.........#
#.........#
#.........#
###########

4
3
#####D#####
#.........#
#..##.#...#
#..#####..#
#....#.#..#
D.........#
#.........#
#.........#
#.........#
#.........#
###########

3
0
#####D#####
#.........#
#..#......#
#..#.#....#
#..###....#
#....@....d
#.........#
#.........#
#.........#
#.........#
#####D#####

3
1
#####D#####
##.....#.##
#.........#
#.......#.#
#.........#
d....#....D
#.........#
#.#.#.#...#
#.........#
##.#.....##
#####D#####

2
1
###########
#...k.....#
#...#.#.#.#
#.........#
#.#.#.#...#
D.........D
#.#.#.#.#.#
#.........#
#.#.#.#.#.#
#.........#
#####D#####
key : 0

2
2
#####d#####
#k........#
##..#..#..#
#.........#
#.........#
D....#....D
#.........#
#.........#
#...#..#..#
#.........#
#####D#####
key : 2

1
4
###########
#........e#
#.........#
#.........#
#..##.###.#
D.....#...#
#..#..##..#
#....#.#..#
#......#..#
#........?#
###########
enemies 1
door 0 : 0 1
sign Turn back; you are not yet ready.

3
2
#####D#####
#.......#.#
#......#..#
#.......#.#
#.........#
D.........D
#.........#
#.......#.#
#.....##..#
#.........#
#####d#####

0
3
###########
#........X#
#.........#
####......#
#.#.......#
D.........#
#.........#
#.........#
#.........#
#.........#
#####D#####

