1
0
###########
#.........#
#..##.....#
#....#....#
#...##....#
#....@.....
#.........#
#.........#
#.........#
#.........#
#####.#####

0
4
###########
#X........#
#.........#
#.........#
#.........#
#.........#
#.........#
#.........#
#.........#
#.........#
#####.#####

1
1
#####d#####
#.........#
#..#......#
#.#.......#
#.........#
..........#
#.........#
#.......#.#
#......#..#
#.........#
#####d#####

2
1
#####d#####
#.........#
#......#..#
#.......#.#
#.........#
...........
#.........#
#.#.......#
#..#......#
#.........#
#####.#####

0
1
###########
#.........#
#.........#
#.........#
#....##...#
#...##....#
#..#..##..#
#....##...#
#...#.....#
#.........#
#####d#####

4
3
#####.#####
#.........#
#.........#
#...#..##.#
#.#.....#.#
.....#.#..#
#......#..#
#......##.#
#.........#
#........k#
###########
key : 3

4
2
#####.#####
#.........#
#...#.#.#.#
#.........#
#..#.#.#..#
...........
#.#.#.#.#.#
#.........#
#..#...#.##
#..e...?.e#
###########
enemies 2
door 0 : 0
sign A useful tool lies just ahead.

2
2
###########
#.....k#..#
#.........#
#.........#
#.#..#..#.#
...........
#.........#
##.....#..#
#.........#
#.........#
#####.#####
key : 0

4
1
#####.#####
#k........#
##........#
#.........#
#.....#.#.#
#.....##...
#....#.##.#
#....#..###
#........##
#.........#
#####.#####
key : 1

1
4
#####.#####
#.........#
#.........#
#.........#
#.........#
.....e....#
#.........#
#.........#
#.........#
#.........#
#####d#####
boss
enemies 1

5
1
#####.#####
#.........#
#.........#
#.........#
#.........#
#.........#
#.........#
#.#.......#
#..#......#
#.........#
#####d#####

3
2
#####.#####
#.........#
#...#.#...#
#...e##...#
#...#.#...#
...#s......
#..e#.....#
##.##.....#
##.##.....#
##........#
#####.#####
enemies 2
switch 0 : 0

3
3
#####.#####
#e........#
#......#..#
#.........#
#.........#
.....#...e#
#.........#
#.........#
##..#..#..#
#e........#
#####.#####
enemies 3

1
3
###########
##........#
#.........#
#.........#
#.#.......#
#..........
#.........#
##.....#..#
#.........#
#.........#
#####l#####
locked : 1

2
3
#####l#####
#k........#
#..#...#..#
#.#.....#.#
#.........#
...........
#.........#
#.........#
#.........#
#.........#
#####.#####
key : 4

2
4
#####d#####
#.........#
#.........#
#.........#
#.........#
..........#
#.........#
#.........#
#.........#
#.......?e#
###########
enemies 1
sign Those who search shall find.

2
0
#####.#####
#.........#
#......#..#
#.#.#...#.#
#.........#
#..........
#.........#
#.........#
#.........#
#.........#
###########

6
1
#####d#####
#.........#
#..##.##..#
#....####.#
#..#......#
#..#####..#
#...####..#
#...##.#.##
#......#..#
#......##.#
###########

3
1
#####.#####
#.........#
#.........#
#.........#
#.........#
#..........
#.........#
#.........#
#.........#
#.........#
#####.#####

