2
3
###########
#.........#
#.........#
#.........#
#.........#
d.........#
#.........#
#.........#
##........#
#.........#
#####.#####

2
1
#####.#####
#.........#
#.........#
#.........#
#.........#
l.........d
#.........#
#.........#
#.........#
#.........#
#####.#####
locked : 1

3
0
#####.#####
#.........#
#..#......#
#.#.......#
#....#....#
#..........
#.........#
#.#.....#.#
#..#....#.#
#.........#
###########

3
3
#####.#####
#.........#
#.........#
#.........#
#...##....#
..........l
#.#.##....#
###.......#
#k###.....#
#.........#
#####.#####
key : 4

3
4
###########
#..#......#
#.#.......#
#.###.#...#
#.###.....#
l...##....#
#.#.#.....#
#..###....#
#.........#
#.........#
#####.#####
locked : 4

5
5
#####.#####
#.........#
#.........#
#.........#
#.........#
#.........#
#.........#
#.........#
#.........#
#X........#
###########

5
3
#####d#####
#.........#
#......#..#
#.......#.#
#.........#
#.........#
#.........#
#.......#.#
#......#..#
#.........#
###########

1
1
#####.#####
#k........#
#.........#
#.....#...#
#.........#
...........
#...#..#..#
#.........#
#.........#
#..#......#
#####.#####
key : 0

0
0
###########
#e.e......#
#?.#...#.##
#.........#
#e#.#.#.#.#
#..........
#..#...#..#
#.........#
#...#.#.#.#
#.........#
#####.#####
enemies 3
sign The brave are rewarded.

1
2
###########
#........e#
#.........#
#.#..#....#
#.........#
..........#
#..#......#
#.........#
#.........#
#.......#.#
#####.#####
enemies 1

2
0
#####.#####
#.........#
#.........#
#.........#
#.........#
#k........l
#.........#
#.........#
#.........#
#.........#
#####.#####
key : 1

1
0
#####.#####
#.........#
#.........#
#.........#
#.........#
#....@.....
#.........#
#.........#
#.........#
#.........#
#####.#####

3
1
#####.#####
#.........#
#.........#
#.........#
#.........#
...........
#.........#
#.......#.#
#......#..#
#.........#
###########

2
2
#####.#####
#.........#
#.........#
#.........#
#.........#
d.........d
#.........#
#........##
#.........#
#.........#
#####.#####

0
1
###########
#.......k##
#.........#
#.........#
#...#..#..#
..........#
#.........#
#..#..#..##
#.........#
#.........#
#####.#####
key : 3

4
3
#####.#####
#.........#
#.........#
#.........#
#.........#
#..........
#.........#
#.........#
#.........#
#.........#
#####d#####

3
2
#####.#####
#.........#
#..#......#
#.#.......#
#.........#
...........
#.........#
#.........#
#.........#
#.........#
###########

4
4
#####.#####
#.........#
#.....##..#
#....####.#
#...#####.#
....#.....d
#..####.#.#
#....#.##.#
#.........#
#.........#
###########

4
5
###########
#..#...##.#
#...#...#.#
#...#.###.#
#...#.#...#
d....e....#
#.........#
#.........#
#.........#
#.........#
#####.#####
boss
enemies 1

