4
0
#####l#####
#.#.....#.#
#.........#
#.........#
#.........#
#.........d
#.........#
#....#..#.#
#.........#
#.........#
#####D#####
locked : 1

4
1
#####D#####
#.........#
#.........#
#.........#
#.........#
d.........d
#.........#
#.#.....#.#
#..#...#..#
#.........#
###########

1
1
###########
#k........#
##.#...#.##
#.........#
#.#.#...#.#
D.........D
#....#.#..#
#.........#
#.#.#.#...#
#.........#
#####D#####
key : 2

0
0
###########
#.........#
#.........#
#.....##..#
#.....#...#
#.....#...#
#.........#
#.........#
#..#......#
#.........#
#####D#####

2
0
#####D#####
#.#.....#.#
#.........#
#.........#
#.....#...#
#.........D
#.........#
#....#..#.#
#.........#
#.........#
#####D#####

3
3
#####D#####
#e.......e#
##.....#.##
#.........#
#.#.#.#.#.#
D.........D
#..#...#..#
#.........#
#.#.#.....#
#...e.....#
###########
enemies 3
door 0 : 0

1
2
###########
##.#...#.##
#.........#
#.#.#.#.#.#
#.........#
D..#.#.#..#
#.........#
#.#...#.#.#
#.........#
##.#...#..#
#####l#####
locked : 4

3
0
#####D#####
###.......#
##........#
#..#......#
#.........#
#.........D
#.........#
#.........#
#.........#
#.........#
#####l#####

2
4
#####D#####
#.........#
#.......###
#....#..###
#.p...#.#.#
D....e.#..#
#....#..#.#
#.........#
#.........#
#.........#
#####l#####
locked : 10
boss
enemies 1

1
4
###########
#X........#
#.........#
#.........#
#.........#
#..#......#
#.#.......#
##........#
#.........#
#.........#
#####D#####

2
2
#####l#####
#.........#
#.........#
#.........#
#.###.....#
d..#......d
#.#.......#
#...#.....#
###.......#
#.........#
#####D#####

3
2
#####D#####
#.........#
#..#...#..#
#.#.....#.#
#.........#
D.........D
#.........#
#.........#
#.........#
#.........#
#####D#####

5
0
#####D#####
#.........#
#..#...#..#
#.#.....#.#
#.#.......#
#.........#
#.........#
#.........#
#.........#
#k........#
###########
key : 4

4
2
#####D#####
#..#.....##
#.........#
#...#...#.#
#.........#
d..#.#....#
#.........#
#.#.#.#.#.#
#.........#
##.....#.##
###########

2
1
#####D#####
#k........#
#......#..#
#.......#.#
#.........#
D.........d
#.........#
#.#.......#
#..#......#
#.........#
#####D#####
key : 1

1
0
#####D#####
#.##......#
#.........#
#..#......#
#.........#
#...#@....D
#.........#
#.####....#
#.........#
#.........#
#####D#####

3
4
#####l#####
#.........#
#.........#
#.........#
#.........#
D..#..#...#
#.........#
#.........#
#........##
#........k#
###########
key : 10

2
3
###########
#.........#
#.........#
#.#.......#
#.#..####.#
d....##...D
#....#..#.#
#.......###
#.....##..#
#.........#
#####D#####

3
1
#####D#####
#e##?.....#
#.###.....#
#.##e#....#
#.##..#...#
D...#.#...D
#.........#
#.........#
#.........#
#s........#
#####D#####
enemies 2
switch 0 : 0
sign Those who search shall find.

