4
1
#####d#####
#k........#
#.........#
#.........#
#.........#
D.........l
#.........#
#.........#
#.......#.#
#.........#
#####D#####
key : 0

3
0
#####D#####
#.........#
#.........#
###.......#
#.........#
#....@....D
#.........#
#.........#
#.........#
#.........#
#####D#####

3
1
#####D#####
#.........#
#.........#
#....#..#.#
#.........#
D.........D
#..#..#...#
#.........#
#.........#
#.......#.#
#####d#####

6
3
#####D#####
#.........#
#.........#
#.........#
#....####.#
#....#....#
#.........#
#....#.#.##
#.......#X#
#.........#
###########

4
2
#####D#####
#..#......#
#......#..#
#......##.#
#.........#
l.........D
#...#.....#
#.#.......#
#..#......#
#.........#
###########
locked : 1

1
2
###########
#.........#
#......#.##
#.......#.#
#.........#
l.........#
#.........#
#.#.......#
#..#......#
#.........#
#####D#####
locked : 3

2
2
#####D#####
#.........#
#.........#
#.........#
#.........#
D.........#
#.........#
#.........#
#.........#
#.........#
#####D#####

3
2
#####D#####
#k........#
#.........#
#.........#
#.........#
D.........D
#.........#
#.........#
#.........#
#.........#
#####D#####
key : 3

0
0
###########
#.........#
#.........#
#......#..#
#.........#
#.........D
#......#..#
#....###..#
#.....##..#
#.........#
#####d#####

5
3
#####l#####
#.........#
#.#.......#
#.##......#
#.###.....#
#....e....#
#.........#
#.........#
#.........#
#.........#
#####D#####
locked : 4
boss
enemies 1

2
0
#####D#####
#.........#
#.........#
#..#......#
#.##......#
#...##....D
#...##....#
#..#..#...#
#.........#
#.........#
#####D#####

3
3
###########
#.........#
#.........#
#.........#
#.........#
D.........#
#.........#
#.#.....#.#
#..#...#..#
#.........#
#####d#####

5
1
#####D#####
#..#.....##
#.........#
#.#.#.#.#.#
#.........#
#..#...#..#
#.........#
#.......#.#
#.........#
##.#...#.##
###########

4
0
#####D#####
#.........#
#.........#
#.........#
#.........#
#.....#...D
#...#.#...#
##...##...#
##e#......#
#e.?......#
###########
enemies 2
sign The brave are rewarded.

2
1
#####D#####
#.........#
#.........#
#.........#
#....###..#
D....##...D
#...#.##..#
#.........#
#...#.....#
#.........#
#####D#####

1
0
#####d#####
#.........#
#.#...#.#.#
#.........#
#k#.#.#...#
#.........d
#...#.#.#.#
#.........#
#...#.#...#
#.........#
#####D#####
key : 1

0
1
###########
#........k#
#..#...#..#
#.#.....#.#
#.........#
D.........#
#.........#
#.........#
#.........#
#.........#
#####D#####
key : 4

1
1
#####D#####
#.........#
#.........#
#....##...#
#.#.###...#
d.....#p..l
#..####p..#
#...##....#
#.........#
#.........#
#####D#####

4
3
#####d#####
#.........#
#...#.#.#.#
#.........#
#.#.#.#.#.#
D.........#
#.#.#.#...#
#.........#
#.#.#.#.#.#
#.........#
#####l#####

