3
3
#####.#####
#.........#
#.........#
#.........#
#.........#
d..........
#.........#
#.........#
#.........#
#.........#
#####.#####

0
2
###########
#.........#
#......#..#
#.......#.#
#.........#
#.........#
#.........#
#.......#.#
#......#..#
#.........#
#####d#####

0
0
###########
#e........#
#.........#
#.........#
#.........#
#.........#
#.........#
#.........#
#.........#
#.........#
#####.#####
enemies 1
door 0 : 0

3
4
###########
#.......se#
#.........#
#.........#
#.........#
..........#
#.........#
#.........#
#.........#
#........e#
###########
enemies 2
switch 1 : 1 2

3
1
#####.#####
#.........#
#.........#
#.........#
#.........#
#k.........
#.........#
#.........#
#.........#
#.........#
#####d#####
key : 1

2
1
#####.#####
#..#...#..#
#..#...#..#
#..##.#...#
#....###..#
#..........
#....##...#
#.........#
#.........#
#.........#
#####.#####

3
2
#####.#####
#s.......?#
#.........#
#.#..#..#.#
#.........#
..........d
#.#..#..#.#
#.........#
#.........#
#e#.....#e#
#####.#####
enemies 2
switch 0 : 0
sign Those who search shall find.

2
3
#####.#####
#k#.......#
#......#..#
#.......#.#
#.........#
..........#
#...#.....#
#.........#
#.........#
#........##
#####.#####
key : 2

4
3
#####.#####
#.........#
#.........#
#.........#
#.........#
..........#
#.........#
#.........#
#.........#
#.......?e#
###########
enemies 1
door 1 : 1 2
sign Beware what lurks ahead.

2
5
#####.#####
#.........#
#.........#
#.........#
#.........#
#.........#
#.........#
#.........#
#.........#
#X........#
###########

1
2
#####d#####
#k........#
#......#..#
#.......#.#
#.........#
..........l
#.........#
#.........#
#.........#
#.........#
#####.#####
key : 0

1
3
###########
#.........#
#.........#
#.........#
#.........#
l..........
#.........#
#.#.....#.#
#..#...#..#
#.........#
#####.#####
locked : 1

2
2
#####.#####
#.........#
#..#...#..#
#.#.....#.#
#.........#
...........
#.........#
#.....#.#.#
#..#...#..#
#.........#
#####.#####

1
4
###########
#.........#
#......#..#
#.......#.#
#.........#
.......#..d
#..#.#....#
#.#k......#
#..#......#
#.........#
###########
key : 3

1
1
###########
#.........#
#..#......#
#.#.......#
#.........#
...........
#.........#
#.#.......#
#..#......#
#.........#
#####.#####

1
0
#####.#####
#.........#
#.........#
#....#....#
#....#....#
#....@.....
#.........#
#.........#
#.....###.#
#?........#
###########
sign The dungeon remembers all who enter.

4
2
#####.#####
#.........#
#.........#
#.........#
#.........#
...........
#.........#
#.#.......#
#..#......#
#.........#
###########

4
1
#####d#####
#.........#
#.........#
#.........#
#.........#
#..........
#.........#
#.........#
#.........#
#.........#
###########

1
5
###########
#......####
#........##
#.......#.#
#....#....#
d....e#...#
#.........#
#...#.....#
#.###.....#
#.........#
#####.#####
boss
enemies 1

