3
2
#####.#####
#.........#
#.........#
#.........#
#.........#
..........#
#.........#
#.........#
#.........#
#........k#
###########
key : 2

2
1
#####.#####
#?........#
#.#.#.#...#
#.........#
#....#.#..#
..........d
#.#...#.#.#
#.........#
#..#...#.##
#........e#
#####.#####
enemies 1
sign The brave are rewarded.

0
1
###########
#........##
#.........#
#.........#
#..#......#
#.........#
#.........#
#..#..#...#
#.........#
#.........#
#####l#####
locked : 0

2
3
#####.#####
#.........#
#.#.#.#.#.#
#.........#
#..#...#..#
d..........
#.#.#.....#
#.........#
#..#...#.##
#.........#
###########

2
4
#####d#####
#.........#
#.....##.##
#.....#.#.#
#...e.#...#
.....#....#
#......#..#
#.........#
#.........#
#.#.......#
#####.#####
boss
enemies 1

3
4
#####.#####
#.........#
#.........#
#.........#
#.........#
#.........#
#.........#
#.........#
#.........#
#X........#
###########

1
5
###########
#.........#
##.....#..#
#.........#
#.........#
.....#....#
#.........#
#.........#
#...#.....#
#.........#
###########

2
2
#####.#####
#.........#
#..#......#
#.#.......#
#.........#
d.........d
#.........#
#.........#
#.........#
#.........#
#####.#####

1
1
#####l#####
#.........#
#.........#
#.........#
#.........#
...........
#.........#
#.........#
#.........#
#.........#
#####.#####

0
4
###########
#........e#
#..##.....#
#.........#
#.........#
..........#
#.........#
#.........#
#.........#
#.........#
#####.#####
enemies 1
door 0 : 0

3
1
#####.#####
#.........#
#.........#
#.#..#..#.#
#.........#
...........
#.....#...#
#.........#
#.........#
#.......#k#
###########
key : 0

4
0
#####.#####
#.........#
#.#.#.#.#.#
#.........#
#..#.#.#..#
#.........#
#.#.#.#.#.#
#.........#
#..#...#.##
#.........#
###########

2
0
#####d#####
#.........#
#..#.....##
#.#.......#
#.....#...#
#..........
#.........#
#.........#
#.........#
#.........#
#####.#####

1
3
#####.#####
#k........#
#.........#
#.........#
#.......#.#
...........
#.........#
#.#.....#.#
#..#...#..#
#.........#
#####.#####
key : 3

0
3
###########
#.k#......#
#.###.....#
#.#.#.....#
#...#.....#
#..........
#.........#
#.........#
#.........#
#.........#
#####.#####
key : 4

3
0
#####.#####
#........##
#......####
#....#?####
#....##.#.#
#...#@#....
#.........#
#.........#
#......#..#
#.........#
#####.#####
sign Those who search shall find.

1
4
#####.#####
#e........#
#..##.#...#
#.##......#
#..#..#...#
...#.......
#.#.......#
#.........#
#.........#
#s........#
#####d#####
enemies 1
switch 0 : 0

1
0
###########
##........#
#.........#
#.........#
#.#.....#.#
#..........
#.........#
#...#..#..#
#.........#
#.........#
#####d#####

1
2
###########
#.........#
#.........#
#.#...#...#
#...####..#
....###....
#...##....#
#.........#
#.........#
#.........#
#####.#####

