8
2
#####D#####
#.........#
#.##..#...#
#....##...#
#.####....#
#.....#...#
#....#....#
#.........#
#.........#
#X........#
###########

2
2
###########
#........e#
#.........#
#.........#
#.........#
D....##...#
#...#.##..#
###.#..##.#
#..#....#.#
#.........#
#####D#####
enemies 1

7
2
#####d#####
#p........#
#.........#
#.........#
#.........#
#....e##..#
#.....##..#
#.....###.#
#.........#
#.........#
#####D#####
boss
enemies 1

3
3
###########
#..#......#
#.........#
#.........#
#..#......#
d.........#
#.........#
#..#..#..##
#.........#
#.........#
#####D#####

6
3
###########
#.......#.#
#...#.....#
#...#####.#
#.....###.#
d....###..#
#....###..#
#.....##..#
#.....#...#
#.........#
###########

4
3
#####D#####
#.#.....#.#
#.........#
#..#.#.#..#
#.........#
D...#.....#
#.........#
#....#.#..#
#.........#
#.#.....#k#
###########
key : 4

5
2
#####l#####
#..#......#
#.........#
#.........#
#...##.#..#
#..#####..#
#...####..#
#..##.###.#
#..##.###.#
#......##.#
#####D#####
locked : 2

3
1
#####D#####
#k........#
#.........#
#.........#
#.........#
D.........D
#.........#
#.#.......#
#..#......#
#.........#
#####D#####
key : 0

1
1
#####D#####
#.........#
#.........#
#.........#
#.........#
D........k#
#.........#
#.........#
#.........#
#.........#
#####D#####
key : 1

6
2
#####D#####
#.........#
#..#...#..#
#.#.....#.#
#.........#
#.........d
#.........#
#.........#
#.........#
#.........#
#####d#####

3
0
#####D#####
#.#.....#.#
#.........#
#...#.....#
#.........#
#.....#...D
#.........#
#...#.#.#.#
#.........#
#.#.....#.#
###########

0
0
###########
#e........#
#.........#
#.........#
#.........#
#.........d
#.........#
#.........#
#.........#
#.........#
#####D#####
enemies 1

4
2
#####D#####
#e........#
#.........#
#.........#
#.........#
D.........D
#.........#
#.........#
#.........#
#.........#
#####l#####
enemies 1

3
2
#####D#####
#k.#......#
#.........#
#.........#
#.........#
D.........d
#.#.......#
#.......#.#
#......#..#
#.........#
#####D#####
key : 2

1
0
#####D#####
#.........#
#..#......#
#.#.......#
#.........#
#.........D
#.........#
#.........#
#.........#
#.........#
#####D#####

0
1
###########
#.........#
#.........#
#.........#
#.........#
d.........#
#.........#
#.........#
#.........#
#.........#
#####D#####

4
1
#####D#####
#..#.....##
#.........#
#.........#
#...#..#..#
#.........D
#.........#
#.....#...#
#.........#
#.........#
###########

2
1
#####D#####
#.......#e#
#.........#
#..#...#..#
#.........#
D.........D
#.........#
#..#.....##
#.........#
#e#.....#e#
#####D#####
enemies 3

2
0
#####D#####
#.........#
#.........#
#.........#
#.........#
#....@....D
#.###.....#
#.?##.....#
#.#.......#
#.........#
#####D#####
sign The dungeon remembers all who enter.

