0
2
###########
#X........#
#.........#
#.........#
#.........#
#.........#
#.........#
#.........#
#.........#
#.........#
#####D#####

4
4
#####D#####
#.........#
#..#...#..#
#.#.....#.#
#.........#
l.........#
#.........#
#.#.......#
#..#......#
#.........#
###########
locked : 3

3
2
#####l#####
##.#...#.##
#.........#
#.#.#.#.#.#
#.........#
D..#.#....D
#.........#
#.#.#.#.#.#
#.........#
##.....#.##
#####D#####

2
3
###########
#.........#
#..#......#
#.#.......#
#.........#
D.........#
#.........#
#.#.....#.#
#..#...#..#
#.........#
#####D#####

3
4
###########
#.........#
#..#...#..#
#.#.....#.#
#.........#
d.........#
#.........#
#.........#
#.........#
#.........#
#####D#####

4
1
#####D#####
#..#......#
#.##..#...#
#..###....#
#...#.#...#
D.........d
#.........#
#.........#
#.........#
#.........#
#####D#####

4
3
#####D#####
#.........#
#..#..#..##
#.........#
#.........#
D...#.....l
#.........#
#.........#
#..#..#..##
#.........#
#####d#####

1
2
#####D#####
#.........#
#.........#
#.........#
#.........#
#....e....#
#.##......#
###.......#
####......#
#.........#
#####d#####
boss
enemies 1

5
1
#####D#####
#..#......#
#.........#
#.........#
#.........#
D.........D
#.........#
#.........#
#.........#
##......#k#
#####D#####
key : 1

5
2
#####D#####
#.........#
#...#.#...#
#.........#
#.#.#.#...#
D.........D
#.#.....#.#
#.........#
#.#.#...#.#
#.e.e.....#
###########
enemies 2

6
1
#####D#####
#.........#
#......#..#
#.......#.#
#.........#
D.........#
#.........#
#.......#.#
#......#..#
#........k#
###########
key : 3

5
3
#####d#####
#.........#
#.........#
#.........#
#.........#
D.........#
#.........#
#.........#
#.........#
#.........#
###########

4
0
###########
#?........#
#.........#
#.#..#....#
#.##.#....#
#..##@....D
#.#..#....#
#.##.#....#
#.........#
#.........#
#####D#####
sign The dungeon remembers all who enter.

6
0
#####D#####
#.........#
#..#...#..#
#...#...#.#
#.........#
#.........D
#.........#
#.#.....#.#
#..#...#..#
#.........#
###########

3
3
#####D#####
##k#...#.##
#.........#
#..#.....##
#.........#
D..#.#.#..d
#.........#
#..#.#.#.##
#.........#
##.#...#.##
#####D#####
key : 4

2
2
#####d#####
#..#......#
#.........#
#........##
#.........#
#.........D
#.........#
#.........#
#.........#
#.........#
#####l#####
locked : 4

3
1
###########
#k........#
#.........#
#.........#
#.........#
#.........D
#.........#
#.........#
#.........#
#.........#
#####D#####
key : 2

5
0
#####D#####
#......#..#
#...#.##..#
#..#.###..#
#..#.##...#
#..#.#.#..D
#..#.#.#..#
#.........#
#.........#
#.........#
#####D#####

4
2
#####D#####
#.........#
#.........#
#.........#
#.........#
d.........D
#.........#
#.........#
#.........#
#.......#.#
#####D#####

