2
1
#####l#####
#.........#
#..#......#
#.#.......#
#.........#
D.........d
#.........#
#.......#.#
#......#..#
#.........#
#####D#####

1
2
###########
#.........#
##.#.....##
#.........#
#.#.#.#.#.#
d.........D
#..#.#.#..#
#.........#
#.#...#.#.#
#.........#
#####D#####

3
3
#####D#####
#.........#
#.........#
#.........#
#.........#
D.........D
#.........#
#.#.....#.#
#..#...#..#
#..k......#
###########
key : 3

3
0
#####D#####
#.........#
#.........#
#.##......#
#....#....#
#...#@....D
#?####....#
###.##....#
#.........#
#.........#
###########
sign Those who search shall find.

3
4
#####d#####
#.........#
#.........#
#.........#
#...##....#
D..#e#....#
#.##......#
#...##....#
##..#.....#
#.........#
#####D#####
boss
enemies 1

3
2
#####D#####
#.........#
#......#..#
#.......#.#
#.........#
l.........D
#.........#
#.#.....#.#
#..#...#..#
#.........#
#####d#####
locked : 0

1
1
#####D#####
#.........#
#..#...#..#
#.#.....#.#
#.........#
D.........d
#.........#
#.......#.#
#......#..#
#.........#
#####l#####
locked : 1

2
0
#####D#####
#.........#
#.........#
#.........#
#.........#
#.........D
#.........#
#.........#
#.........#
#.........#
#####D#####

2
3
#####D#####
#.........#
#.#...##..#
#....##k#.#
#....##.#.#
D.........l
#.....#.#.#
#.........#
#.......#.#
#.........#
#####D#####
key : 2

2
2
#####D#####
#.........#
##.#...#.##
#.........#
#.#...#.#.#
d.........D
#..#.#.#..#
#.........#
#.#...#.#.#
#.........#
#####D#####

0
1
###########
##.....#..#
#.........#
#.........#
#......#..#
D.........#
#.........#
##..#..#..#
#.........#
#.........#
#####D#####

4
4
#####D#####
#.........#
#.........#
#.........#
#.........#
#.........#
#.........#
#.........#
#.........#
#X........#
###########

4
2
#####d#####
#.........#
#.........#
#.........#
#.........#
D.........#
#.........#
#.........#
#.........#
#.........#
###########

1
3
###########
#.......ee#
#.........#
##..#.....#
#.........#
D.........#
#.#.....#.#
#.........#
#.........#
##.....#..#
#####D#####
enemies 2

3
1
#####D#####
##.....#..#
#.........#
#.........#
#....#..#.#
D.........l
#.........#
##..#.....#
#.........#
#k........#
#####D#####
key : 0

1
0
#####D#####
#.........#
#.........#
#.........#
#.........#
#.........D
#.........#
#.........#
#.........#
#.........#
#####D#####

4
1
#####D#####
#.........#
#..#...#..#
#.#.....#.#
#...#.....#
#.....#...D
#.........#
#.#.......#
#..#......#
#k........#
###########
key : 1

2
4
###########
#.........#
##.....#..#
#.........#
#.........#
l....#....#
#.........#
#.........#
##.....#..#
#.........#
#####d#####
locked : 3

0
0
###########
#.........#
#.........#
#.........#
#.........#
#.........D
#.........#
#.........#
#.........#
#.........#
#####D#####

