3
1
#####.#####
#.........#
#.........#
#.........#
#.........#
...........
#.........#
#.......#.#
#......#..#
#.........#
#####.#####

2
0
#####l#####
#.........#
#..#...#..#
#.#.....#.#
#.........#
#..........
#....#....#
#.........#
#.........#
#.........#
#####d#####

3
2
#####.#####
#.........#
#.........#
##.#......#
#..#k#....#
...##.....#
#..##.....#
####......#
#.........#
#.........#
#####.#####
key : 0

4
1
#####.#####
#.........#
#..#..#...#
#.........#
#.........#
...........
#.........#
#.........#
#.....#..##
#.........#
#####.#####

1
0
#####.#####
#.........#
#.........#
#........##
#.........#
#..........
#.#.......#
#.#.....#.#
#..#...#..#
#.........#
#####l#####
locked : 0

5
1
#####.#####
#......#.##
#.........#
#.#.#.#...#
#.........#
...#.#.#...
#.........#
#.#.#...#.#
#.........#
##e#.....##
#####d#####
enemies 1

1
1
#####.#####
#.........#
#......#..#
#.......#.#
#.........#
...........
#.........#
#.#.......#
#..#......#
#.........#
#####d#####

3
0
#####d#####
#.........#
#.........#
#...#.#.#.#
#...#.#.#.#
#....@.....
#...#.....#
#...##.##.#
#.........#
#.........#
#####.#####

1
2
###########
#.......#k#
#.........#
#.........#
#....#....#
..........#
#.........#
#.#..#..#.#
#.........#
#.........#
#####.#####
key : 5

2
2
#####.#####
#........k#
#.....#..##
#.........#
#.........#
....#.....#
#.........#
#.........#
#..#..#..##
#.........#
#####.#####
key : 2

7
1
#####.#####
#.........#
#.........#
#.........#
#.........#
#.........#
#.........#
#.........#
#.........#
#X........#
###########

0
0
###########
#e#e......#
#e?.......#
#s.#.#.#.##
#.........#
#...#......
#.........#
#....#.#.##
#.........#
#.........#
#####.#####
enemies 3
switch 0 : 0
sign A locked path — look elsewhere first.

6
1
#####d#####
#.........#
##........#
#.........#
#.........#
#....e....#
#.........#
#.........#
#..#......#
#.........#
#####.#####
boss
enemies 1

0
1
###########
#.......ee#
#.....###e#
#......##.#
#......##.#
..........#
#.........#
#.........#
#.........#
#.........#
#####.#####
enemies 3

5
0
#####d#####
#.........#
#.........#
#.........#
#.........#
#..........
#.........#
#.........#
#...#.....#
#.........#
###########

2
1
#####d#####
#k#.....#.#
#.........#
#.........#
#..#......#
...........
#.........#
#.#..#....#
#.........#
#.........#
#####.#####
key : 1

4
2
#####.#####
#.........#
#.........#
#....#....#
#......##.#
.......#..#
#......##.#
#.........#
#.........#
#.........#
#####.#####

4
0
#####.#####
#.........#
#.........#
#.........#
#.........#
#..........
#.........#
#.#.......#
#..#......#
#.........#
#####d#####

5
2
#####.#####
#.........#
#.#.#.....#
#..#......#
#.#.......#
....##....#
#..##.....#
#..##.....#
#........?#
#.......ee#
###########
enemies 2
door 0 : 0
sign Beware what lurks ahead.

