3
2
#####.#####
#.........#
#.........#
#.........#
#.....#.#.#
....###...#
#.....#...#
#...###.#.#
#......#..#
#.........#
#####.#####

6
3
#####.#####
#.........#
#.....##..#
#....#....#
#..#..##..#
...##.....#
#.........#
#.........#
#.........#
#........X#
###########

4
2
#####.#####
#.........#
#......#..#
#.......#k#
#.........#
..........#
#.........#
#.........#
#.........#
#.........#
#####.#####
key : 3

5
1
#####.#####
#.........#
#......#..#
#.......#.#
#.........#
..........l
#...#.....#
#.#.....#.#
#..#...#..#
#..k......#
###########
key : 1

4
1
#####.#####
#.........#
#.........#
#.........#
#.........#
d..........
#.........#
#.........#
#.........#
#.........#
#####.#####

2
2
#####.#####
#........##
#.........#
#.........#
#..#......#
..........#
#........k#
#..#..#..##
#.........#
#.........#
#####.#####
key : 0

5
2
#####.#####
#.........#
#.#.#.#.#.#
#.........#
#.#.#.#...#
l.........d
#.#.#.#...#
#.........#
#.#.#.#.#.#
#.........#
#####.#####
locked : 1

2
0
###########
#.........#
#......#..#
#.........#
#...#.....#
#..........
#.........#
#.#.......#
#..#......#
#.........#
#####.#####

1
2
#####d#####
#.........#
#.....#...#
#..#.#....#
#....###..#
#..#.###..d
#......#..#
#...#....##
#.........#
#.........#
#####.#####

6
0
#####.#####
#.........#
#.........#
#.........#
#.........#
#.........#
#...#.....#
#.......#.#
#.........#
#k........#
###########
key : 2

5
0
#####.#####
#.........#
#..#..#...#
#.........#
#.........#
#..#.......
#.........#
#.........#
#..#..#..##
#.........#
#####.#####

3
1
#####.#####
#.........#
#.........#
#.........#
#.........#
...........
#.........#
#.........#
#.........#
#.........#
#####.#####

1
3
###########
#.........#
#..#......#
#.#.......#
#.........#
d.........#
#.........#
#.........#
#.........#
#.........#
###########

0
2
###########
#.........#
#.........#
#.........#
#..##.....#
#...#.....#
#.........#
#.........#
#.........#
#.........#
#####d#####

3
0
#####.#####
#.........#
#.........#
#.........#
#.........#
#?...@.....
#.........#
#.........#
#.........#
#.........#
#####.#####
sign The dungeon remembers all who enter.

5
3
###########
#.........#
#.........#
#.........#
#..#......#
d..##e....#
#.#.......#
#..##.....#
#.........#
#.........#
#####.#####
boss
enemies 1

2
1
###########
#e...e....#
#.........#
#.........#
#.....##..#
.......#...
#.........#
#.........#
#.........#
#?........#
#####.#####
enemies 2
sign What you seek is close.

4
0
#####.#####
#.........#
#.#.#.##..#
#.e#####..#
#?#######.#
#....##...d
#.........#
#.........#
#.........#
#.........#
#####.#####
enemies 1
sign Beware what lurks ahead.

6
2
#####.#####
#.........#
#.#.#...#.#
#.........#
#....#.#..#
#..........
#.#.....#.#
#.........#
#..#...#.##
#e........#
###########
enemies 1

