1
2
#####d#####
#.........#
#.#.#.#.#.#
#.........#
#......#..#
l.........D
#.....#...#
#.........#
#..#...#.##
#.........#
#####D#####
locked : 0

0
2
###########
#.........#
#.........#
#.........#
#.........#
#.........#
#.........#
#.........#
#.........#
#.........#
#####d#####

6
3
#####d#####
#.........#
#......####
#....#.####
#...e.###.#
#...###...#
#..##.#...#
#...#..#..#
#..#..##..#
#.........#
#####D#####
boss
enemies 1

3
3
#####D#####
#.........#
#..#...#..#
#.#.....#k#
#.........#
D.........#
#.........#
#.........#
#.........#
#.........#
#####D#####
key : 3

1
1
###########
#.........#
#.........#
#.........#
#.........#
D..#......l
#.#k......#
#..#......#
#.........#
#.........#
#####D#####
key : 1

5
2
#####D#####
#.........#
#...#.....#
#...##....#
#.........#
#.........D
#.........#
#.........#
#.........#
#.........#
###########

2
2
#####D#####
#.........#
#.........#
#.........#
#.........#
D.........D
#.........#
#.........#
#.........#
#.........#
#####D#####

4
3
#####D#####
#.........#
#.........#
#....####.#
#.....#e#.#
D...#...e.#
#...e#..#.#
#...#.#...#
#.........#
#.........#
#####D#####
enemies 3

5
4
###########
#.........#
#.........#
#.........#
#.#..#..#.#
d.........#
#.........#
#....#..#.#
#.........#
#.........#
###########

2
1
#####D#####
#k........#
#..#......#
#.#.......#
#.........#
D.........D
#.........#
#.......#.#
#......#..#
#.........#
#####D#####
key : 0

1
3
###########
#.........#
#.........#
#.........#
#.........#
D.........#
#.........#
#.#.......#
#..#......#
#.........#
#####D#####

3
1
#####D#####
#.#.......#
#...#.....#
###.#.....#
#...#.....#
#...#.....D
#.........#
#.........#
#.........#
#.........#
###########

2
0
#####D#####
#.........#
#.........#
#.........#
#.........#
#....@....D
#.........#
#.........#
#.........#
#.........#
###########

5
3
#####D#####
#k........#
#.........#
#.........#
#.........#
D.........d
#.........#
#.......#.#
#......#..#
#.........#
#####d#####
key : 9

3
2
#####D#####
#.........#
#.........#
#.........#
#.........#
D.........D
#.........#
#.#.......#
#..#......#
#.........#
#####d#####

4
2
#####d#####
#.........#
#.........#
#.........#
#.........#
#.........D
#.........#
#.......#.#
#......#..#
##........#
#####D#####

2
3
#####D#####
#?........#
#.........#
#.........#
#.........#
D........e#
#.........#
#.........#
#.........#
#.........#
#####D#####
enemies 1
sign The brave are rewarded.

7
3
#####D#####
#.........#
#...#.##..#
#...####..#
#...#.#...#
#.........#
#.........#
#.........#
#.........#
#X........#
###########

1
0
###########
#......#..#
#.........#
#.........#
#.........#
#.........D
#..#......#
#.........#
#.........#
#.........#
#####D#####

