5
2
#####.#####
#.........#
#..#......#
#.#.......#
#.........#
..........#
#.........#
#.......#.#
#......#..#
#........k#
###########
key : 6

2
0
#####.#####
#.........#
#.........#
###.......#
#.#.##....#
#..###.....
#..#......#
##........#
#?........#
#e........#
###########
enemies 1
sign Beware what lurks ahead.

2
2
#####.#####
#k#.....#.#
#.........#
#.........#
#.......#.#
..........d
#.........#
#.........#
#.........#
#.........#
#####.#####
key : 1

6
1
#####.#####
#.........#
#...#.....#
#.........#
#.........#
#..#.#....#
#.##......#
#.#.......#
#.........#
#X........#
###########

1
1
###########
##.#......#
#..##.....#
##.##.....#
#....#....#
...........
#.........#
#.........#
#.........#
#.........#
#####.#####

3
3
#####.#####
#.........#
#.........#
#.........#
#.........#
......##..#
#....##e#.#
#....#....#
#......##s#
#.......###
#####.#####
enemies 1
switch 0 : 0 1

2
1
#####.#####
#.........#
#.........#
#.........#
#.........#
...........
#.........#
#.#.......#
#..#......#
#.........#
#####d#####

1
3
#####.#####
#.........#
#.........#
##..#..#..#
#.........#
d..........
#.#..#..#.#
#.........#
#.........#
##.....#..#
#####.#####

1
0
###########
#.........#
#.........#
#.........#
#.........#
#....@.....
#.........#
#.........#
#.........#
#.........#
#####.#####

3
1
#####d#####
#.........#
#.........#
#.........#
#.........#
#..........
#.........#
#.........#
#.........#
#.........#
#####.#####

1
2
###########
#.........#
#......#..#
#.......#.#
#.........#
..........d
#.........#
#.......#.#
#......#..#
#.........#
#####.#####

4
1
#####.#####
#..#......#
#..#..#...#
#..##.....#
#...##....#
#..#......d
#.........#
#.........#
#.........#
#.........#
#####l#####

1
4
###########
#........k#
#.##.....##
#.#.......#
#.........#
..........#
#.........#
#........##
#.........#
#.........#
###########
key : 2

0
3
###########
#.........#
#.........#
##..#..#..#
#.........#
#.........#
#.........#
#.........#
#.........#
##.....#..#
#####.#####

4
3
#####.#####
#.........#
#.........#
#.........#
#.........#
......#...#
#.....e#..#
#.....#?..#
#.........#
#........e#
###########
enemies 2
door 0 : 0 1
sign Beware what lurks ahead.

3
2
#####.#####
#.........#
#.........#
#.....##..#
#.........#
...........
#...#.....#
#.##k.....#
#.###.....#
#.........#
#####.#####
key : 3

2
3
#####.#####
#.......#.#
#.........#
#.........#
#.........#
d.........#
#.........#
#.......#.#
#......#..#
#.........#
#####.#####

4
2
#####.#####
#.........#
##.....#..#
#.........#
#.........#
d..........
#.........#
#.........#
#......#..#
#.........#
#####.#####

5
1
#####l#####
#......##.#
#.....###.#
#......##.#
#.........#
#....e.....
#.........#
#.........#
#.........#
#.........#
#####.#####
locked : 3
boss
enemies 1

