1
4
#####.#####
#.........#
#.........#
#.#.......#
#.##e.....#
#..####...#
#...##....#
#.#..##...#
#..##.#...#
#.........#
#####l#####
locked : 0
boss
enemies 1

2
0
###########
#?........#
#.........#
#.........#
#....##...#
#..#.@....d
#.##..#...#
#.#.......#
#......#..#
#.........#
#####.#####
sign Many have walked this path.

3
5
###########
#.#.....se#
#.#e#.....#
#.##......#
#..#......#
...#......#
#..#......#
#.........#
#.........#
#........e#
###########
enemies 3
switch 1 : 1

1
1
###########
#k......#.#
#.........#
#.........#
#..#..#...#
#..........
#.........#
#.#.......#
#.........#
#.........#
#####.#####
key : 0

3
3
#####.#####
#e.......s#
#.#.....#.#
#.........#
#.........#
...........
#.........#
#.........#
#.#.......#
#e.......?#
#####.#####
enemies 2
switch 0 : 0
sign This door will not yield without a key.

2
1
#####.#####
#.........#
#.#...#.#.#
#.........#
#.#.#.#.#.#
d..........
#.#.....#.#
#.........#
#.#.#...#.#
#.........#
#####.#####

3
0
#####.#####
#.........#
#.........#
#.........#
#.........#
#..........
#.........#
#.........#
#.........#
#.........#
###########

4
4
#####.#####
#.........#
#..#..#..##
#.........#
#.........#
...#..#...#
#.........#
#........e#
#..#..#..##
#.....e.?e#
###########
enemies 3
door 1 : 1
sign Beware what lurks ahead.

3
1
#####.#####
#..#.....##
#.........#
#...#...#.#
#.........#
...#.#.#...
#.........#
#.#.#.#.#.#
#.........#
##.#...#.##
###########

1
2
###########
#.........#
#......#..#
#.........#
#.........#
..........#
#.........#
#.........#
#.........#
#.#.......#
#####l#####
locked : 2

3
2
#####.#####
##.....#..#
#.........#
#.........#
#.#.....#.#
...........
#.........#
##..#..#..#
#.........#
#k........#
#####.#####
key : 2

4
2
#####.#####
#.........#
#..#......#
#.#...#...#
#.........#
#.........d
#.........#
#.......#.#
#......#..#
#k........#
###########
key : 4

2
3
###########
#..#......#
#.#.#.....#
#.........#
#.##......#
l..##.....l
#.###.....#
##...#....#
##........#
#.........#
#####.#####
locked : 1

2
4
#####l#####
#.........#
##.#.....##
#.........#
#..#.#.#..#
l.........#
#......#..#
#.........#
##.....#.##
#.........#
#####.#####
locked : 4

4
3
#####.#####
#.........#
#.........#
#.........#
#.........#
d..........
#.........#
#.........#
#.........#
#.........#
#####.#####

3
4
#####.#####
#e........#
#.#.#.#.#.#
#.........#
#..#...#..#
...........
#.#.#.#.#.#
#.........#
#..#...#.##
#?.......e#
#####.#####
enemies 2
door 0 : 0
sign Seek the matching key before you proceed.

5
3
#####.#####
#.........#
#.........#
#.........#
#.........#
#..##.....#
#..##.....#
#.........#
#.........#
#.........#
###########

0
4
###########
#X........#
#.....#...#
#....#.#..#
#....#.#..#
#.........#
#.........#
#.........#
#.........#
#.........#
#####.#####

2
2
#####l#####
#k........#
#.#.....#.#
#.........#
#.........#
......#...l
#.........#
#.........#
#.......#.#
#.........#
#####.#####
key : 1

