0
0
###########
#k........#
#......#..#
#.......#.#
#.........#
#.........D
#.........#
#.........#
#.........#
#.........#
#####D#####
key : 1

0
1
###########
#.........#
#..#......#
#.#.......#
#.........#
D.........#
#.........#
#.........#
#.........#
#.........#
#####d#####

4
1
#####D#####
#e........#
#...#.#...#
#...#.....#
#...#.....#
D.........D
#.........#
#.........#
#........##
#....e...e#
###########
enemies 3

5
3
#####D#####
#.........#
#.........#
#.....##..#
#....###..#
D.....##..#
#.........#
#.........#
#........?#
#.......ee#
###########
enemies 2
door 0 : 0 1
sign Beware what lurks ahead.

2
0
#####D#####
#.........#
#.........#
#.........#
#..##.....#
#k.###....D
#.........#
#.........#
#.........#
#.........#
#####l#####
key : 0

1
0
#####D#####
####......#
####......#
###.......#
#..#.##...#
#..?#@....D
#..#......#
#...#..#..#
#..##.#...#
#.........#
#####D#####
sign Something glints behind that door…

1
1
#####d#####
#.........#
#.........#
#......#..#
#.........#
D.........#
#.........#
#.........#
#......#..#
#.........#
#####D#####

2
2
###########
#........k#
#.........#
#.........#
#.........#
D.........#
#.........#
#.........#
#.........#
#.........#
#####l#####
key : 3

2
1
#####D#####
#.........#
#..#......#
#.#......##
#.........#
D.........D
#.........#
#.........#
#.........#
#.........#
#####D#####

3
2
#####l#####
#......#..#
#..#...#..#
#.#.....#.#
#.......#.#
D.........D
#.........#
#.......#.#
#......##.#
#.........#
#####l#####
locked : 3

5
2
#####d#####
#.........#
#.......#.#
#.........#
#.........#
#....#....D
#.........#
#.........#
#.#.....#.#
#.........#
#####d#####

3
0
#####l#####
#.........#
#.#...#.#.#
#.........#
#.#.#.#...#
#.........D
#.#.#.#.#.#
#.........#
#.#.#.#.#.#
#.........#
#####l#####
locked : 1

4
0
#####l#####
#.........#
#......#..#
#.......#.#
#.........#
#.........D
#.........#
#.........#
#.........#
#.........#
###########
locked : 0

3
3
###########
#......?se#
#.........#
##..#..#..#
#.........#
D.........#
#...#..#..#
#.........#
#.........#
##.....#..#
#####D#####
enemies 1
switch 0 : 0 1
sign This door will not yield without a key.

3
1
#####D#####
#k........#
#.........#
##..#..#..#
#.........#
D.........D
#...#.....#
#.........#
#.........#
#......#..#
#####D#####
key : 2

4
3
#####D#####
#.........#
#...#..#..#
#.........#
#.........#
D....#....#
#.........#
#.........#
##........#
#.........#
#####D#####

4
2
#####l#####
#.........#
#......#..#
#.......#.#
#.........#
D.........D
#.........#
#.......#.#
#......#..#
#.........#
#####d#####
locked : 2

6
2
#####d#####
#......#.##
#......#.##
#........##
#...e#....#
#...##....#
#..#.#....#
#....#....#
#.........#
#.........#
#####D#####
boss
enemies 1

7
2
#####D#####
#.##....p.#
#.##......#
#...#.....#
#.##......#
#.........#
#.........#
#.........#
#.........#
#X........#
###########

