1
0
#####d#####
#.........#
#.........#
#...#....##
#.....#.#.#
#.....#...D
#....##.#.#
#....##...#
#.....#####
#........k#
#####D#####
key : 1

4
0
#####D#####
#.........#
#.........#
#.#..##...#
#..###....#
#....#....#
#..#......#
#.##......#
#.........#
#e.......e#
###########
enemies 2

4
3
#####D#####
#.........#
#.........#
#.........#
#.........#
D.........D
#.........#
#.........#
#.........#
#.........#
#####D#####

5
5
###########
#.........#
#.........#
#.........#
#.........#
D.........#
#.........#
#.........#
#.........#
#.........#
###########

6
4
#####D#####
#.........#
#.##......#
#..#.#....#
#.#.###...#
#....##...#
#...#..#..#
#.....##..#
#...#..##.#
#X........#
###########

1
1
###########
#.#.....#.#
#.........#
#.#.#.#.#.#
#.........#
D.........#
#.........#
#.#.#.#...#
#.........#
#.#.......#
#####l#####
locked : 2

2
1
#####l#####
#.........#
#........p#
#.........#
#.........#
D.........D
#.........#
#.........#
#.........#
#.........#
#####D#####

2
0
#####D#####
#.........#
#......#..#
#.......#.#
#.........#
#.........D
#.........#
#.........#
#.........#
#.........#
#####D#####

3
2
#####l#####
#.........#
#.........#
#.........#
#.........#
d.....#...D
#.........#
#.......#.#
#.........#
#.........#
#####D#####

0
0
###########
#.........#
#..#...#..#
#.#.....#.#
#.........#
#.........#
#.........#
#.........#
#.........#
#.........#
#####d#####

4
4
###########
#......?ee#
#.......#e#
#.........#
#.........#
D....#....#
#.........#
#.........#
#.......#.#
#.........#
#####D#####
enemies 3
sign Only the prepared may pass.

2
2
###########
#.........#
#.#.....#.#
#.........#
#.........#
D..#......#
#.........#
#.........#
#.#.....#.#
#.........#
#####l#####
locked : 0

3
3
###########
#.........#
#..#......#
#.........#
#.........#
D......#..#
#.........#
#.........#
#..#..#..##
#.........#
#####D#####

4
2
#####D#####
#.........#
#.........#
#.........#
#.....##..#
#......#..D
#....##.#.#
#.....#.#.#
#.......###
##.......k#
#####D#####
key : 2

3
0
#####D#####
#.........#
#.........#
#...##....#
#.###.....#
#..#@#....D
#.##.#....#
#....#....#
#.........#
#.........#
#####D#####

5
2
#####D#####
#.........#
#......#..#
#.......#.#
#.........#
#.........D
#.........#
#.........#
#.........#
#.........#
###########

3
1
#####D#####
#k#.......#
#.#.......#
#..#.....p#
#.###p....#
D..#......d
#.........#
#.........#
#.........#
#.........#
###########
key : 0

5
3
#####D#####
#.........#
#.........#
#.........#
#.........#
D.........l
#.........#
#.........#
#.........#
#....k....#
###########
key : 3

5
4
#####D#####
#.........#
#.........#
#.........#
#.........#
l....e....D
#.........#
#.........#
#.........#
#.........#
#####D#####
locked : 3
boss
enemies 1

