6
2
#####.#####
#.........#
#..#......#
#.#.......#
#.........#
d.........#
#..#......#
#.........#
#.........#
#.........#
#####.#####

8
2
#####.#####
#.........#
#.........#
#..#......#
#..#......#
.....#....#
#.....#...#
#....######
#......#X##
#........##
###########

5
1
#####.#####
#k#.......#
#.........#
#..#.#.#.##
#.........#
#...#.#...l
#.........#
#..#.#.#.##
#.........#
#.#.......#
#####.#####
key : 1

0
2
###########
#k........#
#..#...#..#
#.#.....#.#
#.........#
#.........#
#.........#
#.........#
#.........#
#.........#
#####.#####
key : 8

4
3
#####.#####
#.........#
#.....#.#.#
#.........#
#..#.#.#..#
l.........#
#.#...#.#.#
#.........#
#..#...#.##
#.........#
#####.#####
locked : 1

7
1
#####.#####
#e.#.....##
#.........#
#.........#
#e.#..#...#
#e........d
#?........#
#..#.....##
#.........#
#.........#
#####.#####
enemies 3
sign The brave are rewarded.

6
1
#####.#####
#.........#
#.#.#.....#
#.........#
#.....#.#.#
#.........d
#.#...#.#.#
#.........#
#.#.#...#.#
#.........#
#####.#####

4
2
#####.#####
#.........#
#.........#
#.........#
#.........#
....##....l
#..#.#....#
#.##.##...#
#.........#
#.........#
#####.#####

2
3
###########
##.....#e##
#........?#
#.#.#.#.#.#
#.........#
...#.#.#..#
#.........#
#...#.#...#
#.........#
##.......##
#####.#####
enemies 1
door 0 : 0 1
sign Beware what lurks ahead.

4
1
###########
#....k....#
#.......#.#
#.........#
#...#.....#
...........
#.........#
#.......#.#
#......#..#
#.........#
#####.#####
key : 0

3
2
#####d#####
#.........#
#.....###.#
#...#####.#
#...###...#
#.....#....
#...####..#
#.........#
#.........#
#.........#
#####.#####

5
3
#####.#####
##.#...#.##
#........?#
##.#.#.#.##
#.........#
.....#....#
#.........#
##.#.#.#..#
#......s.e#
##....e#e##
###########
enemies 3
switch 0 : 0 1
sign Turn back; you are not yet ready.

7
2
#####.#####
#.........#
#.........#
#....#....#
#...e.#...#
d....#....#
#.#.......#
#.........#
#.........#
#.........#
#####.#####
boss
enemies 1

4
0
###########
#.........#
#.........#
#.........#
#..#......#
#..#.@.....
#.#.##....#
#...#.....#
#####.....#
#.........#
###########

8
1
#####.#####
#.........#
#.#.....#.#
#.........#
#.........#
#..........
#.........#
#.........#
#.#.....#.#
#k........#
###########
key : 4

3
3
#####.#####
#.........#
#.........#
#..#.#....#
#..#......#
.....#....#
#.........#
#.........#
#.........#
#.........#
#####.#####

1
2
#####.#####
#.........#
#.#.....#.#
#.........#
#.........#
#.........#
#.........#
#.........#
#.......#.#
#.........#
#####d#####

5
2
#####.#####
#.........#
#.........#
#.........#
#.........#
l..........
#.........#
#.#.....#.#
#..#...#..#
#.........#
#####.#####
locked : 0

2
2
#####d#####
#.........#
#.........#
#.........#
#.........#
#..........
#.........#
#.........#
#.........#
#.........#
#####d#####

