3
1
#####D#####
#.........#
#.........#
#.##.##...#
#.###.#.#.#
#..#......D
#..#..#...#
#...#.#...#
#e........#
#ee.......#
###########
enemies 3

3
4
#####D#####
#.........#
#.#.......#
#.#.......#
#.........#
d.........l
#....#....#
#....###..#
#.....##..#
#.........#
###########

1
1
#####d#####
#k........#
#..#...#..#
#.#.....#.#
#.........#
D.........D
#.........#
#.........#
#.........#
#.........#
#####D#####
key : 0

3
3
#####D#####
#.........#
#.........#
#....#....#
#.........#
D..#......d
#.#.......#
##e##.....#
#..##.....#
#........##
#####l#####
enemies 1

5
5
#####D#####
#.........#
#.........#
#.........#
#.........#
#....#....#
#....##...#
#....#..#.#
#......####
#........X#
###########

3
6
###########
#........e#
#.........#
#.........#
#.........#
D.........#
#.........#
#.........#
#.........#
#........?#
###########
enemies 1
sign Turn back; you are not yet ready.

0
0
###########
##.#...#.##
#.........#
#.#.#.....#
#.........#
#..#.#.#..D
#.........#
#.#.....#.#
#.........#
##.#...#.##
#####D#####

4
3
#####l#####
#.........#
#.#.#.#.#.#
#.........#
#..#......#
#.........#
#.#.#.#.#.#
#.........#
#..#...#..#
#.........#
###########
locked : 1

2
3
###########
#.........#
#...#..#..#
#......#..#
#...#...#.#
D...##....D
#.##..###.#
#.#.......#
#.........#
#.........#
#####D#####

2
2
#####D#####
#.........#
#.........#
#.........#
#.........#
D.........D
#..#......#
#..###....#
#..#......#
#.........#
#####d#####

0
1
###########
#.........#
#.........#
#.........#
#.###.#...#
D..##.##..#
#..####...#
#..#.#.#..#
#......#..#
#.........#
#####d#####

3
5
#####D#####
#.........#
#.........#
#.........#
#.........#
l.........D
#.........#
#.........#
#.........#
#.........#
#####d#####
locked : 0

3
2
#####d#####
#.........#
#.........#
#.........#
#.........#
D.........D
#.........#
#.........#
#.........#
#.........#
###########

4
5
#####d#####
#..#......#
#..##.....#
#.#.#.....#
#.........#
#....e....#
#.........#
#.........#
#.........#
#.........#
#####D#####
boss
enemies 1

2
4
###########
#..k.....##
#..#......#
#.#.......#
#.........#
D.........D
#..#......#
#.........#
#.........#
#.........#
#####D#####
key : 2

2
1
#####D#####
#k........#
##..#..#..#
#.........#
#.........#
#....#....D
#.........#
#.........#
#......#..#
#.........#
#####D#####
key : 1

2
5
###########
#........k#
#.#.#.#.#.#
#.........#
#.#.#.#...#
D.........#
#.#.#.#.#.#
#.........#
#.#.#.#.#.#
#.........#
#####D#####
key : 4

1
2
###########
#.........#
#.#.....#.#
#.........#
#.........#
D..#..#...#
#.........#
#.........#
#.......#.#
#.........#
#####D#####

1
0
#####D#####
#.........#
#.........#
#.........#
#.........#
#....@....D
#.........#
#.........#
#.........#
#.........#
###########

