2
2
#####.#####
#......#..#
#.....###.#
#......#..#
#.....#...#
#..........
#.........#
#.........#
#.........#
#.........#
#####.#####

2
3
#####.#####
#k........#
#......#..#
#.......#.#
#.........#
..........d
#.........#
#.#.......#
#..#......#
#.........#
#####l#####
key : 2

1
5
#####.#####
#.........#
#.........#
#.........#
#.........#
.....e....#
#....#....#
#...#.....#
#.........#
#.........#
#####d#####
boss
enemies 1

4
2
#####.#####
#.......#.#
#.........#
#...#...#.#
#.........#
....#.#...#
#.........#
#.#.#.#...#
#.........#
#.#.....#k#
###########
key : 1

3
3
#####l#####
#.#.....#.#
#.........#
#..#.#.#.##
#.........#
....#.#....
#.........#
#..#.#.#.##
#.........#
#.......#.#
###########
locked : 2

2
6
###########
#.........#
#.........#
#.........#
#.........#
d.........#
#.........#
#.#.......#
#..#......#
#.........#
###########

0
5
###########
#X........#
#.........#
#.........#
#.........#
#.........#
#.........#
#.........#
#.........#
#.........#
#####.#####

1
2
#####.#####
#.#.......#
#.........#
#..#.#.#.##
#.........#
#...#.#....
#.........#
#..#.#.#.##
#.........#
#.#.....#.#
#####.#####

3
1
###########
#.........#
#.........#
##..#.....#
#.........#
#.........l
#.#..#....#
#.........#
#.........#
##.....#..#
#####l#####
locked : 1

3
2
#####.#####
#.........#
#.........#
#.........#
#.........#
l..#.###...
#..#.#....#
#..#.###..#
#..#...#..#
#.........#
#####.#####
locked : 0

1
4
###########
#e...e....#
#.........#
#.........#
#.........#
...........
#.........#
#.........#
#.........#
#.........#
#####.#####
enemies 2

2
5
#####d#####
##.#...#.##
#.........#
#.#.#...#.#
#.........#
...#...#..d
#.........#
#.#.#.....#
#.........#
#......#..#
###########

2
4
#####.#####
#.........#
#.........#
#.........#
#.........#
d..........
#.........#
#.........#
#.........#
#.........#
#####d#####

5
1
#####.#####
#.#.....#.#
#.........#
#.........#
#.....#...#
#.........#
#.........#
#.#..#..#.#
#.........#
#.........#
###########

4
0
###########
#..#......#
#.#.#.....#
#...#.#..##
#.##@#....#
#....##....
#.........#
#.........#
#.........#
#.........#
###########

4
1
#####l#####
#k........#
#.........#
#.........#
#.........#
...........
#.........#
#.........#
#.........#
#.........#
#####.#####
key : 0

3
4
#####d#####
#.........#
#.........#
#.........#
#.........#
..........#
#.........#
#.........#
#.........#
#.........#
###########

0
2
###########
#.........#
#.........#
#.........#
#.........#
#..###....#
#.####....#
###.#.....#
#.#.#.....#
#........##
#####.#####

1
3
###########
#..k......#
#..#......#
#.#.......#
#.........#
...........
#.........#
#.......#.#
#......#..#
#.........#
#####.#####
key : 3

