5
0
#####.#####
#.........#
#..#......#
#.#.......#
#.........#
#..........
#.........#
#.........#
#.........#
#k........#
###########
key : 4

4
2
#####.#####
#e........#
#.........#
#.........#
#.........#
...........
#.........#
#.........#
#.........#
#e........#
#####.#####
enemies 2
door 0 : 0

3
0
#####.#####
#.........#
#.........#
#.........#
#..#......#
#..........
#.###.....#
#.###.....#
#..##.....#
#.........#
#####d#####

3
3
###########
#.........#
#.........#
#.........#
#.........#
l.........#
#.........#
#.........#
#.........#
#.........#
#####.#####
locked : 2

3
1
#####.#####
#.........#
#.........#
##..#.....#
#.###.....#
....#......
#.........#
##........#
#.........#
#.........#
#####.#####

1
1
###########
#.##...#.##
#.##...#..#
#...#.###.#
#.....##..#
d....e.#..#
#.......#.#
#.........#
#.........#
#......#..#
#####.#####
boss
enemies 1

1
0
#####.#####
#e........#
##e#......#
####......#
#e##......#
#?.s......d
#..##.....#
#.........#
#.........#
#.........#
#####.#####
enemies 3
switch 1 : 1
sign The dungeon remembers all who enter.

4
0
#####d#####
#.........#
#.........#
#.........#
#.........#
#....@.....
#.........#
#.........#
#.........#
#.........#
#####.#####

4
3
#####.#####
#.........#
#.........#
#.........#
#.........#
..........#
#.........#
#.........#
#.........#
#.......se#
###########
enemies 1
switch 0 : 0

2
0
#####.#####
##.#.....##
#.........#
##.#...#..#
#.........#
#..#.#.#...
#.........#
##.#.#...##
#.........#
#..#...#.##
#####.#####

7
1
#####.#####
##.....#..#
#.........#
##.....#.##
#.........#
#..#.#....#
#.........#
##.#.#.#..#
#k........#
##.#...#.##
###########
key : 2

6
1
#####.#####
#......#..#
#.....#.#.#
#.....#.#.#
#.........#
#.........#
#.........#
#.........#
#.........#
#.........#
#####.#####

3
2
#####d#####
#k........#
#.........#
#.........#
#..#......#
..........l
#.........#
#.#.......#
#..#..#...#
#........##
#####.#####
key : 1

0
0
###########
#e....e#.e#
#.....#...#
#.......#.#
#.........#
#...#.....#
#...#.....#
#.#.......#
#.........#
#.........#
#####.#####
enemies 3
door 1 : 1

2
1
#####.#####
#X........#
#.........#
#.........#
#.........#
...........
#.........#
#.........#
#.........#
#.........#
#####.#####

4
1
#####.#####
##.#...#.##
#.........#
##...#.#.##
#.........#
...#.#.....
#.........#
##.#.#.#..#
#.........#
##.#...#..#
#####d#####

2
2
###########
#.........#
#.........#
#.........#
#.........#
..........#
#.........#
#.........#
#.........#
#.........#
#####d#####

5
1
#####d#####
#.........#
#.#.#.....#
#.##......#
#...#...#.#
...........
#......#..#
#......##.#
#......##.#
#.........#
#####.#####

5
2
#####.#####
#.........#
#..#......#
#.#.......#
#.........#
..........#
#.........#
#.#.......#
#..#......#
#........k#
###########
key : 0

