5
2
#####l#####
#k........#
##.#...#..#
#.........#
#...#.#.#.#
D.........D
#..#...#..#
#.........#
#.#.#.#.#.#
#.........#
#####d#####
key : 2

1
0
#####d#####
#.........#
#..##.....#
#?#s#.....#
#.........#
#.e##.....d
#e#e#.....#
#.p....p..#
#.........#
#.........#
#####D#####
enemies 3
switch 0 : 0
sign Beware what lurks ahead.

3
1
#####D#####
#........##
#.........#
#.........#
#.........#
D.........l
#..#......#
#.........#
#.........#
#.........#
#####D#####

2
0
#####D#####
#.........#
###.#.....#
#.#.#.....#
#.###.....#
#...#.....D
#.#.......#
#.........#
#.........#
#.........#
#####D#####

4
1
#####D#####
#.........#
#........##
#.........#
#.........#
D.........D
#.........#
#.........#
#.........#
#.........#
#####d#####

6
2
#####d#####
#.........#
#.........#
#.........#
#.........#
#.........#
#.........#
#.#.......#
#..#......#
#.........#
###########

4
2
#####D#####
#.........#
#.........#
#.........#
#.......#.#
D...#e.#..D
#.......#.#
#...#.##..#
#.....###.#
#.........#
#####l#####
locked : 2
boss
enemies 1

4
3
#####D#####
#e........#
#.........#
#.........#
#.........#
D.........D
#.........#
#.........#
#.........#
#?........#
#####D#####
enemies 1
door 0 : 0
sign This door will not yield without a key.

3
3
###########
#........k#
#.#.......#
#........##
#.........#
D.........#
#.........#
#.........#
#......#..#
#.........#
#####D#####
key : 3

5
3
#####D#####
#.........#
#.........#
#.........#
#.........#
D.........#
#.........#
#.........#
#.........#
##.......k#
###########
key : 4

0
0
###########
#..#.....##
#.........#
#.........#
#..#..#...#
#.........#
#.........#
#..#..#...#
#.........#
#.........#
#####d#####

2
1
#####D#####
#k........#
#.........#
#.........#
#.........#
D.........D
#.........#
#.#.......#
#..#......#
#.........#
#####D#####
key : 0

4
4
###########
#.......ee#
#.........#
#.........#
#.........#
D.........#
#..##.....#
#.###.....#
#.##......#
#........e#
###########
enemies 3

3
2
#####D#####
#.......#.#
#.........#
#....#.#.##
#.........#
l...#.#...D
#.........#
#..#.#...##
#.........#
#.......#.#
#####D#####
locked : 0

3
0
#####D#####
#.........#
#.........#
#.........#
#.........#
#...#@#...D
#....##...#
#....###.##
#.....#...#
#......##?#
#####D#####
sign The dungeon remembers all who enter.

1
1
###########
#.........#
#.........#
#.........#
#.........#
d..#......#
#..#......#
#.........#
#.........#
#.........#
#####D#####

5
1
#####d#####
#.........#
#.........#
#.........#
#.........#
#...#..#..D
#.........#
#.........#
#..#..#..##
#.........#
###########

4
0
#####D#####
#.........#
#.........#
#p........#
#.........#
#......p..D
#.........#
#.........#
#.........#
#.........#
###########

2
2
###########
####.....X#
##........#
####......#
#....#....#
D..#.#....#
#.........#
#.........#
#.........#
#..#......#
#####D#####

