5
1
#####.#####
#.........#
#.........#
#.........#
#.........#
..........#
#.........#
#.........#
#.........#
#.........#
#####.#####

1
0
#####d#####
#.........#
#.........#
#...#.#...#
#..##..#..#
#...###....
#..##.#...#
#..##..#..#
#.........#
#.........#
#####d#####

1
2
#####.#####
#.........#
#.........#
#.........#
#.........#
.....e....#
#....###..#
#....#...##
#.........#
#.........#
#####d#####
boss
enemies 1

2
1
#####.#####
#.........#
#.........#
#.........#
#.........#
l..........
#.........#
#.#.....#.#
#..#...#..#
#.........#
#####l#####
locked : 0

0
0
###########
#.........#
#......#..#
#....#..#.#
#.........#
#....#....#
#.........#
#.......#.#
#......#..#
#........##
#####d#####

1
1
###########
#.........#
#.........#
##..#..#..#
#.........#
...........
#...#..#..#
#.........#
#.........#
#.........#
#####.#####

2
2
#####d#####
#.........#
##.....#..#
#.........#
#.........#
....#..#..#
#.........#
#.........#
##.....#..#
#.........#
#####l#####
locked : 3

7
0
#####.#####
#.........#
#...#.#...#
#..##..#..#
#...#.##..#
#..#.###..#
#..#...#..#
#.........#
#.........#
#e.......?#
###########
enemies 1
sign The brave are rewarded.

6
0
#####.#####
#k........#
##.#...#.##
#.........#
#...#.#.#.#
#..........
#..#.#.#..#
#.........#
#.#...#.#.#
#.........#
#####.#####
key : 1

6
1
#####.#####
#.........#
#..#......#
#.#.......#
#..#......#
..........#
#.........#
#.........#
#.........#
#........k#
###########
key : 2

2
0
#####d#####
#.........#
#..#..#...#
#.........#
#.........#
#.....#...l
#.........#
#.........#
#.....#..##
#.........#
#####.#####

4
0
#####l#####
##.#...#..#
#k........#
##.#.#...##
#.........#
#..#.#....d
#.........#
##.#...#.##
#.........#
##.#.....##
#####.#####
key : 0

0
2
###########
#X.#......#
#.........#
#....#....#
#.........#
#.........#
#...###...#
#.........#
#.........#
#.........#
#####.#####

3
2
#####l#####
#.........#
#.........#
#.#.......#
#.#.......#
.....#....#
#.##......#
######....#
##........#
#k........#
#####.#####
key : 3

4
2
#####.#####
#.........#
#.........#
#.#.......#
#.#.......#
...#......#
#......#..#
#......#..#
#......#..#
#.........#
###########

3
0
#####.#####
#.#.....#.#
#.........#
#..#.#....#
#.........#
#...#.#....
#.........#
#..#.#.#.##
#.........#
#.#.....#.#
#####l#####
locked : 1

5
0
#####.#####
#.........#
#.........#
##...#.#..#
#?##......#
#....@.#...
#.........#
#.........#
#.........#
#.........#
#####.#####
sign The brave are rewarded.

3
1
#####l#####
#.........#
#.........#
#.........#
#.........#
...........
#.........#
#.........#
#.........#
#.........#
#####.#####
locked : 2

4
1
#####.#####
#..#...#.##
#.........#
#...#.#.#.#
#.........#
d..#...#...
#.........#
#.....#...#
#.........#
##.#...#.##
#####.#####

