7
1
#####d#####
#.........#
#.........#
#.......#.#
#.......#.#
D.....#...#
#.........#
#.......#.#
#......#..#
#.........#
###########

6
1
#####D#####
#.........#
#..##.#...#
#.#..##...#
#.#...#...#
D..#..#...D
#..##.#...#
#.........#
#.........#
#.........#
#####d#####

4
3
#####D#####
##.#...#.##
#.........#
##.#.#....#
#.........#
d..#.#.#..#
#.........#
##.#...#..#
#.........#
##.#.....##
###########

5
0
###########
#?........#
#.........#
#.........#
#.##......#
#..#.@....D
#.##......#
#.........#
#.........#
#.........#
#####D#####
sign Many have walked this path.

0
2
###########
#X........#
#.........#
#.........#
#.........#
#.........#
#.........#
#.........#
#.........#
#.........#
#####D#####

1
2
#####D#####
#.........#
#.........#
#.........#
#......#..#
#..##e##..#
#....#....#
#..#.##...#
#..##..#..#
#.........#
#####d#####
boss
enemies 1

3
3
#####D#####
#.........#
#..#......#
#.#....#..#
#.........#
D.........d
#.........#
#.........#
#...#.....#
#.........#
#####D#####

5
1
#####D#####
#e........#
#.........#
#.........#
#.#...#...#
D..##.#...D
#.###e#...#
#..#e##...#
#.....#...#
#.........#
#####D#####
enemies 3

7
0
#####D#####
#.........#
###.#.....#
###..#....#
#.#....#..#
#..#.#....D
#.####....#
#.........#
#.........#
#.........#
###########

3
4
###########
#.........#
#.........#
#..p......#
#....#....#
d...#.#...#
#.........#
#.........#
#.........#
#.........#
###########

2
3
###########
#........k#
#.........#
#.........#
#.........#
D.........#
#.........#
#.........#
#.........#
#.........#
#####D#####
key : 3

4
1
#####l#####
#.........#
#.........#
#.........#
#.####....#
#...##....D
#.#.##....#
###.##....#
#..##.....#
#.........#
#####D#####

5
2
#####D#####
#........k#
#..#...#.##
#.........#
#.#.#...#.#
D.........#
#....#.#..#
#.........#
#.#.#.#.#.#
#.........#
#####D#####
key : 0

3
2
#####D#####
#.........#
#.........#
##.....#..#
#.........#
D.........D
#....#....#
#.........#
#.........#
##........#
#####l#####
locked : 1

4
2
#####l#####
#.........#
#.........#
#.........#
#.........#
D.........d
#.........#
#.......#.#
#......#..#
#.........#
#####D#####

2
2
#####d#####
#.........#
#......#..#
#.......#.#
#.........#
#.........D
#.........#
#k#.......#
#..#......#
#.........#
#####D#####
key : 2

6
2
#####D#####
##.#.....##
#.........#
#.#...#.#.#
#.........#
D..#...#..#
#.........#
#.#...#.#.#
#.........#
##.#...#k##
###########
key : 1

6
0
#####D#####
#.........#
#.........#
#....######
#....##...#
#.....#...D
#.....##..#
#....####.#
#......#..#
#.........#
#####D#####

3
1
###########
#.........#
#..#......#
#.#.......#
#.........#
#.........D
#.........#
#.........#
#.........#
#.........#
#####l#####
locked : 0

