5
0
#####D#####
#.........#
#..#...#..#
#.#.....#.#
#.........#
#.........#
#.........#
#.........#
#.........#
#.........#
#####d#####

3
0
#####l#####
#.........#
#........##
#...###...#
#..##.#...#
#..##.....D
#.....#...#
#...###...#
#.........#
#........##
#####D#####
locked : 0

3
3
#####D#####
#.........#
#..#......#
#.#.......#
#.........#
D.........d
#.........#
#.........#
#.........#
#.........#
###########

2
0
###########
#?........#
#.........#
#.........#
#.........#
#....@....D
#......##.#
#......##.#
#.....#.#.#
#.........#
#####l#####
sign Seek the matching key before you proceed.

1
1
###########
#..#......#
#......#..#
#.......#.#
#.........#
#.........D
#.........#
#.........#
#.......#.#
#..#......#
#####D#####

2
4
###########
#.........#
#.....#####
#....####.#
#.........#
l....#....d
#......##.#
#.........#
#.........#
#.........#
#####D#####
locked : 3

1
2
###########
#.........#
#..#......#
#.#.......#
#.........#
D.........#
#.........#
#.#.......#
#..#......#
#.........#
#####D#####

2
5
#####d#####
#.#.....#.#
#.........#
#.........#
#.#..#..#.#
d.........#
#.........#
#.#..#..#.#
#.........#
#.........#
###########

4
1
#####D#####
#.........#
#.........#
#.p.......#
#..###....#
D..##.....#
#....#....#
#.........#
#.........#
#........k#
###########
key : 3

6
0
#####d#####
#.........#
#..#...##.#
#.#.....#.#
#.........#
#.........#
#.........#
#......#..#
#.........#
#.........#
###########

3
4
#####D#####
#.........#
#.#.#...#.#
#.........#
#.#.#...#.#
d.........#
#.#...#.#.#
#.........#
#...#.....#
#.........#
###########

2
2
#####D#####
#.........#
#.........#
#.........#
#....#..#.#
D.....#...l
#.....#.#.#
#....#.#.##
#........##
#.........#
#####D#####

4
0
#####D#####
#.........#
#.........#
#.........#
#.........#
#k........D
#.........#
#.......#.#
#......#..#
#.........#
#####D#####
key : 2

2
3
###########
#..#.....##
#.........#
#.........#
#...#.....#
l.........l
#.........#
#..#..#..##
#.........#
#.........#
#####D#####
locked : 2

0
5
###########
#X........#
#.........#
#...#.#...#
#...#.#...#
#.........#
#.........#
#.......p.#
#.........#
#.........#
#####D#####

3
1
#####D#####
#k........#
##..#..#..#
#.........#
#.........#
D....#....D
#.........#
#.........#
#.........#
#.........#
#####D#####
key : 1

1
5
#####D#####
#.........#
#...#.#...#
#...##.#..#
#..###....#
#...e##...#
#..#..#...#
#.........#
#.........#
#.........#
#####d#####
boss
enemies 1

2
1
#####D#####
#k........#
##.....#..#
#.........#
#..#...#..#
D.........D
#..#.#.#..#
#.........#
##.....#.##
#.........#
#####D#####
key : 0

3
2
#####D#####
#e#.....#?#
#.........#
#...#.#.#.#
#.........#
D...#.#...D
#.........#
#.#.#.#.#.#
#.........#
#e#.....#.#
###########
enemies 2
sign What you seek is close.

