2
2
#####D#####
#.........#
#.........#
#..#......#
#..#......#
l.........D
#.........#
#.........#
#.........#
#.........#
#####D#####
locked : 0

3
5
#####d#####
#......#..#
#.....###.#
#....#.##.#
#...#.....#
D...####..D
#......#..#
#.....###.#
#......####
#.........#
###########

1
0
#####D#####
#.........#
#.........#
#.........#
#.........#
#?...@....D
#.........#
#.........#
#.........#
#.........#
#####D#####
sign Those who search shall find.

2
5
###########
#.........#
#.........#
#.........#
#.........#
D.........d
#.........#
#.........#
#.........#
#.........#
#####d#####

3
4
#####D#####
#e........#
#.........#
#.........#
#.........#
#e........D
#.........#
#.........#
#.........#
#.........#
#####D#####
enemies 2

1
2
###########
#.........#
#.........#
##.....#..#
#.........#
l.........D
#...#..#..#
#.........#
#.........#
##.....#..#
#####D#####
locked : 2

4
4
#####D#####
#.........#
#.........#
#.........#
#.........#
#.........#
#.........#
#.........#
#e........#
#e.......e#
###########
enemies 3

2
3
#####D#####
#.........#
#.........#
#.........#
#.........#
D.........d
#.........#
#.........#
#.........#
#....k....#
###########
key : 3

2
4
###########
#.......#.#
#.........#
#.#.#.#.#.#
#.........#
d...#.#...D
#.........#
#.#.....#.#
#.........#
#.#.....#.#
#####D#####

2
0
#####D#####
#.........#
#.........#
#.........#
#.#.#.....#
#...#.....D
#k####....#
####......#
#..##.....#
#.........#
###########
key : 0

2
6
###########
#.........#
#.........#
#.........#
#....####.#
d....e##..#
#.......#.#
#....##.#.#
#.........#
#.........#
#####D#####
boss
enemies 1

1
1
#####d#####
#..#......#
#..##.#...#
#..##..#..#
#..#p.#...#
D..#...#..l
#.##......#
#.........#
#.........#
#p........#
#####D#####

0
1
###########
#.........#
#..#......#
#.#.......#
#.........#
D.........#
#.........#
#.......#.#
#......#..#
#.........#
#####d#####

0
0
###########
#k........#
#.........#
#.........#
#.#..#..#.#
#.........D
#.........#
##..#..#..#
#.........#
#.........#
#####D#####
key : 1

2
1
#####D#####
#k#.......#
#.........#
#..#.#.#.##
#.........#
D...#.#...l
#.........#
#..#...#..#
#.........#
#.#.....#.#
#####D#####
key : 2

3
1
#####D#####
#.........#
#..#......#
#.#.......#
#.........#
#.........D
#.........#
#.........#
#.........#
#.........#
###########

3
2
#####D#####
#.........#
#.........#
#.........#
#.........#
D.........#
#.........#
#.........#
#.........#
#.........#
###########

3
6
#####D#####
#p........#
#..##.....#
#....#....#
#...#.#...#
D.....#...#
#...##....#
#.........#
#..p......#
#........X#
###########

1
3
###########
#.........#
#..#......#
#.#.......#
#.........#
D.........#
#.........#
#.........#
#.........#
#.........#
#####D#####

