3
4
#####l#####
#.........#
#.........#
#.........#
#.........#
#..........
#.........#
#.......#.#
#......#..#
#.........#
###########
locked : 1

1
5
###########
#.........#
#.........#
#.........#
#.........#
...#......#
#.........#
##.#......#
#.........#
#......#..#
#####.#####

2
1
#####.#####
##k#.....##
#.........#
#.#...#.#.#
#.........#
...#.#.#..d
#.........#
#.#.....#.#
#.........#
##.#...#.##
#####.#####
key : 0

3
6
#####.#####
#.........#
#.........#
#.........#
#.........#
d.........d
#.........#
#.#.......#
#..#......#
#.........#
###########

1
3
###########
#.#.......#
#..#..#...#
#..##.....#
#.##..#...#
#..........
#.....#...#
#.....#...#
#.........#
#.........#
#####d#####

3
5
#####.#####
#e........#
##..#..#..#
#.........#
#.........#
.....#....d
#.........#
#.........#
##..#.....#
#.........#
###########
enemies 1

1
4
###########
#..k......#
#..#......#
#.#.......#
#.........#
...........
#.........#
#.#.......#
#..#......#
#.........#
#####.#####
key : 3

2
4
#####.#####
#.........#
#.#.....#.#
#.........#
#.........#
l..#..#....
#.........#
#.........#
#.#.....#.#
#.........#
#####l#####
locked : 0

4
7
#####.#####
#.........#
#.........#
#.........#
#.........#
#....###..#
#.........#
#....#....#
#.........#
#X........#
###########

2
3
#####d#####
#.........#
#.........#
#.........#
#.........#
..........l
#.........#
#.......#.#
#......#..#
#......k..#
###########
key : 1

1
1
###########
#.#.......#
#.........#
#.....#.#.#
#.........#
....#.#...#
#.........#
#.....#.#.#
#.........#
#.#.......#
#####.#####

2
2
###########
#.#.....#.#
#.........#
#....#.#.##
#.........#
d...#......
#.........#
#..#.#...##
#.........#
#.........#
###########

3
7
###########
#.........#
#.........#
#.........#
#.........#
d....e....#
#..#......#
#.#.......#
##.#......#
#.........#
#####.#####
boss
enemies 1

1
0
#####.#####
#.........#
#.........#
#....##...#
#....##...#
#....@.....
#.....#...#
#.........#
#.........#
#.........#
#####.#####

2
5
#####.#####
#k........#
#.........#
#.........#
#.........#
...........
#.........#
#.........#
#.........#
#.........#
#####.#####
key : 2

2
6
###########
#.........#
##..#.....#
#.........#
#.........#
..........#
#.........#
#.........#
##..#..#..#
#.........#
#####.#####

2
0
#####.#####
#.........#
#.........#
#.........#
#.........#
#..........
#.........#
#.........#
#.........#
#.........#
###########

0
0
###########
#.........#
#..#......#
#.#.......#
#.........#
#.........#
#.........#
#.#.......#
#..#......#
#.........#
#####.#####

3
1
#####.#####
#.........#
#.#.#.#...#
#.####....#
#.#####...#
#.........#
#.........#
#.........#
#.........#
#.........#
###########

