3
2
#####D#####
#.........#
#.##......#
#.###.....#
#.#..#.#..#
D......#X.#
#....####.#
#....#.#..#
#........##
#.........#
#####D#####

2
1
#####D#####
#k........#
##..#.....#
#.#.##....#
#..###....#
D..#.##...d
#....#....#
#.........#
#.........#
#.........#
#####D#####
key : 5

5
1
#####D#####
#.........#
#..#......#
#.#.......#
#.........#
D.........#
#.#.......#
#.......#.#
#..#...#..#
#.........#
#####D#####

2
2
#####l#####
#.........#
#......#..#
#.......#.#
#.........#
d.........#
#.........#
#.........#
#.........#
#.........#
#####D#####

0
2
###########
#s.......e#
#?.#...#.##
#.........#
#..#.#.#..#
#.........#
#..#.#.#..#
#.........#
##.#......#
#.........#
#####D#####
enemies 1
switch 0 : 0 1
sign Seek the matching key before you proceed.

7
0
#####l#####
#.........#
#.........#
#.........#
#.........#
#.........D
#.........#
#.........#
#.........#
#.........#
###########
locked : 0

2
0
###########
#.........#
#..#......#
#.#....#..#
#.........#
#..#......D
#.........#
#.......#.#
#......#..#
#.......#.#
#####d#####

4
1
#####d#####
#e.......?#
#..#..##..#
#..#..##..#
#...##e#..#
D.........D
#.....#...#
#.........#
#.........#
#e........#
#####D#####
enemies 3
sign The brave are rewarded.

3
1
#####D#####
#.........#
#.........#
#.........#
#.........#
D.........D
#.........#
#.........#
#.........#
#.........#
#####d#####

1
1
###########
#k........#
#.........#
#.........#
#.#.#.....#
#...#.....D
#.#.#.....#
#.........#
#.........#
#.........#
#####D#####
key : 6

6
1
#####D#####
#.........#
#.........#
#.........#
#.........#
d.........#
#.........#
#.........#
#.........#
#.........#
#####D#####

3
0
#####d#####
#.........#
#.........#
#.........#
#.........#
#.........D
#.........#
#.........#
#.........#
#.........#
#####D#####

4
0
#####D#####
#.........#
#.....#.###
#....#...##
#....##...#
#....k##..D
#....#.#..#
#.........#
#.........#
#.........#
#####D#####
key : 0

4
2
#####D#####
##.#...#.##
#.........#
##.#.#.#.##
#.........#
D..#......#
#.........#
#....#.#.##
#.........#
##.#...#..#
###########

1
2
#####D#####
#.......#.#
#.....##..#
#...#.#...#
#...##..#.#
D....e....D
#.........#
#.....#.#.#
#.....##..#
#.........#
#####l#####
locked : 6
boss
enemies 1

1
3
###########
#........e#
#.........#
#.........#
#.........#
D...#.....#
#..##.....#
#####.....#
##..#.....#
###......?#
###########
enemies 1
door 0 : 0 1
sign Turn back; you are not yet ready.

6
0
#####D#####
##........#
#......#..#
#k#.....#.#
#.........#
#.........d
#.........#
#.#.......#
#.........#
#.........#
#####l#####
key : 1

5
0
#####D#####
#.........#
#.........#
#.........#
#.........#
#?...@p...D
#.........#
#........p#
#.........#
#.........#
#####D#####
sign The brave are rewarded.

7
1
#####D#####
#.........#
#..#......#
#.#.......#
#.........#
D.........#
#.........#
#.......#.#
#......#..#
#.........#
###########

