5
1
#####.#####
#.........#
#..#......#
#.#.......#
#.........#
...........
#.........#
#.........#
#......#..#
#.........#
###########

3
1
#####.#####
#.........#
#......#..#
#.......###
#.........#
...........
#.....#...#
#.#.......#
#..#......#
#.........#
#####d#####

4
1
#####d#####
##.....#.##
#.........#
##.#.#.#.##
#.........#
...#.#.#..l
#.........#
##.#.#.#.##
#.........#
##.#...#.##
#####.#####

5
2
#####.#####
#.........#
####......#
#..#.#....#
#..#......#
.....#....#
#.##......#
#......#..#
#.........#
#.......ee#
###########
enemies 2
door 0 : 0

1
2
#####.#####
#..#......#
##.##.....#
##.#..#...#
#.........#
d....e....#
#.........#
#.........#
#.........#
#.........#
#####.#####
boss
enemies 1

4
0
#####.#####
#......##.#
#.....#.#.#
#...#...#.#
#.......#.#
#...#......
#e##?#....#
#e#s......#
####......#
####......#
#####.#####
enemies 2
switch 0 : 0
sign Beware what lurks ahead.

2
1
#####.#####
#.........#
#.........#
#.........#
#.........#
...........
#.........#
#.......#.#
#......#..#
#.........#
#####.#####

4
2
#####.#####
##........#
###....#..#
###.......#
#...#.....#
l.........d
#.........#
##........#
#.........#
#.........#
#####.#####
locked : 0

2
0
###########
#.........#
#......#..#
#.......#.#
#.........#
#..........
#.........#
#.........#
#.........#
#.........#
#####.#####

0
1
###########
#.........#
#.........#
#..#......#
#.........#
#..........
#.........#
#.......#.#
#......#..#
#.........#
#####d#####

0
2
###########
#........X#
#.....#...#
#....##...#
#...###...#
...###....#
#...###...#
#.........#
#.........#
#.........#
#####.#####

5
0
#####.#####
#.........#
#...#..#..#
#.........#
#.........#
#...#..#...
#.........#
#.........#
##..#.....#
#.........#
#####.#####

3
2
#####.#####
#k........#
#.........#
###.......#
#..#......#
...#.......
#.........#
#.........#
#.........#
#.........#
#####.#####
key : 0

3
3
###########
#........k#
#.........#
##..#..#..#
#.........#
..........#
#....#..#.#
#.........#
#.........#
##.....#..#
#####.#####
key : 2

6
0
#####.#####
#.........#
#......#..#
#.......#.#
#.........#
#.........#
#.........#
#.#.......#
#..#......#
#k........#
###########
key : 3

3
0
#####.#####
#..#...#..#
#..##.....#
#...#.....#
#.........#
#....@.....
#.........#
#...#.....#
#.........#
#.........#
#####.#####

1
1
#####d#####
#.........#
#.#.#.#.#.#
#.........#
#....#.#..#
#.........d
#k#...#.#.#
#.........#
#..#...#.##
#.........#
#####.#####
key : 1

2
2
#####.#####
#?........#
#.##......#
#.#.......#
#.#.......#
.........e#
#.........#
#.........#
#.........#
#.........#
#####.#####
enemies 1
sign Something glints behind that door…

4
3
#####.#####
#.........#
#..#......#
#.#.......#
#.........#
d.........#
#.........#
#.........#
#.........#
#.........#
###########

