3
4
#####D#####
#.........#
#.........#
#.........#
#.........#
D.........#
#.........#
#.........#
#.........#
#.......ee#
###########
enemies 2

3
2
#####D#####
#k........#
#.........#
#..#.....##
#.........#
D.........D
#.....#...#
#.........#
#.........#
#........##
#####D#####
key : 0

1
4
#####D#####
##.....#.##
#.........#
#....#...##
#.........#
D..#.#.#..d
#.........#
#..#.#.#.##
#.........#
##.#...#.##
#####d#####

2
4
#####d#####
#.........#
#.........#
#.........#
#.........#
D.........D
#.........#
#.........#
#.....#...#
#.........#
#####D#####

2
2
#####D#####
#e........#
#.........#
#.........#
#.........#
D.........D
#.........#
#.........#
#.........#
#e........#
#####D#####
enemies 2

3
3
#####l#####
#k##......#
#...#.....#
#.........#
#.........#
D.........D
#..#.#....#
#...#.....#
#..##.....#
#.........#
###########
key : 1

2
3
#####l#####
#.........#
#......#..#
#.......#.#
#.........#
D.........D
#.........#
#.......#.#
#......#..#
#.........#
#####l#####
locked : 2

1
2
###########
#.........#
#.........#
##.....#..#
#.........#
D.........D
#.#..#....#
#.........#
#.........#
#.........#
#####D#####

4
1
#####D#####
#.........#
#..#..##..#
#..#..##..#
#..##.##..#
#.........D
#.........#
#.........#
#........##
#.........#
#####d#####

2
1
#####D#####
#.........#
#...#..#..#
#.......#.#
#.........#
#.........D
#......#..#
#.#.....#.#
#..#..##..#
#.........#
#####d#####

3
1
#####d#####
#.........#
#...#.....#
#.........#
#.........#
D.........D
#.........#
#.#.......#
#..#......#
#.........#
#####D#####

1
3
###########
#.........#
#.........#
##.....#..#
#.........#
D.........D
#...#..#..#
#.........#
#.........#
##.....#..#
#####l#####
locked : 0

3
0
###########
#.........#
#..##..#..#
#....###..#
#..###....#
#...####..D
#..##@.#..#
#.........#
#.........#
#.........#
###########

0
4
###########
#k........#
#...#..#..#
#.........#
#.........#
#...#.....#
#.........#
#.........#
#.........#
#.........#
#####D#####
key : 5

5
1
#####d#####
#.........#
#.#.......#
###.......#
#.#.......#
#.........#
#.........#
#.........#
#.........#
#.........#
###########

4
2
#####D#####
#.........#
#..#......#
#.#.......#
#.........#
D.........#
#.........#
#.#.......#
#..#......#
#........k#
###########
key : 2

1
1
###########
#.........#
##........#
#.........#
#.........#
#.........D
#.........#
#.......#.#
#......#..#
#.........#
#####D#####

1
5
###########
##........#
####......#
#....#....#
#.##......#
d....e....#
#.........#
#.........#
#.........#
#.........#
#####D#####
boss
enemies 1

2
5
#####D#####
#.........#
#.........#
#.........#
#.........#
D.........#
#.........#
#.........#
#.........#
#........X#
###########

