2
1
#####D#####
#.........#
#..#...#.##
#.........#
#..#.#.#..#
#.........D
#......#..#
#.........#
##.#...#.##
#.........#
#####d#####

2
2
#####D#####
#.........#
#.........#
#.....#..##
#.........#
D.........D
#......#..#
#.........#
#.........#
#..#......#
###########

5
2
#####D#####
#.........#
#......#..#
#......#..#
#.........#
d....e....#
#.........#
#.........#
#.........#
#.........#
#####D#####
boss
enemies 1

6
1
#####l#####
#.........#
#.........#
#.........#
#.........#
#.........D
#.........#
#.........#
#.........#
#.........#
###########
locked : 3

0
1
###########
#k#.....#.#
#.........#
#.........#
#.....#...#
D.........D
#.........#
#.#..#..#.#
#.........#
#.........#
#####l#####
key : 0

2
3
#####D#####
#.........#
#.#.#.....#
###.......#
#..#......#
D..#####..#
#.........#
#....####e#
#.#.......#
#......?se#
###########
enemies 2
switch 0 : 0
sign A useful tool lies just ahead.

1
3
###########
#..#k....##
#.........#
##...#.#.##
#.........#
D..#.#....d
#.........#
#..#.....##
#.........#
##.#......#
#####D#####
key : 3

4
1
#####D#####
#.#.....#.#
#.........#
#.#.#.#.#.#
#.........#
#...#.....D
#.........#
#.#.#.#.#.#
#.........#
#.#.......#
#####d#####

1
1
#####l#####
#.........#
##.#......#
###.......#
#.........#
#.........D
#.........#
#.........#
#.........#
#.........#
#####D#####
locked : 0

0
2
###########
#.........#
#.........#
#.........#
#.........#
D.........#
#.........#
#.......#.#
#......#..#
#.........#
#####D#####

3
1
#####d#####
#.........#
#..#......#
#.#.......#
#.........#
#.........#
#.........#
#.#.......#
#..#......#
#.........#
#####D#####

5
1
#####d#####
#........##
#.........#
#.........#
#..#..#...#
#.........d
#.........#
#..#......#
#.........#
#.........#
#####l#####

0
0
###########
#?........#
#.........#
#.........#
#.........#
#....@....D
#.........#
#.........#
#.........#
#.........#
###########
sign What you seek is close.

1
4
#####D#####
#..#.....##
#.........#
#.........#
#..#..#...#
d.........#
#.........#
#..#..#..##
#.........#
#.........#
###########

4
2
###########
#.......#.#
#.........#
#..#.#.#..#
#.........#
D...#.#...D
#.........#
#......#.##
#.........#
#k#.....#.#
#####D#####
key : 4

1
2
#####D#####
#.........#
#.........#
#.........#
#.........#
D.........D
#.........#
#.........#
#.........#
#.........#
#####D#####

4
3
###########
##.....#?e#
#.........#
#.........#
#...#..#..#
D.........#
#.........#
##..#..#..#
#.........#
#........e#
###########
enemies 2
door 0 : 0
sign Those who search shall find.

6
2
#####D#####
#.........#
#.........#
#......##.#
#.....###.#
D.....##..#
#......#..#
#........p#
#...p.....#
#........X#
###########

0
4
###########
##.......k#
#...#...#.#
#.........#
#..#.#....#
#...#.#...#
#.......#.#
#.....###.#
#...#.##..#
#.........#
#####D#####
key : 6

