4
2
#####.#####
#.........#
#.........#
#..#..#...#
#.........#
d..........
#...#..#..#
#.........#
#.........#
#..#.....##
#####.#####

5
2
#####.#####
#.........#
#......#..#
#.......#k#
#.........#
..........#
#.........#
#.......#.#
#......#..#
#.........#
#####.#####
key : 2

3
2
#####d#####
#.........#
#.........#
#...#.....#
#.##.#....#
...#.......
#.####....#
###.#.....#
#.........#
#.......#.#
#####.#####

0
0
###########
#.......#.#
#.........#
#..#...#.##
#.........#
#...#.....#
#.........#
#..#.....##
#.........#
#.#.....#.#
#####.#####

2
0
#####l#####
#.........#
#.........#
#.........#
#.........#
#k.........
#.........#
#.........#
#.........#
#.........#
#####.#####
key : 0

6
2
#####.#####
#.#.......#
#..#......#
##.#......#
#...#.#...#
...##.#...#
#..##.##..#
#.....#...#
#..#..##..#
#.........#
###########

3
1
#####l#####
#e.......e#
#.#.....#.#
#.........#
#.........#
...#..#....
#.........#
#.........#
#.......#.#
#e.......?#
#####.#####
enemies 3
sign This door will not yield without a key.

2
1
#####.#####
#.........#
#......#..#
#.......#.#
#.........#
...........
#.........#
#.......#.#
#......#..#
#.........#
#####l#####
locked : 0

4
3
#####.#####
#.........#
#......#..#
#.......#.#
#.........#
..........#
#.........#
#.........#
#.........#
#.........#
###########

1
1
###########
#.........#
#.........#
#.........#
#.........#
d..........
#.........#
#.........#
#.........#
#.........#
#####.#####

4
0
#####.#####
#.#.......#
#.........#
#.........#
#.#..#..#.#
#..........
#.........#
#.#..#..#.#
#.........#
#k........#
###########
key : 1

4
1
#####.#####
#.........#
#.#.#.#.#.#
#.........#
#....#.#..#
..........d
#...#...#.#
#.........#
#..#...#.##
#.........#
#####.#####

2
2
#####.#####
#.........#
#.........#
#.........#
#.........#
.....e....#
#.........#
#.........#
#.........#
#.........#
#####d#####
boss
enemies 1

3
3
###########
#........k#
#.........#
#.........#
#.........#
.....#....#
#.........#
#.........#
#.#.....#.#
#.........#
#####.#####
key : 4

6
1
#####d#####
#.........#
#.........#
#.........#
#.........#
#..........
#.........#
#.#.....#.#
#..#...#..#
#.........#
###########

1
2
###########
#.##.....X#
#...#.#...#
#...#.....#
#...##....#
..........#
#.........#
##........#
#.........#
#.........#
#####.#####

1
0
#####.#####
##.....#..#
#.........#
#.........#
#.#..#..#.#
#.........d
#.........#
##.....#..#
#.........#
#.........#
#####l#####
locked : 1

5
1
#####.#####
#.........#
#.........#
#.........#
#.........#
#..........
#..#......#
#.#.......#
#.#.......#
#.........#
#####d#####

3
0
#####.#####
#.........#
#.........#
#.........#
#...##....#
#?...@.....
#.........#
#..#......#
#.........#
#.........#
#####.#####
sign Those who search shall find.

