1
0
###########
#.........#
#......#..#
#.......#.#
#.......#.#
#.........D
#.........#
#.#.....#.#
#..#...#..#
#.........#
#####l#####
locked : 2

4
0
#####D#####
#.........#
#.........#
#.........#
#.........#
#.........#
#.........#
#.......#.#
#......#..#
#k........#
###########
key : 0

3
2
#####D#####
#......#..#
#.........#
#.......#.#
#.........#
D.........D
#.........#
#.........#
#.........#
#....k....#
###########
key : 1

2
1
#####D#####
#.........#
#.........#
#.........#
#.##.#....#
D..#......d
#.##......#
#..#k#....#
#..##.....#
#.........#
#####D#####
key : 2

0
4
###########
#e.......e#
#.#.#.....#
#.........#
#....#.#..#
#.........#
#.#.#.#.#.#
#.........#
#........##
#.........#
#####D#####
enemies 2
door 0 : 0

1
1
###########
#.........#
#.........#
#........p#
#....####.#
D....###..D
#....####.#
#...#.....#
#..p....#.#
#.........#
#####D#####

1
4
#####D#####
#s........#
#.........#
#.........#
#.........#
D........e#
#..#......#
#.........#
#.........#
#.........#
#####D#####
enemies 1
switch 0 : 0

3
3
#####l#####
#.#.......#
#.........#
#.........#
#..#..#...#
D.........D
#.........#
#.#..#..#.#
#.........#
#.........#
###########
locked : 3

2
4
#####D#####
#.........#
#.........#
##........#
#.........#
d.........d
#.........#
#.........#
#.........#
#.........#
#####l#####

3
0
#####D#####
#.#.......#
#.##......#
#.###.....#
#.#.#.....#
#....@....D
#.........#
#.........#
#.........#
#.........#
#####D#####

2
5
###########
#.......p.#
#.........#
#p#.##....#
#.###.....#
d..####...#
#.#.......#
#..#..#...#
#.........#
#.........#
###########

1
2
###########
#.........#
#.........#
#....##.#.#
#.....#...#
D...###...D
#..#..##..#
#..##.#...#
#.........#
#.........#
#####d#####

3
1
#####D#####
#.........#
#.........#
#.........#
#.#..#..#.#
D.........D
#.........#
#...#.....#
#.........#
#.........#
###########

1
3
###########
#......#..#
#......#..#
#.....##..#
#.........#
D.........D
#.........#
#.........#
#.........#
#.........#
#####D#####

4
4
#####D#####
#..#......#
#.........#
#...#.....#
#...#.#...#
#..###.#..#
#..#.#....#
#..#.####.#
#.....##..#
#X........#
###########

2
0
#####l#####
#.#.....#.#
#.........#
#.........#
#.........#
#.........D
#.........#
#.#..#..#.#
#.........#
#.........#
#####D#####

2
2
#####d#####
#.........#
#......#..#
#.......#.#
#.........#
d.........D
#.........#
#.........#
#.........#
#.........#
#####D#####

2
3
#####D#####
#k........#
#.#.#.#.#.#
#.........#
#..#.#.#..#
D.........d
#.#...#.#.#
#.........#
#......#..#
#.........#
#####l#####
key : 3

3
4
#####l#####
#.........#
#.........#
#........##
#.........#
D....e....#
#..##.....#
#.##......#
#.###.....#
#........##
#####D#####
locked : 0
boss
enemies 1

