2
1
#####d#####
#.........#
##........#
##.#.#....#
#.####....#
...##......
#.##......#
#.........#
#.........#
#.........#
#####.#####

1
6
###########
#........X#
#.........#
#..#...#..#
#...#.#...#
....#.##..#
#..#.#.#..#
#.........#
#.........#
#.........#
###########

3
1
#####.#####
#..#......#
#..#......#
#.#.......#
#.........#
#..........
#.........#
#.......#.#
##.....#..#
#k........#
###########
key : 0

2
0
#####.#####
#.........#
###.......#
#.#.......#
#.###.....#
#...#@.....
#.#.#.....#
#..#..#...#
#.###.....#
#.........#
###########

2
3
#####.#####
#k........#
#......#..#
#.......#.#
#.........#
...........
#.........#
#.........#
#.........#
#.........#
#####l#####
key : 2

2
2
#####.#####
##........#
##........#
#.........#
#.........#
...........
#.........#
#.......#.#
#.#....#..#
#.........#
#####l#####

3
2
#####l#####
#..#......#
#.........#
#.#.##....#
#...#.....#
.....#.....
#.##.#....#
#...#.....#
#.........#
#.........#
###########
locked : 0

2
5
#####.#####
#.........#
##..#.....#
#.........#
#.........#
d....#....#
#.........#
#.........#
##..#..#..#
#.........#
###########

1
5
#####.#####
#.........#
#.........#
#.........#
#.........#
d....e.....
#.........#
#.........#
#.........#
#.........#
#####.#####
boss
enemies 1

2
4
#####.#####
##.#.....##
#.........#
#.#.#...#.#
#.........#
...#.#.#..d
#.........#
#.#.#.#.#.#
#.........#
##.#...#.##
###########

0
5
###########
#.......ee#
#.#......?#
#.........#
#.........#
...#..#...#
#.........#
#.........#
#.#.....#.#
#.........#
#####.#####
enemies 2
sign A useful tool lies just ahead.

1
0
###########
#.........#
#.........#
#.........#
#.........#
#..........
#.........#
#.#.......#
#..#......#
#.........#
#####.#####

0
4
###########
##k#...#.##
#.........#
##.#.#....#
#.........#
...#.#.....
#.........#
##...#.#..#
#.........#
##.#.....##
#####.#####
key : 4

1
1
###########
#.........#
##.....#.##
#.........#
#.#.#.#.#.#
...........
#..#.#.#..#
#.........#
#...#...#.#
#.........#
#####d#####

0
3
###########
#.........#
#..#...#..#
#.........#
#.#.#.#.#.#
#..........
#..#.#....#
#.........#
#...#.#.#.#
#.........#
#####d#####

1
4
#####.#####
#.........#
#........##
#.........#
#.........#
..........d
#.........#
#......##.#
#......#..#
#.........#
#####.#####

1
3
#####d#####
#.........#
#.........#
#.........#
#.........#
...........
#.........#
#.........#
#.........#
#.........#
#####.#####

3
3
#####l#####
#.........#
#.........#
#.........#
#.........#
..........#
#.........#
##........#
#.........#
#.........#
###########
locked : 1

1
2
###########
#..k......#
#..#...#..#
#.#.....#.#
#.........#
...........
#.........#
#.#.......#
#..#......#
#.........#
#####.#####
key : 1

