6
2
#####D#####
#.........#
#.........#
#.........#
#.........#
#.........#
#.........#
#.........#
#e........#
#e?......e#
###########
enemies 3
door 0 : 0
sign Many have walked this path.

4
2
#####D#####
##.#...#.##
#k........#
##.#.#...##
#.........#
D..#...#..D
#.........#
#..#.#.#..#
#.........#
##.#.....##
#####d#####
key : 2

4
0
#####D#####
#.........#
#.#...#.#.#
#.........#
#..#.#.#..#
#.........D
#...#.#.#.#
#.........#
#..#...#..#
#.........#
#####D#####

4
1
#####D#####
#e........#
#.#.#.#.#.#
#.........#
#.#.#.#.#.#
D.........D
#...#.#.#.#
#.........#
#.#.#...#.#
#s........#
#####D#####
enemies 1
switch 0 : 0

3
3
#####d#####
#..#......#
#.........#
#.........#
#...#..#..#
d.........D
#.........#
#..#......#
#.........#
#.........#
#####D#####

3
2
#####D#####
#.........#
#......#..#
#.......#.#
#.........#
D.........d
#.........#
#.........#
#.........#
#.........#
#####D#####

1
3
#####D#####
#.........#
#.........#
#.........#
#.........#
#....e....#
#.........#
#.........#
#.........#
#.........#
#####d#####
boss
enemies 1

5
0
#####D#####
#.........#
#.........#
#...#.....#
#..#.##...#
#..#..#...l
#...#.....#
#.........#
#.........#
#k........#
###########
key : 1

4
3
#####D#####
#.........#
#.........#
#.........#
#.........#
D.....#...#
#.........#
#.#.....#.#
#..#...#..#
#.........#
###########

0
3
###########
#X........#
#.........#
#.........#
#.........#
#.........#
#.........#
#.........#
#.........#
#.........#
#####D#####

2
3
#####d#####
#......#..#
#.........#
#.......#.#
#...#.#...#
D...###...#
#...#.....#
#.........#
#..#......#
#.........#
#####d#####

2
1
###########
#.........#
##.....#..#
#.........#
#.........#
D.........D
#.........#
#.........#
##..#..#..#
#.........#
#####D#####

5
1
#####D#####
#..#.....##
#.........#
#.........#
#......#..#
l.........D
#.........#
#........##
#.........#
#.........#
###########
locked : 1

3
4
###########
#........k#
#.........#
#.........#
#.........#
D.........#
#.........#
#.#.......#
#..#......#
#.........#
###########
key : 5

3
0
#####D#####
##........#
#..#...#..#
#.#.....#.#
#.........#
#.........D
#.........#
#.##......#
#..#......#
#.........#
#####D#####

2
2
###########
#e...e....#
#.........#
#.........#
#.........#
D.........D
#.........#
#.........#
#.........#
#.........#
#####D#####
enemies 2

5
2
#####d#####
#.........#
#.........#
#.........#
#.........#
D.........#
#.........#
#.........#
#.........#
#.........#
#####D#####

2
0
###########
#.##......#
#..##.#...#
#..##.....#
#..#@##...#
#....#....D
#.........#
#.........#
#.........#
#.........#
#####D#####

3
1
#####D#####
#.........#
#.........#
#.........#
#.........#
D.........D
#..###....#
#...k#....#
#...#.....#
#.........#
#####D#####
key : 0

