2
3
#####d#####
#e........#
#.........#
#.........#
#.........#
...#...#..d
#..#......#
#.........#
#.........#
#.........#
#####.#####
enemies 1

4
2
#####.#####
#.........#
#.........#
#.........#
#.........#
.........k#
#.........#
#.........#
#.........#
#.........#
#####l#####
key : 2

5
0
#####.#####
#.........#
#..#......#
#.#.#.....#
#.........#
#.........#
#.........#
#.........#
#.....#...#
#.........#
###########

1
3
#####.#####
#.........#
#.........#
#.........#
#.........#
.....e....#
#.........#
#.........#
#.........#
#.........#
#####d#####
boss
enemies 1

0
3
###########
#X........#
#.........#
#.........#
#..##.....#
#..#......#
#.#.#.....#
#...#.....#
#.###.....#
#.........#
#####.#####

3
0
#####.#####
#.........#
#.........#
#.........#
#.........#
#....#.....
#.........#
#k#.....#.#
#..#...#..#
#.........#
#####.#####
key : 1

2
0
#####.#####
#.........#
#..#...#..#
#.#.....#.#
#.........#
#.........#
#.........#
#.......#.#
#......#..#
#.........#
#####.#####

2
4
###########
#.........#
#.........#
#..#.#.#.##
#.........#
d...#......
#.........#
#..#.#.#.##
#.........#
#.#.....#.#
###########

0
0
###########
#..#.....##
#.........#
#.....#.#.#
#.........#
#..#...#..#
#.........#
#.#.#...#.#
#.........#
##.#...#.##
#####.#####

4
1
#####d#####
#.........#
#.........#
##........#
#.#.##....#
....##.....
#.#.##....#
###.##....#
##........#
#k........#
###########
key : 0

4
0
#####.#####
#.........#
#.........#
#.........#
#...@#?#..#
#....##....
#......#..#
#.........#
#.........#
#.........#
#####.#####
sign Those who search shall find.

5
2
#####l#####
#.#.......#
#.........#
#....#....#
#.........#
#.........#
#.....#...#
#.#.......#
#..#......#
#.........#
###########
locked : 1

3
1
###########
#.........#
#.........#
##..#..#..#
#.........#
...........
#.#..#..#.#
#.........#
#.........#
##........#
#####d#####

3
3
#####.#####
#.........#
#......#..#
#.......#.#
#.........#
d.........#
#.........#
#.#.....#.#
#..#...#..#
#.........#
###########

1
2
###########
#.........#
#......#..#
#.......#.#
#.........#
#..........
#.........#
#...#.....#
#.........#
#..#......#
#####.#####

1
0
#####.#####
#.........#
#.........#
####......#
#e#s......#
#.?##.....#
#.........#
#.........#
#.........#
#.........#
#####.#####
enemies 1
switch 0 : 0 1
sign The dungeon remembers all who enter.

2
5
###########
#......e.e#
#.....?#..#
#.....##..#
#.........#
..........#
#.........#
#.........#
#.........#
#........e#
###########
enemies 3
door 0 : 0 1
sign Many have walked this path.

2
2
#####.#####
#.........#
#..#......#
#k#.......#
#.........#
#..........
#.........#
#.......#.#
#......#..#
#.........#
#####.#####
key : 3

3
2
#####.#####
##........#
#.##......#
#..#......#
#..#......#
...#......d
#.#.......#
#.#.#.....#
##.#......#
#.........#
#####.#####

