5
0
#####D#####
#.#.....#.#
#.........#
#.#.#.#.#.#
#.........#
#...#.#...D
#.........#
#.#.#.#...#
#.........#
#.......#.#
###########

4
3
###########
#.........#
#..#......#
#.#.......#
#.........#
D.........#
#.........#
#.......#.#
#......#..#
#.........#
###########

4
0
#####D#####
#.........#
#.........#
#..####...#
#...@###..#
#..###?#..D
#...#.....#
#...#.....#
#.........#
#.........#
#####D#####
sign Those who search shall find.

3
4
#####D#####
#.........#
#.........#
#.........#
#.........#
#.........#
#..#.##...#
#..#......#
#.........#
#X........#
###########

3
0
###########
##........#
#k........#
#.........#
#.........#
#.........D
#.........#
#.........#
#.........#
#.........#
#####D#####
key : 0

5
1
#####l#####
#..#......#
##..#.....#
#.#.......#
#.#.##.##.#
D...##.#..D
#.###.###.#
#.......#.#
#.....#.#.#
#.........#
###########
locked : 0

3
2
#####D#####
#.........#
#..#......#
#.#.......#
#.........#
D.........#
#.........#
#.#.......#
#..#......#
#.........#
#####D#####

2
3
#####D#####
#k#.......#
#.........#
#....####.#
#...#.###.#
D.....##..D
#.....##..#
#...#.##..#
#.........#
#.........#
###########
key : 4

1
3
#####D#####
#.........#
#.........#
#.#.#.....#
#.........#
D.........d
#.........#
#.........#
#.........#
#.........#
#####D#####

1
5
###########
#.........#
#.........#
#.........#
#.........#
d.........#
#..#......#
###.......#
##.#......#
#.........#
###########

4
2
#####D#####
#.........#
#.........#
#...#...#.#
#.........#
l.........D
#.........#
#.........#
#.........#
#.........#
#####d#####
locked : 1

1
2
###########
#.........#
#..##.##..#
#...##....#
#..##.##..#
#......#..D
#.....#...#
#.........#
#.........#
#.........#
#####D#####

5
2
#####d#####
#.......#.#
#.........#
#.#...#.#.#
#.........#
D...#.#...#
#.........#
#...#.#.#.#
#.........#
#.#.......#
###########

3
1
###########
#.........#
#.###.....#
#.#.##....#
#.#.##....#
D.........D
#.........#
#.........#
#.........#
#.........#
#####d#####

4
1
#####d#####
#.........#
#.........#
#..#.#....#
#.........#
D...#.....l
#.........#
#..#.#.#.##
#.........#
#k#.....#.#
#####l#####
key : 1

0
3
###########
#e.......?#
#.........#
#.........#
#..#......#
#..#......#
#.#.#.....#
#.#.......#
#...#.....#
###.......#
#####D#####
enemies 1
sign The dungeon remembers all who enter.

2
2
#####D#####
#.........#
#.........#
#.........#
#.........#
#.........D
#.........#
#k#.......#
#..#......#
#.........#
#####D#####
key : 2

1
4
###########
#.........#
#......#..#
#.......#.#
#.........#
d.........d
#.........#
#.#.......#
#..#......#
#.........#
#####l#####

2
4
#####l#####
#.........#
#.........#
#.........#
#.........#
D....e....#
#.........#
#.........#
#.........#
#.........#
#####D#####
locked : 4
boss
enemies 1

