2
3
#####.#####
#.........#
#..#......#
#.#.......#
#.........#
..........#
#.........#
#.#.......#
#..#......#
#.........#
#####.#####

1
0
#####.#####
#.........#
#.........#
#.........#
#......##.#
#..#.@##..#
#..#...#..#
#.##.#....#
#..#..#...#
#?##......#
#####.#####
sign The dungeon remembers all who enter.

1
3
###########
#.........#
#.........#
#.........#
#.........#
d....#.#..#
#.....##..#
#.....##..#
#.........#
#.........#
#####.#####

2
2
#####.#####
#.........#
#.........#
#..#..#..##
#.........#
d..........
#..#..#...#
#.........#
#.........#
#..#.....##
#####l#####

4
4
#####.#####
#.........#
#.........#
#.........#
#....###..#
...#.#k...#
#....###..#
#..#####..#
#.....##..#
#.........#
#####.#####
key : 7

0
0
###########
#.........#
##..#.....#
##........#
#.#.......#
#.........#
#..#...##.#
#......#..#
#.....#.#.#
#.........#
#####.#####

3
2
#####l#####
#.........#
#..#...#..#
#.#.....#.#
#.........#
...........
#.........#
#.........#
#.........#
#.........#
#####d#####
locked : 0

5
3
#####l#####
#.........#
#...#..##.#
#...#..#..#
#....#.#..#
#....e#....
#....##.#.#
#.........#
#.........#
#.........#
#####.#####
locked : 3
boss
enemies 1

6
3
#####.#####
#.........#
#.........#
#......#..#
#.........#
#.........#
#.........#
#e........#
##........#
#e.......e#
###########
enemies 3
door 0 : 0

1
2
###########
#es?......#
#e##......#
#...#.....#
#.#.......#
#.........d
#.........#
#.#.......#
#.........#
#.........#
#####.#####
enemies 2
switch 0 : 0
sign The dungeon remembers all who enter.

2
0
#####.#####
#.........#
#.#.....#.#
#.........#
#.#.#.#...#
#..........
#.#.#...#.#
#.........#
#.#.#.#.#.#
#.........#
###########

4
1
#####.#####
#.........#
#.........#
#.........#
#..#......#
#..........
#...#.....#
#.#.......#
#..#......#
#k........#
###########
key : 3

2
1
###########
#....k....#
#.........#
#.........#
#.........#
..........d
#.........#
#.........#
#.........#
#.........#
#####.#####
key : 0

3
1
#####.#####
#..#.....##
#.........#
#.........#
#...#.....#
#..........
#.........#
#........##
#.........#
#.........#
#####.#####

4
3
#####l#####
#.........#
#.....##..#
#....#.#..#
#.......#.#
.....#.#...
#....#.##.#
#.........#
#.........#
#.........#
#####l#####
locked : 4

4
2
#####d#####
#......##.#
#.........#
#....#.#.##
#....###..#
...........
#..##.....#
#.........#
#.........#
#.........#
###########

5
4
#####.#####
#.........#
#.........#
#.........#
#.........#
...##.....#
#...#.....#
##.#......#
#.........#
#........X#
###########

3
3
#####.#####
#k........#
#.........#
#.........#
#.........#
..........d
#.........#
#.........#
#.........#
#.........#
#####l#####
key : 4

3
4
###########
#.........#
#.#.#...#.#
#.........#
#...#.#.#.#
d.........#
#.#.#...#.#
#.........#
#...#.#.#.#
#.........#
#####.#####

