2
1
#####d#####
#.........#
#.........#
#.........#
#.........#
D.........#
#.........#
#.........#
#..#......#
#.........#
#####D#####

2
3
#####d#####
#.........#
#..#...#..#
#.#.....#.#
#.........#
#.........D
#.........#
#.#.......#
#..#......#
#.........#
#####D#####

0
3
###########
#X........#
#.........#
#..#......#
#.........#
#..#.##...#
#.##.##...#
#....#....#
#.....#...#
#.........#
#####D#####

2
4
###########
#.........#
#..#..#...#
#.#.......#
#.........#
D.........#
#.........#
#.........#
#.........#
#.......#k#
###########
key : 5

5
0
#####D#####
#.........#
#.........#
#.........#
#.........#
#?...@....D
#.........#
#.........#
#.........#
#.........#
#####D#####
sign Something glints behind that door…

5
2
#####D#####
#......#..#
#.........#
#.........#
#.........#
D.........#
#.........#
#.......#.#
#......#..#
#........k#
###########
key : 2

4
0
#####D#####
#........##
#..#......#
#k#.......#
#.........#
#..#......D
#.........#
#.#.......#
#..#......#
#.........#
#####D#####
key : 0

6
0
#####D#####
#.........#
#...#.#...#
#..#.#....#
#.....#...#
#..#.#....D
#.........#
#.........#
#.........#
#.........#
###########

4
2
#####D#####
##.....#.##
#.........#
##.#.#.#.##
#.........#
d..#.#.#..#
#.........#
#..#.#.#.##
#.........#
#..#...#.##
#####D#####

3
0
#####D#####
#.........#
##..#..#..#
#.........#
#.........#
#....#....d
#.........#
#.........#
##.....#..#
#.........#
#####D#####

1
3
#####D#####
#.........#
#.........#
#.........#
#....#....#
#...#e....#
#.#####...#
#...#.....#
#.....#...#
#.##......#
#####d#####
boss
enemies 1

3
2
###########
#.........#
##..#..#..#
#.........#
#.........#
l....#....D
#.........#
#.........#
##..#.....#
#.........#
#####D#####
locked : 2

4
1
#####D#####
#.#.....#.#
#.........#
#.#.#.#...#
#.........#
D.....#...d
#.........#
#.#.#.....#
#.........#
#.#.......#
#####l#####
locked : 0

3
1
#####D#####
#.......#.#
#.........#
#......#..#
#.........#
d...#.#...l
#.........#
#..#.....##
#.........#
#.......#.#
#####D#####

6
1
#####D#####
#.........#
##........#
#.........#
#.........#
D...#.....#
#.........#
#.........#
##..#.....#
#.......ee#
###########
enemies 2

2
0
###########
#.........#
#.........#
#.........#
#.........#
#.........D
#.........#
#.........#
#.........#
#p........#
#####D#####

1
1
###########
#.........#
#.#...#.#.#
#.........#
#.#.#...#.#
#.........#
#...#.#.#.#
#.........#
#...#.#...#
#.........#
#####d#####

3
3
#####D#####
#.........#
#.........#
#.........#
#.........#
D.........#
#.........#
#.........#
#.........#
#.........#
###########

5
1
#####l#####
#k........#
#.....#...#
#...#.....#
#...#.#...#
D.........D
#.........#
#.........#
#.........#
#.........#
#####D#####
key : 1

