2
3
###########
#.........#
#......#..#
#..#....###
#.........#
d.........#
#.........#
#.#.......#
#..#......#
#.........#
#####l#####

2
2
#####.#####
#.........#
#..#...#..#
#.#.....#.#
#.........#
..........d
#.........#
#.........#
#.........#
#.........#
#####.#####

2
0
#####.#####
#..#......#
#.###.....#
#..##.....#
#..##.....#
#...#@.....
#.........#
#?#.#.....#
#.........#
#.........#
#####.#####
sign Those who search shall find.

3
3
#####l#####
#.........#
#...#.#.#.#
#...#.#...#
#...#.#.#.#
.....e.....
#.........#
#.........#
#.........#
#.........#
#####.#####
locked : 3
boss
enemies 1

3
4
###########
#........e#
#.........#
#.........#
#.##......#
..........#
#.........#
#.........#
#.........#
#.........#
###########
enemies 1

4
0
#####.#####
#.........#
##.....#.##
#.........#
#.#.#.#...#
#..........
#....#.#..#
#.........#
#...#.#.#.#
#k........#
###########
key : 2

0
1
###########
#.........#
#.........#
#.........#
#.........#
..........#
#.........#
#.........#
#.........#
#.........#
#####d#####

1
2
###########
#.........#
#..#...#.##
#.........#
#.#.#.#.#.#
..........#
#......#..#
#.........#
#.#.#...#.#
#.........#
#####.#####

3
2
#####.#####
#.........#
#......#..#
#.........#
#.#.......#
...........
#.........#
#......#..#
#.........#
#.........#
#####.#####

4
1
#####.#####
#.........#
#.........#
#.........#
#.........#
.....###...
#......#..#
#......#..#
#.........#
#....k....#
###########
key : 3

4
3
#####.#####
#.........#
#...#.....#
#...##....#
#.........#
..........#
#.##......#
#.#.......#
##.#......#
#........X#
###########

2
1
#####.#####
#.........#
#.#.#...#.#
#.........#
#..#.#.#..#
...........
#...#...#.#
#.........#
#......#.##
#........k#
#####.#####
key : 0

1
1
#####d#####
#.........#
#.....#...#
#....#.#..#
#.........#
d..........
#.........#
#.........#
#.........#
#.........#
#####.#####

4
2
#####.#####
#e........#
#.........#
#....#..#.#
#.........#
...........
#....#....#
#.........#
#.........#
#e..?e....#
###########
enemies 3
sign What you seek is close.

0
0
###########
#.........#
#..#...#..#
#.#.....#.#
#.........#
#..........
#.........#
#.........#
#.........#
#.........#
#####l#####
locked : 0

3
0
#####.#####
#.........#
#.........#
#.........#
#.........#
#..........
#.........#
#.........#
#.........#
#.........#
#####.#####

3
1
#####.#####
#k#.....#.#
#.........#
#......#.##
#.........#
....#.#....
#.........#
#..#.#...##
#.........#
#.#.....#.#
#####.#####
key : 1

1
0
#####l#####
#.........#
#.........#
#.....#.###
#....#..#.#
#....###..d
#.....##..#
#....######
#.........#
#.........#
#####.#####

