6
1
#####D#####
#.........#
#.........#
#.........#
#.........#
D..##.....D
#...#?....#
#...##....#
#..##e....#
#..ee.....#
###########
enemies 3
sign The dungeon remembers all who enter.

3
0
#####D#####
##.....#..#
#.........#
#.........#
#.#.....#.#
#.........l
#.........#
#...#..#..#
#.........#
#.........#
#####D#####

1
1
#####D#####
#.........#
#.........#
#.........#
#...e...#.#
d....#....#
#....###..#
#.......###
#.....#...#
#.........#
#####D#####
boss
enemies 1

0
1
###########
#X........#
#.........#
#.........#
#.........#
#..#.#....#
#..###....#
##.##.....#
####......#
#.........#
#####D#####

5
1
#####D#####
#.........#
#.........#
#.........#
#.........#
D.........D
#.........#
#.........#
#.........#
#.........#
#####D#####

6
0
#####D#####
#.........#
#.........#
#.........#
#.........#
#?...@#...D
#.......#.#
#.....##..#
#.........#
#.........#
#####D#####
sign Those who search shall find.

4
1
#####D#####
#..#...#.##
#.........#
#.#.#.#.#.#
#.........#
d..#......D
#.........#
#.#.....#.#
#.........#
#..#...#..#
#####D#####

4
2
###########
####......#
####......#
##.#.#....#
#...##....#
D...##....#
#.........#
#.........#
#.....#...#
#.........#
#####d#####

1
0
###########
#.........#
#.###.....#
#...#.....#
#....#....#
#..##.....d
#.###.....#
#.........#
#.........#
#.........#
#####l#####
locked : 4

2
1
#####D#####
#.........#
#.........#
#.........#
#.........#
D.........#
#.........#
#.#.....#k#
#..#...#..#
#.........#
#####D#####
key : 5

6
2
#####D#####
#........e#
#..#..#..##
#........s#
#........?#
D...#..#..#
#.........#
#.........#
#..#..#..##
#........e#
#####d#####
enemies 2
switch 0 : 0 1
sign Many have walked this path.

5
3
###########
#........e#
#.........#
#.........#
#.........#
D.........#
#.........#
#.........#
#.........#
#........e#
###########
enemies 2
door 0 : 0 1

3
1
#####D#####
#.........#
#.........#
##...#....#
#.........#
l...###...#
#..##.##..#
#......#..#
#..##.#...#
#..#...#..#
#####D#####
locked : 1

5
2
#####d#####
#.........#
#......#..#
#.......#.#
#.........#
D.........D
#.........#
#.........#
#.........#
#.........#
#####D#####

7
2
#####d#####
#.........#
#......#..#
#.......#.#
#.........#
#.........#
#.........#
#.......#.#
#......#..#
#.........#
###########

4
0
#####D#####
#k........#
##..#.....#
#.........#
#.........#
#...#..#..d
#.........#
#.........#
##.....#..#
#.........#
#####D#####
key : 1

7
0
#####D#####
#.......#.#
#.........#
#..#.#.#.##
#.........#
#...#.#...#
#.........#
#....#...##
#.........#
#k#.......#
###########
key : 0

2
0
#####l#####
#.........#
#......#..#
#.......#.#
#.........#
#k........D
#.........#
#.........#
#.........#
#.........#
#####D#####
key : 4

5
0
#####D#####
#..#......#
#.###.....#
#...#.....#
#....#....#
#....#.#..D
#.....#...#
#.........#
#.........#
#.........#
#####D#####

