3
0
#####.#####
#.........#
#......#..#
#....#?#..#
#....##.#.#
#....@#....
#.........#
#.........#
#.........#
#.........#
#####d#####
sign The walls are warm to the touch.

0
1
###########
#.........#
#.........#
#.........#
#.........#
#.........#
#.........#
#.........#
#.........#
#.........#
#####.#####

2
3
#####.#####
#.........#
#.........#
#.........#
#.........#
..........#
#.........#
#.........#
#.........#
#........X#
###########

2
1
#####.#####
#k........#
#.........#
#.........#
#.........#
...........
#.........#
#.........#
#.........#
#.........#
#####.#####
key : 0

5
1
#####.#####
#.........#
#..#......#
#.#.......#
#.........#
..........l
#.........#
#.......#.#
#......#..#
#.........#
#####.#####

1
2
###########
#e........#
##..#..#..#
#.........#
#.........#
.....#....d
#.........#
#.........#
##..#..#..#
#e........#
#####.#####
enemies 2
door 0 : 0

6
2
#####.#####
#.........#
#.........#
#.........#
#.........#
...##.....#
#.....#...#
#...#.#...#
#.#.#.#...#
#.#......e#
###########
enemies 1

5
2
###########
##........#
#.........#
#..#......#
#.........#
l.........#
#..###....#
#..#......#
#..##.....#
#.........#
#####.#####
locked : 3

7
0
#####l#####
#.##......#
#...#.#...#
#.#.###...#
#.######..#
#..#.#.#..#
#.........#
#.........#
#.........#
#.........#
###########
locked : 0

5
0
#####d#####
#.........#
#.#.#.#.#.#
#.........#
#..#.#....#
#..........
#.#...#...#
#.........#
#......#..#
#.........#
#####d#####

1
1
#####.#####
#e.#.....##
#.........#
#.........#
#e.#..#...#
#e.........
#s........#
#..#.....##
#.........#
#?........#
#####.#####
enemies 3
switch 0 : 0
sign Something glints behind that door…

4
0
#####d#####
#.........#
#.#.....#.#
#.........#
#.........#
#....#.....
#.........#
#.........#
#.........#
#.........#
#####d#####

2
2
#####.#####
#.........#
#.........#
#.........#
#.........#
...........
#.........#
#.........#
#.........#
#....k....#
###########
key : 1

2
0
###########
#.........#
#..#......#
#.#.......#
#..#......#
#..........
#.........#
#.#.....###
#..#..##..#
#.........#
#####.#####

3
1
#####.#####
#.........#
#......#..#
#.......#.#
#.........#
..........#
#.........#
#.........#
#.........#
#.........#
#####.#####

4
1
#####.#####
#.........#
#..#......#
#.#.......#
#.........#
.........k#
#.........#
#.........#
#.........#
#.........#
#####.#####
key : 8

6
0
#####d#####
#.........#
#......#..#
#.......#.#
#.........#
#..........
#.........#
#.#.......#
#..#......#
#.........#
#####l#####

1
3
###########
#.........#
#.........#
#...##....#
#....#.##.#
d....e.#..#
#...#..#..#
#...#.##..#
#.........#
#.........#
#####.#####
boss
enemies 1

6
1
#####.#####
#.........#
#.........#
#.........#
#.........#
...........
#.........#
#.#.......#
#..#......#
#..k......#
###########
key : 3

