3
2
#####.#####
#.#.....#.#
#.........#
#..#...#.##
#.........#
......#....
#.........#
#..#.#.#..#
#.........#
#.#.....#.#
#####l#####

4
1
#####.#####
#e........#
#.........#
#.#.......#
#..#......#
...........
#.........#
#.........#
#.........#
#e...e....#
###########
enemies 3

1
0
#####.#####
#.........#
#......#.##
#.......#.#
#.........#
#.........d
#.........#
#.#.....#.#
#..#...#..#
#.........#
#####d#####

3
4
#####.#####
#.........#
#.........#
#......#..#
#.........#
..........#
#...#..#..#
#.........#
#.........#
#......#.k#
###########
key : 4

1
1
###########
#.#.....#.#
#.........#
#...#.#...#
#.........#
d...#......
#.........#
#.#.#...#.#
#.........#
#.#.....#.#
#####.#####

1
3
#####.#####
#.........#
#.........#
###.#.....#
#.#..#....#
d...#e....#
#...#.....#
##...#....#
#.........#
#.........#
#####.#####
boss
enemies 1

0
3
###########
#X........#
#.........#
#.........#
#.........#
#....##...#
#....##.#.#
#....#.#.##
#........##
#.........#
#####.#####

2
1
#####.#####
####......#
#####.....#
###.......#
#..#...#..#
...........
#.........#
#.........#
#.........#
#.........#
#####.#####

0
0
###########
#k........#
#.........#
#.........#
#.........#
#.........#
#.........#
#.........#
#.........#
#.........#
#####.#####
key : 1

2
2
#####d#####
#e........#
#.#.......#
#.........#
#.........#
...#..#....
#.........#
#.........#
#.......#.#
#?........#
#####.#####
enemies 1
sign The dungeon remembers all who enter.

2
0
#####d#####
#e#.....#e#
#.........#
#e#...#.#.#
#.........#
#...#.#....
#.........#
#.#.#.#...#
#.........#
#.........#
#####.#####
enemies 3

4
0
#####.#####
#.........#
#..#......#
#.#.......#
#.........#
#..........
#.........#
#.......#.#
#......#..#
#.........#
###########

3
1
#####.#####
#e#.....#.#
#.........#
#.#.#.#...#
#.........#
......#....
#.........#
#.#.#.#.#.#
#.........#
#e#.....#.#
#####.#####
enemies 2

3
3
#####.#####
#.........#
#.........#
#.........#
#.........#
...#.......
#.........#
##........#
#..#......#
#..k......#
###########
key : 0

4
2
#####l#####
##.....#..#
#.........#
#.........#
#.#..#..#.#
..........#
#.........#
#......#..#
#.........#
#.........#
###########
locked : 0

1
2
###########
#.........#
#..#...#..#
#.#.....#.#
#.........#
..........d
#.........#
#.........#
#.........#
#.........#
#####d#####

2
3
#####.#####
#.........#
#..#......#
#.#.......#
#.........#
...........
#.........#
#.......#.#
#......#..#
#.........#
#####.#####

2
4
###########
#........k#
#.........#
##..#..#..#
#.........#
..........#
#......#..#
#.........#
#.........#
##.....#..#
#####.#####
key : 3

3
0
#####.#####
#.........#
#.##......#
#...#.....#
#?###.....#
#..#.@.....
#.........#
#.........#
#.........#
#.........#
#####.#####
sign The dungeon remembers all who enter.

