4
4
#####D#####
#.........#
#......##.#
#....#...##
#......##.#
#....#.#..#
#.........#
#.........#
#.........#
#X........#
###########

2
5
###########
#.#.....#.#
#.........#
#..#.#...##
#.........#
d...#.....#
#.........#
#..#...#.##
#.........#
#.......#.#
###########

2
4
###########
#.........#
#.........#
#.........#
#.........#
D......#..d
#.........#
#.#.#.....#
#..#......#
#.........#
#####d#####

0
0
###########
#........##
#.........#
#.........#
#.........#
#...#.....#
#.........#
#.........#
#.........#
#.........#
#####D#####

4
2
#####D#####
#.........#
#..#...#..#
#.#.....#.#
#.........#
#.........#
#.........#
#.........#
#.........#
#.........#
###########

3
0
#####D#####
#?........#
#.........#
#.........#
#.........#
#e........D
#.........#
#.........#
#.........#
#.........#
#####D#####
enemies 1
sign Those who search shall find.

2
1
#####D#####
#..#....#.#
#..##.##..#
#.#e.##e#.#
#..#.##...#
D.........D
#.........#
#.........#
#.........#
#.........#
#####D#####
enemies 2

3
2
#####D#####
#.........#
#.........#
#..#.#.#.##
#.........#
D.....#...d
#.........#
#....#.#.##
#.........#
#.#.......#
#####D#####

3
4
#####d#####
#.........#
#.........#
#.##.#....#
#...e.....#
D..#.#....#
#..#.#....#
##.#.#....#
#.........#
#.........#
#####D#####
boss
enemies 1

1
0
#####D#####
#......#..#
#.........#
#.........#
#...#.....#
#..##@#...D
#.#?###...#
#.........#
#.........#
#.........#
#####D#####
sign The dust is undisturbed here.

4
0
#####D#####
#.........#
#..#...#.##
#.........#
#..#...#..#
#.........#
#......#..#
#.........#
#..#...#..#
#k........#
###########
key : 1

2
0
#####D#####
#.........#
##.#...#..#
#.........#
#..#.#.#..#
#.........D
#..#.#.#..#
#.........#
##.#...#..#
#.........#
#####D#####

1
1
###########
#......#..#
#...#k#.p.#
#...###.#.#
#...###...#
D...##....D
#...##.p#.#
#.........#
#.........#
#.........#
#####D#####
key : 0

2
2
#####l#####
#.........#
#.........#
##.#.#..###
#.##.#..#.#
D....k#...D
#....#....#
#.....#.###
#.........#
#.........#
#####D#####
key : 2

1
2
###########
#.........#
##.#...#.##
#.........#
#.#...#...#
D.........l
#....#.#..#
#.........#
#.#.#.#.#.#
#.........#
#####l#####
locked : 1

3
1
#####D#####
#.........#
#..#......#
#.#.......#
#.........#
D.........D
#.........#
#.........#
#.........#
#.........#
###########

2
3
#####D#####
#k........#
#.........#
#.........#
#.........#
D.........D
#.........#
#.#.....#.#
#..#...#..#
#.........#
#####D#####
key : 3

1
3
###########
#.........#
#.........#
#.........#
#.........#
l..###....#
#.#.#.....#
##...#....#
#.........#
##.#......#
#####D#####
locked : 3

3
3
#####D#####
#.........#
#.........#
#.........#
#.........#
d.........D
#.........#
#.........#
#.........#
#.........#
###########

