3
2
#####d#####
#.........#
#..#...#..#
#.#.....#.#
#.........#
D.........D
#.........#
#.#.......#
#..#......#
#.........#
#####D#####

5
2
#####D#####
#.........#
#.........#
#.........#
#...##....#
#....###..D
#....#..#.#
#......####
#...#.###.#
#e..?.....#
###########
enemies 1
sign This door will not yield without a key.

5
4
#####D#####
#.........#
#.........#
#.........#
#.##......#
D..#.#....#
#.####....#
#..#.#....#
####......#
#........X#
###########

4
4
#####D#####
#.........#
#.........#
#.........#
#.........#
d....e....#
#.........#
#.........#
#.........#
#.........#
#####D#####
boss
enemies 1

2
0
#####d#####
#..#......#
#..#......#
#..e#.....#
#e#####...#
#se###....#
#..##.....#
#.........#
#.........#
#.........#
#####D#####
enemies 3
switch 0 : 0 1

4
2
#####D#####
#k........#
#..#...#..#
#.........#
#...#...#.#
D.........D
#..#.#.#..#
#.........#
#.#.#.#...#
#.........#
#####D#####
key : 3

5
3
#####l#####
#.........#
#.........#
#.........#
#.........#
D.........D
#.........#
#.........#
#..p......#
#.........#
###########
locked : 0

1
1
###########
#e...e....#
#.........#
#.........#
#.......p.#
D..p......D
#.........#
#.........#
#.........#
#....e....#
###########
enemies 3
door 0 : 0 1

2
2
#####D#####
#.........#
#.#.....#.#
#.........#
#..#.#.#..#
#.........l
#.#.#.#.#.#
#.........#
#......#.##
#.........#
#####d#####

1
2
###########
#.........#
##..#..#..#
#.........#
#.........#
D....#....#
#.........#
#.........#
##..#.....#
#.........#
#####D#####

2
3
###########
#.........#
#.....#...#
#....##...#
#.....#...#
l.........#
#.........#
#.........#
#.........#
#.........#
#####D#####
locked : 3

3
3
#####D#####
#k#.......#
#.........#
#..#.#...##
#.........#
D...#.....d
#.........#
#..#.#.#.##
#.........#
#.#.......#
#####D#####
key : 2

3
1
###########
#.........#
#.........#
#.....#..##
#.........#
D.........D
#..#..#...#
#.........#
#.........#
#..#.....##
#####D#####

3
4
###########
#.........#
#.........#
#.#..#..#.#
#.........#
d.........#
#.#..#..#.#
#.........#
#.........#
#.#.....#.#
#####D#####

4
1
#####D#####
#..#......#
#.........#
#.........#
#..#..#...#
#.........D
#.........#
#..#..#..##
#.........#
#k........#
###########
key : 0

0
0
###########
#.........#
#.........#
#.........#
#.........#
#.........#
#.........#
#.........#
#.........#
#.........#
#####D#####

1
0
#####D#####
#.........#
#.........#
#.........#
#.........#
#.........D
#.........#
##......#.#
#......#..#
#.........#
#####d#####

3
0
#####D#####
##.#......#
##........#
##.###....#
#...#.....#
#....@....D
#.........#
#.........#
#.........#
#.........#
###########

4
3
#####D#####
#k........#
#.#.......#
#.........#
#.........#
D..#..#...d
#.........#
#.........#
#.#.....#.#
#.........#
#####l#####
key : 4

