4
2
#####D#####
#.........#
#.#.#.#...#
#.........#
#.#.#.#.#.#
D.........D
#.#.#.#...#
#.........#
#.#.#...#.#
#.........#
#####l#####

3
1
#####l#####
##.#...#..#
#k........#
##.#...#.##
#.........#
D....#.#..D
#.........#
#..#...#.##
#.........#
#..#...#.##
#####D#####
key : 0

3
2
#####d#####
#......#k##
#.........#
##.....#.##
#.........#
D..#...#..D
#.........#
##.#.#.#..#
#.........#
#........##
#####D#####
key : 2

3
0
#####D#####
#.........#
##.#...#..#
#.........#
#..#.#.#..#
#.........D
#..#.#.#..#
#.........#
#..#...#.##
#.........#
#####d#####

1
1
#####D#####
#e........#
##.#...#..#
#.........#
#.#.#...#.#
D.........d
#....#.#..#
#.........#
#.#...#.#.#
#.........#
#####D#####
enemies 1

1
2
#####D#####
#.........#
#.........#
#.........#
#.........#
d....e....#
#.........#
#.........#
#.........#
#.........#
#####D#####
boss
enemies 1

4
3
#####D#####
#.........#
#.....#...#
#...#.....#
#...###...#
D.........#
#.........#
#.........#
#........e#
#......?ee#
###########
enemies 3
sign Beware what lurks ahead.

2
2
#####D#####
#.........#
#.........#
#.........#
#...#..#..#
D...####..#
#.........#
#...##.#..#
#......#..#
#.........#
#####d#####

0
1
###########
#k........#
##.#......#
#.........#
#.#.#.#.#.#
D.........D
#......#..#
#.........#
#.#.#.....#
#.........#
#####D#####
key : 3

0
0
###########
#.........#
#.........#
#.........#
#.........#
#.........D
#..#......#
#.#.......#
##........#
#.........#
#####d#####

3
3
###########
#.........#
#...#.....#
#.........#
#.........#
D..#......#
#.....#...#
#.......#.#
#......#..#
#.........#
#####D#####

1
0
#####d#####
#.........#
#.......###
#.........#
#.........#
#.........D
#.........#
#.#.......#
#..#......#
#.........#
#####D#####

4
1
#####D#####
#.........#
#.#.#.#.#.#
#.........#
#..#.#.#..#
D.........D
#.#.....#.#
#.........#
#..#.....##
#.........#
#####D#####

0
2
###########
#........X#
#.........#
#.........#
#.........#
D.........#
#.........#
#.........#
#.........#
#.........#
#####D#####

4
0
#####d#####
#.........#
#.........#
#.........#
#.........#
#....@....D
#.........#
#......#..#
#.........#
#?........#
###########
sign The dungeon remembers all who enter.

2
1
#####D#####
##.....#.##
#.........#
#.#.....#.#
#.........#
D..#.#....D
#.........#
#...#.#.#.#
#.........#
##.....#.##
#####l#####
locked : 2

5
1
#####D#####
#.........#
#.........#
#...#.....#
#..#......#
#.........D
#....#....#
#....##...#
#.........#
#.........#
###########

2
0
#####D#####
#.........#
#.........#
##.....#..#
#k........#
#.........D
#.#.....#.#
#.........#
#.........#
##........#
#####D#####
key : 1

5
2
#####l#####
#.........#
#.........#
#.........#
#.........#
D.........#
#.........#
#.#.....#.#
#..#...#..#
#.........#
###########
locked : 1

