6
0
#####.#####
#.........#
#.........#
#.#..#..#.#
#.........#
#..........
#k#..#..#.#
#.........#
#.........#
#.#.....#.#
#####l#####
key : 3

6
1
#####.#####
#.........#
#..#...#..#
#.#.....#.#
#.........#
...........
#.........#
#.........#
#.........#
#.........#
###########

3
4
###########
#.........#
#......#..#
#.......#.#
#.........#
d.........#
#.........#
#.#.......#
#..#......#
#........##
###########

4
1
#####.#####
#.........#
#.#.....#.#
#.........#
#.........#
d....#.....
#.........#
#.........#
#.#.......#
#.........#
#####.#####

1
2
#####.#####
#..#......#
#...#.##..#
#....##...#
#...####..#
.....e....#
#.........#
#.........#
#.........#
#.........#
#####d#####
boss
enemies 1

5
0
#####.#####
#.........#
#.........#
#.........#
#...@#....#
#...###....
#...#.#...#
#.........#
#..#......#
#.........#
#####.#####

2
1
#####.#####
#.........#
#.........#
#.........#
#.........#
#..........
#.........#
#.........#
#.........#
#.........#
#####d#####

3
3
#####.#####
#.......#.#
#.........#
#.........#
#....#..#.#
l.........d
#.........#
#.#..#..#.#
#.........#
#.........#
###########
locked : 1

2
3
###########
#........k#
##.....#..#
#.........#
#.........#
..........#
#.........#
#.........#
#...#..#..#
#.........#
#####.#####
key : 2

0
2
###########
#X........#
#.........#
#.........#
#.........#
#.........#
#.........#
#.........#
#.........#
#.........#
#####.#####

1
1
###########
#.........#
#.........#
#.....#...#
#......#..#
#..........
#.........#
#.........#
#.........#
#.........#
#####.#####

3
1
#####d#####
#.........#
#.........#
#.........#
#.........#
#..........
#.........#
#.........#
#.........#
#.........#
#####.#####

5
1
#####.#####
#..#......#
#.........#
#.........#
#......#..#
.........e#
#.........#
#..#......#
#.........#
#.........#
#####.#####
enemies 1

2
2
#####d#####
#e.......?#
#.........#
#...#.....#
#.........#
...........
#......#..#
#.........#
#.........#
#e........#
#####.#####
enemies 2
sign Something glints behind that door…

6
2
###########
#........e#
#.........#
#.........#
#.........#
..........#
#.........#
#.........#
#.........#
#.........#
###########
enemies 1

4
2
#####.#####
##.....#..#
#.........#
#.........#
#...#..#..#
..........#
#.........#
##..#..#..#
#.........#
#.........#
###########

3
2
#####.#####
#k........#
#..#...#..#
#.#.....#.#
#.........#
..........l
#.........#
#.......#.#
#......#..#
#.........#
#####.#####
key : 1

4
0
###########
#k........#
##.#...#.##
#.........#
#.#.#.#.#.#
#.........d
#..#.#.#..#
#.........#
#.#...#.#.#
#.........#
#####.#####
key : 0

7
0
#####l#####
#.........#
#......#..#
#.......#.#
#.........#
#.........#
#.#.#.....#
#.........#
#......#..#
#.........#
###########
locked : 3

