2
3
###########
#........k#
#.........#
#.........#
#.........#
D.........#
#......#..#
#.........#
#.........#
#.........#
#####D#####
key : 3

3
2
#####D#####
#e#.......#
#.........#
#.#.#.....#
#.........#
D...#.#...D
#.........#
#.#.#.#.#.#
#.........#
#e#.....#.#
#####D#####
enemies 2

1
1
#####D#####
#.........#
#......#..#
#.......#.#
#.........#
D.........D
#......#..#
#.#...#..##
#..#......#
#.........#
#####D#####

1
0
#####d#####
#..#.....##
#.........#
#.........#
#...#..#..#
#.........D
#.........#
#..#..#..##
#.........#
#.........#
#####D#####

0
2
###########
#........X#
#.........#
#.........#
#.........#
D.........#
#.........#
#.........#
#.........#
#.........#
#####D#####

3
0
#####D#####
#.........#
#......#..#
#.......#.#
#.........#
#.........l
#.........#
#.#.......#
#..#......#
#.........#
#####D#####

5
0
#####D#####
#.........#
#.........#
#.........#
#.........#
#.........D
#.........#
#.#.......#
#..#......#
#k........#
###########
key : 0

5
1
#####D#####
#.......#.#
#.........#
#.#.#.#.#.#
#.........#
D.....#...#
#.........#
#.#.#.#...#
#........?#
#......e#e#
###########
enemies 2
sign Those who search shall find.

2
0
#####D#####
#e#.....#.#
#.........#
#.#.#.#...#
#.........#
#...#.#...D
#.........#
#.#.#.#.#.#
#.........#
#e#.......#
#####D#####
enemies 2

2
2
#####d#####
#.........#
#.........#
#.........#
#.........#
d.........D
#.........#
#.........#
#.........#
#.........#
#####D#####

0
0
###########
#.........#
#......#..#
#.......#.#
#.........#
#.........D
#.........#
#.........#
#.........#
#.........#
#####d#####

3
1
#####D#####
#.#.....#.#
#.........#
#.#.#.#.#.#
#.........#
l.........D
#.........#
#.#.#.#.#.#
#.........#
#.#.....#.#
#####D#####
locked : 0

0
1
###########
#.........#
#......#..#
#.......#.#
#.........#
D....#....D
#.#.......#
#.........#
#.........#
#k#.......#
#####D#####
key : 4

2
1
#####D#####
#......#..#
#......#..#
#.......#.#
#.........#
D.........d
#.........#
#.##......#
#..#......#
#.........#
#####D#####

4
2
#####D#####
#.........#
#.........#
#.........#
#.........#
d.........#
#.........#
#.#.....#.#
#..#...#..#
#.........#
###########

1
2
#####D#####
#.........#
#.........#
#.........#
#.........#
D....e....#
#.........#
#.........#
#.........#
#.........#
#####d#####
boss
enemies 1

3
3
#####D#####
#.........#
#.........#
#.........#
#.........#
D.........#
#.........#
#.........#
#.........#
#.........#
###########

4
0
#####D#####
#.........#
#.........#
#.........#
#.........#
#?...@....D
#.........#
#.........#
#.........#
#.........#
#####D#####
sign What you seek is close.

4
1
#####D#####
#k........#
#.........#
#.........#
#.........#
D.........d
#.........#
#.........#
#.........#
#.........#
#####D#####
key : 1

