9
0
#####D#####
#.........#
#.........#
#.........#
#.........#
#.........#
#.........#
#.........#
#.........#
#X........#
###########

1
2
#####D#####
#e........#
#.........#
#.#.....#.#
#.........#
D.........D
#.....#...#
#.........#
#.........#
#s......#e#
#####D#####
enemies 2
switch 0 : 0 1

3
0
#####D#####
#.........#
#.........#
#....#....#
#.....#...#
#....@#...d
#...#.....#
#.........#
#...#.....#
#.........#
#####D#####

1
1
###########
#.........#
#.........#
#..#..#...#
#.........#
#.........D
#..#......#
#.........#
#.........#
#..#.....##
#####D#####

4
0
#####D#####
#.........#
##.#...#.##
#.........#
#..#.#.#..#
#.........#
#..#.#.#..#
#.........#
##.#...#..#
#.........#
#####D#####

8
0
#####l#####
#.........#
#.........#
#.........#
#.........#
#....e....#
#.........#
#.........#
#.........#
#.........#
#####D#####
locked : 3
boss
enemies 1

3
1
#####D#####
#.........#
#.........#
#.....#...#
#.........#
d.........D
#.........#
#...#.....#
#.........#
#.........#
###########

4
2
#####D#####
#.........#
#.........#
#.........#
#.........#
#.........#
#.........#
#.#.......#
#..#......#
#k........#
###########
key : 7

2
3
#####D#####
#......#..#
#..#...##.#
#.#######.#
#.........#
d....#....#
#..####...#
#.........#
#.........#
#.........#
###########

7
0
#####d#####
#.........#
#..#.....##
#.........#
#.#.#.#...#
#.........l
#.........#
#.........#
#.#.#.#...#
#.........#
#####l#####

2
1
#####D#####
#k........#
#.........#
#.........#
#.........#
D.........D
#.........#
#.........#
#.........#
#.........#
#####D#####
key : 0

5
0
#####D#####
#.........#
#..#.....##
#.........#
#.........#
#...#..#..#
#.........#
#.........#
#..#..#..##
#.........#
#####d#####

2
2
#####D#####
#.........#
#.......#.#
#.........#
#.........#
D.........d
#.........#
#.........#
##........#
##........#
#####D#####

2
0
###########
#.........#
#..#...#..#
#.#.....#.#
#.........#
#.........D
#......#..#
#.#.......#
#..#......#
#.#....#..#
#####D#####

7
1
###########
#.........#
#.........#
#.##......#
#..###....#
l..#.#....#
#..#......#
#..###....#
#.........#
#.........#
###########
locked : 0

1
3
###########
#........k#
#.........#
#.........#
#.........#
D.........#
#.........#
#.#.......#
#..#......#
#.........#
#####D#####
key : 6

0
2
###########
#e........#
#.........#
#..##.....#
#.#.#.....#
#...#.....#
#...#.....#
#...##....#
#.........#
#.........#
#####D#####
enemies 1
door 0 : 0 1

3
2
#####D#####
#.........#
#.........#
#.........#
#.........#
D........k#
#.........#
#.........#
#.........#
#.........#
#####D#####
key : 3

6
0
#####d#####
#.........#
#.........#
#.........#
#.#.#.#.#.#
#.........#
#....#.#..#
#.........#
#.#.#.#.#.#
#.........#
#####d#####

