5
0
#####.#####
#.........#
#.#.....#.#
#.........#
#.........#
#..#..#...d
#.........#
#.........#
#.#.....#.#
#.........#
#####d#####

5
2
###########
#e...e....#
#.........#
#.........#
#.........#
...........
#.........#
#.........#
#.........#
#s........#
#####l#####
enemies 2
switch 0 : 0

4
3
###########
#k........#
#.........#
#.........#
#.........#
#.........#
#.........#
#.........#
#.........#
#.........#
#####.#####
key : 3

4
0
#####.#####
#.........#
#..#......#
#.........#
#..#......#
#..........
#..#.#.#..#
#.........#
#..#...#.##
#.........#
#####.#####

7
0
#####.#####
#..#.....##
#.........#
#.........#
#...#..#..#
#.........#
#.........#
#..#..#..##
#.........#
#.........#
###########

3
0
#####.#####
#.........#
#......#..#
#.......#.#
#.........#
#k........l
#.........#
#.........#
#.........#
#.........#
#####.#####
key : 1

2
0
#####d#####
#.........#
#..#...#..#
#.#.....#.#
#.........#
#.........d
#.........#
#.........#
#.........#
#.........#
#####.#####

3
1
#####.#####
#.........#
#......#.##
#.........#
#..#...#..#
l.........#
#..#...#..#
#.........#
##.#...#.##
#.........#
#####.#####
locked : 1

6
2
#####l#####
#.........#
##.....#..#
#.........#
#.........#
....#......
#.........#
#.........#
##........#
#.........#
###########
locked : 0

5
4
###########
#.......ee#
#.........#
#.........#
#.........#
..........#
#.........#
#.........#
#.........#
#.......?e#
###########
enemies 3
sign What you seek is close.

2
1
###########
#.........#
#.........#
#.........#
#.##......#
d..#......#
#.##......#
#.........#
#.........#
#.........#
#####.#####

5
1
#####.#####
#.........#
#......#..#
#.......#.#
#.........#
d..........
#.........#
#.......#.#
#......#..#
#.........#
#####.#####

6
1
#####.#####
#.........#
#..#......#
#.#.......#
#.........#
...........
#.........#
#.#.......#
#..#......#
#.........#
###########

5
3
#####.#####
#k........#
#.........#
#..#..#..##
#.........#
...........
#.....#...#
#.........#
#.........#
#..#......#
#####.#####
key : 2

4
1
#####.#####
#.........#
#......#..#
##......#k#
#.........#
..........#
#...#.....#
#.#.......#
#..#......#
#.........#
#####.#####
key : 0

0
0
###########
#X........#
#.........#
#.........#
#.........#
#.........#
#.........#
#.........#
#.........#
#.........#
#####.#####

6
0
#####d#####
##........#
#.........#
#.........#
#...@###..#
#....###...
#.#.......#
#.........#
#.........#
#.........#
#####.#####

1
0
#####.#####
#.........#
#.........#
#.........#
#.........#
#....e....#
#.........#
#.........#
#.........#
#.........#
#####d#####
boss
enemies 1

6
3
#####.#####
#.........#
#.........#
#.........#
#.........#
..........#
#.........#
#.........#
#........e#
#.......ee#
###########
enemies 3
door 0 : 0

