7
0
#####.#####
#.........#
#..#......#
#.#.......#
#.........#
#..........
#.........#
#.........#
#.........#
#.........#
###########

7
1
#####.#####
#..#.....##
#........k#
##.#.#...##
#.........#
.....#.#..#
#.........#
##.#.#.#.##
#.........#
##.......##
#####d#####
key : 2

3
0
#####.#####
#.........#
#.........#
#.........#
#.........#
#..........
#.........#
#.......#.#
#......#..#
#.........#
#####d#####

5
0
#####l#####
#.........#
#.........#
#.........#
#.........#
#k.........
#.........#
#.........#
#.........#
#.........#
#####.#####
key : 1

4
2
###########
##........#
#.........#
#.........#
#.........#
..........#
#.........#
##........#
#.........#
#.........#
###########

1
0
#####.#####
#.........#
#.........#
#.........#
#.........#
#.........d
#.........#
#.........#
#.........#
##........#
#####l#####
locked : 2

0
0
###########
#e........#
#e........#
#.........#
#.........#
#..........
#.........#
#.........#
#.........#
#.........#
#####.#####
enemies 2

6
0
#####.#####
#.........#
#...#...#.#
#......##.#
#....#.##.#
#....@##...
#.........#
#.........#
#.........#
#.........#
#####.#####

4
0
#####d#####
#.........#
#..#...#..#
#.#.....#.#
#.#.......#
#..........
#.........#
#.........#
#.........#
#.........#
#####l#####
locked : 0

1
1
#####.#####
#.........#
#.........#
#.........#
#.........#
d....e....#
#.........#
#.........#
#.........#
#.........#
#####.#####
boss
enemies 1

0
1
###########
#.......#X#
##........#
#.........#
#.........#
.......#..#
#......#..#
#......#..#
#..#......#
#.........#
#####.#####

6
2
###########
#.........#
#.........#
##.....#..#
#.........#
..........#
#.#.....#.#
#.........#
#.........#
##.....#..#
###########

4
1
#####l#####
#.........#
##.#...#.##
#.........#
#..#...#..#
...........
#..#.#....#
#.........#
##.#...#..#
#.........#
#####d#####

2
1
#####.#####
#.........#
#.........#
#.........#
#.........#
.........k#
#.........#
#.........#
#.#.......#
#.........#
#####.#####
key : 3

2
0
#####l#####
#.........#
#...#.#...#
#...##....#
#e#####...#
#..e#......
#?##......#
#.........#
#.........#
#.........#
#####.#####
enemies 2
sign Seek the matching key before you proceed.

6
1
#####.#####
#k........#
#......#..#
#.......#.#
#.........#
...........
#.........#
#.........#
#.........#
#.........#
#####.#####
key : 0

8
1
#####d#####
#.........#
#..#...#..#
#.#.....#.#
#.........#
#.........#
#.........#
#.........#
#.........#
#.........#
###########

5
1
#####d#####
#.........#
#..#......#
#.#.....###
#.........#
...#......#
#.........#
#.........#
#.........#
#.........#
#####.#####

3
1
#####.#####
#.........#
#..#.....##
#.........#
#.........#
...#......#
#.........#
#.........#
#.....#..##
#.........#
#####l#####
locked : 1

