0
1
###########
#.....e.?e#
#.....#...#
#....##...#
#...###...#
D..###e#..#
#...##....#
#.........#
#.........#
#.........#
#####D#####
enemies 3
sign Something glints behind that door…

2
0
#####d#####
#.........#
#......#..#
#.......#.#
#.........#
#k........D
#.........#
#.........#
#.........#
#.........#
#####D#####
key : 0

0
0
###########
#k........#
#..##..#..#
#...#.##..#
#..#...#..#
#..#..#...D
#..#.#....#
#.........#
#.........#
#.#.......#
#####D#####
key : 2

4
1
#####D#####
#k#.......#
#.........#
#.....#...#
#.........#
#.........D
#.........#
#......#..#
#.........#
#.........#
#####l#####
key : 1

1
1
#####D#####
#.........#
#.........#
#.........#
#.........#
D.........D
#.........#
#.......#.#
#......#..#
#.........#
#####d#####

1
0
#####D#####
##.#...#.##
#.........#
##.......##
#.........#
#..#......D
#.........#
##.#.#.#.##
#.........#
##.#...#.##
#####d#####

5
1
#####l#####
#.........#
#.........#
#..###....#
#.#####...#
#..#..#...D
#..#..#...#
#..#.#....#
#.........#
#.........#
#####l#####
locked : 1

3
0
#####D#####
#.........#
#.#.#.....#
#.##.#....#
#....#....#
#....@....D
#..#......#
#.........#
#.........#
#?........#
###########
sign The brave are rewarded.

2
2
#####d#####
#.........#
#...#.###.#
#...#####.#
#...##.#..#
D...#..#..#
#.....###.#
#.........#
#.........#
#.........#
#####D#####

2
1
#####d#####
#.........#
#.........#
#...##....#
#..#......#
D...#.....D
#...#.....#
####.#....#
#..#......#
#.........#
#####D#####

6
2
#####D#####
#..#.....##
#.........#
#.........#
#...#..#..#
D.........#
#.........#
#..#..#..##
#.........#
#........k#
###########
key : 3

5
2
#####l#####
#.........#
#...#...#.#
#...#.#..##
#.........#
D.........D
#.........#
#.........#
#.........#
#.........#
#####D#####

1
2
###########
#.........#
####......#
##.###....#
#...##....#
D..##.....d
#..#......#
#.........#
#.........#
#.........#
#####d#####

1
3
###########
#.........#
##..#..#..#
#.........#
#.........#
d...#.....#
#.........#
#.........#
##..#..#..#
#.........#
###########

6
1
#####l#####
#.#.......#
#.........#
#.........#
#.#.....#.#
#.........D
#.........#
#.#.....#.#
#.........#
#.........#
###########
locked : 0

3
1
#####D#####
#.........#
#......#..#
#.......#.#
#.........#
D.........D
#.........#
#.........#
#.........#
#.........#
#####D#####

4
2
#####D#####
#.........#
#.........#
#.........#
#.........#
D....e....#
#....#....#
#....#....#
#.........#
#.........#
#####l#####
locked : 2
boss
enemies 1

5
3
###########
#.........#
#.#...#...#
#.........#
#..#...#..#
D.........#
#.#...#...#
#.........#
#..#...#.##
#.........#
###########

3
2
#####D#####
#..#......#
#.....#####
#.....##..#
#.....##..#
D....#X...#
#....##...#
#.........#
#.........#
#.........#
#####D#####

