4
0
#####.#####
#.........#
#.........#
#.#.....#.#
#.........#
#.........#
#.#..#..#.#
#.........#
#.........#
#k#.....#.#
###########
key : 7

2
3
#####.#####
#.........#
#.........#
#.........#
#...#.....#
l..........
#...#.#...#
#...##....#
#.........#
#.........#
#####.#####
locked : 1

3
1
#####.#####
#.........#
#.........#
#.........#
#.........#
.......#...
#.........#
#.........#
#.........#
#....e....#
###########
enemies 1

2
0
###########
#.........#
#.........#
#.........#
#.........#
#....@.....
#.........#
#.........#
#.........#
#.........#
#####.#####

1
3
#####d#####
#.........#
#.........#
#.........#
#.........#
l..........
#.........#
#.........#
#.........#
#.........#
#####.#####
locked : 7

1
1
###########
#e........#
#e........#
#..#..#..##
#.........#
#..........
#...#..#..#
#.........#
#.........#
#.........#
#####.#####
enemies 2

3
3
#####.#####
#.........#
##.....#.##
#.........#
#..#.#.#..#
..........d
#..#.#....#
#.........#
#......#.##
#.........#
#####.#####

0
3
###########
#......#.##
#.........#
##.#.#....#
#.........#
...#.#.#..#
#.........#
#..#.#.#..#
#.........#
##.#...#..#
#####d#####

0
2
###########
#k........#
#.........#
#...#..#..#
#.........#
#..........
#.........#
#.......#.#
#...#..#..#
#.........#
#####.#####
key : 8

4
3
#####.#####
#.........#
#.........#
#.........#
#.........#
..........#
#.........#
#.....#...#
#.........#
#.........#
###########

1
4
###########
#........X#
#.........#
#.........#
#.........#
....#..#..#
#...#.##..#
#...#####.#
#.....#...#
#......#..#
#####.#####

3
2
#####.#####
#........k#
#..#..#..##
#.........#
#.........#
...#..#....
#.........#
#.........#
#..#..#...#
#.........#
#####.#####
key : 1

2
2
#####.#####
#..#......#
#.........#
#.........#
#...#..#..#
l.........l
#.........#
#........##
#.........#
#.........#
#####.#####
locked : 0

2
1
#####.#####
#.........#
#.##......#
#.k##.....#
#.#.......#
..........l
#.........#
#..#......#
#.........#
#.........#
#####.#####
key : 0

3
0
#####.#####
#.........#
#.........#
#.........#
#.........#
#..........
#.........#
##....#...#
#.........#
#.........#
#####.#####

2
4
#####.#####
#.........#
#.........#
#.........#
#.........#
.....e....#
#.......#.#
#.....#...#
#......#..#
#.........#
#####d#####
boss
enemies 1

1
2
#####.#####
#.........#
##.#...#..#
#.#.....#.#
#.........#
..........l
#.........#
#........##
#.........#
#.........#
#####.#####

3
4
#####d#####
#......#..#
#.........#
#.........#
#......#..#
d.........#
#.........#
#......#..#
#.........#
#.........#
###########

4
2
#####.#####
#.........#
#.........#
#.........#
#.........#
#..........
#.........#
#.........#
#.........#
#.........#
###########

