2
4
#####D#####
#.........#
#.........#
#.........#
#.........#
D....e.#..#
#......#..#
#.....#.#.#
#.........#
#.........#
#####d#####
boss
enemies 1

2
1
#####D#####
#k........#
##..#.....#
#.........#
#.........#
D....#....l
#.........#
#.........#
##.....#..#
#.........#
#####D#####
key : 0

0
3
###########
#..#......#
##........#
#.....###.#
#.....##..#
D.....##..#
#.........#
#.........#
#.........#
#.........#
#####d#####

2
0
###########
#.........#
#.........#
#.........#
#.........#
#...#@....D
#....##...#
#..##.....#
#...#..#..#
#..#...#..#
#####D#####

3
1
#####D#####
#.......#.#
#.........#
#..#.#.#..#
#.........#
D...#.#...D
#.........#
#..#.#...##
#.........#
#e#.....#.#
###########
enemies 1

2
2
#####D#####
#.........#
#.........#
#.........#
#....p....#
l....#....l
#..#####..#
#..###....#
#...#.....#
#......p..#
#####D#####
locked : 0

4
3
#####D#####
#.........#
#......#..#
#.......#.#
#.........#
D.........#
#.........#
#.#.......#
#..#......#
#.........#
###########

3
2
#####D#####
#k........#
#####.#...#
#.####....#
#.####....#
D...###...D
#.#..#....#
#.........#
#.........#
#.........#
#####D#####
key : 1

0
2
###########
#k#.....#.#
#.........#
#.#.#...#.#
#.........#
#.....#...D
#.........#
#.#...#.#.#
#.........#
#.#.....#.#
#####D#####
key : 8

1
3
#####d#####
#.........#
#.........#
#.........#
#.........#
l.........D
#.......#.#
#.....#...#
#......#..#
#.........#
#####D#####
locked : 7

1
4
###########
#........X#
#.........#
#.........#
#.##..#...#
D.....##..#
#.#..##.#.#
#.##.#..#.#
#.###.....#
#.........#
#####D#####

3
0
#####D#####
#.........#
#.........#
#.........#
#.........#
#..###....D
#...#.....#
#.#####...#
#...#.....#
####......#
#####D#####

2
3
#####D#####
#.........#
#.........#
#.........#
#....##...#
l....##...D
#......#..#
#.........#
#.........#
#.........#
#####D#####
locked : 1

3
4
#####d#####
#.........#
#..#......#
#.#.......#
#.........#
d.........#
#.#.......#
#.#..#....#
#..#......#
#.........#
###########

4
0
#####D#####
#.........#
#.........#
#.###.....#
#.##......#
#.........#
#.........#
#.........#
#.........#
#k........#
###########
key : 7

4
2
#####D#####
#.........#
#.........#
#.........#
#.........#
#.........D
#.........#
#.........#
#.........#
#.........#
###########

3
3
#####D#####
#.........#
#.........#
#...#.#...#
#..#..##..#
D..#.###..d
#..#####..#
#..#####..#
#.........#
#.........#
#####D#####

1
1
###########
#e........#
#e........#
#.........#
#....##.#.#
#...####..D
#....###..#
#..#.###.##
#..#..###.#
#..#......#
#####D#####
enemies 2

1
2
#####D#####
#.#.....#.#
#.........#
#..#.#...##
#.........#
D...#.#...l
#.........#
#..#.#.#.##
#.........#
#.........#
#####D#####

