3
2
#####.#####
#.........#
#k###.....#
#####.....#
#.........#
...##......
#.##...#..#
#.....##..#
#.....#...#
#.........#
#####l#####
key : 0

1
2
#####.#####
#e.#......#
#.........#
#..####...#
#.....#...#
......#..e#
#.........#
#.........#
#.........#
#.........#
#####.#####
enemies 2

5
3
#####d#####
#.........#
#.........#
#.........#
#.........#
#....e....#
#.........#
#.........#
#.........#
#.........#
#####.#####
boss
enemies 1

2
1
#####l#####
#.........#
#..#...#.##
#.........#
#..#.#.#..#
...........
#....#....#
#.........#
##.#...#.##
#.........#
#####.#####

2
0
###########
#k........#
#.........#
#.........#
#.........#
#..........
#.........#
#.........#
#.........#
#.........#
#####.#####
key : 5

1
1
#####.#####
#.........#
#......#..#
#.......#.#
#.........#
#..........
#.........#
#.........#
#..#......#
#..#......#
#####l#####
locked : 1

4
4
#####.#####
#.........#
#.........#
#..#......#
#.#.......#
...#.#....#
#...###...#
#..###e...#
#.....##..#
#..#...?.e#
###########
enemies 2
door 0 : 0
sign Many have walked this path.

2
2
#####.#####
#.........#
#..#......#
#.#.......#
#...#.....#
.....#k#..#
#......#..#
#.........#
#.........#
#.........#
#####.#####
key : 2

3
1
#####.#####
#.........#
#..#......#
#.#.......#
#.........#
...........
#.........#
##........#
#.........#
#.........#
#####.#####

4
1
#####.#####
#.......#.#
#.........#
#...#.#.#.#
#.........#
#...#.#....
#.........#
#.#.#.#.#.#
#.........#
#k#.....#.#
###########
key : 1

0
2
###########
#.##......#
#...#.....#
#.#.###...#
#.........#
..........#
#.........#
#.........#
#.........#
#.........#
#####.#####

3
0
#####.#####
#......#..#
#.........#
#......#..#
#.#.......#
#....@.....
#..#.#....#
#.........#
#...#.....#
#?#.......#
###########
sign Strange symbols cover the floor.

3
3
###########
#.........#
#..#...#..#
#.#.....#.#
#.........#
..........d
#.........#
#.......#.#
#......#..#
#.........#
#####.#####

3
4
###########
#.........#
#.........#
#.........#
#.........#
d..........
#.........#
#.#.......#
#..#......#
#.........#
#####.#####

4
2
#####l#####
#.........#
#.........#
##........#
#.........#
.......#...
#....##...#
#...###...#
#...#.#.#.#
#......##.#
###########
locked : 0

4
3
#####.#####
#........##
#.........#
#.........#
#...#.....#
...........
#.........#
#.........#
#.........#
#.........#
#####d#####

3
5
###########
#..#......#
#.........#
#.#.#...#.#
#.........#
.....#.#..#
#.........#
#.#.#.#.#.#
#.........#
##........#
###########

6
3
#####.#####
#.........#
#......##.#
#...###...#
#...##..#.#
#.....##..#
#...#.#...#
#.........#
#.........#
#X#.......#
###########

0
1
###########
#ee.......#
#e....###.#
#s......#.#
#.........#
#..........
#.........#
#.........#
#.........#
#.........#
#####.#####
enemies 3
switch 0 : 0

