4
4
#####.#####
#.........#
#.........#
#.........#
#.........#
#....###...
#.........#
#.........#
#.........#
#k........#
###########
key : 4

2
4
#####.#####
#.........#
#k#.......#
##...#....#
#.#.##....#
.....#.....
#.........#
#.........#
#.........#
#.........#
#####.#####
key : 2

0
2
###########
#k........#
#.....#.#.#
#.........#
#.........#
#.........#
#.#.#.#...#
#.........#
#..#...#.##
#.........#
#####.#####
key : 1

2
3
#####d#####
#..#...##.#
#..##.##..#
#...##....#
#..#####..#
#..#.##....
#.........#
#.........#
#.........#
#.........#
###########

1
1
###########
#.........#
#.........#
#.........#
#...##....#
.....#....d
#.........#
#.........#
#.........#
#.........#
#####.#####

1
0
###########
#.#.......#
#...#.#...#
#.#####...#
#.#.##....#
#.....#....
#.........#
#.........#
#.........#
#.........#
#####.#####

3
0
#####.#####
#.........#
#e#.......#
#.........#
#..#......#
#s.e.......
#..##.....#
#.........#
#.........#
#.........#
#####.#####
enemies 2
switch 0 : 0

4
1
#####.#####
#.........#
#.........#
#.........#
#.........#
d.........#
#.........#
#.........#
#.........#
#.........#
###########

2
0
#####.#####
#.........#
#.........#
#........##
#....#....#
#....@....d
#.........#
#.........#
#.........#
#.........#
#####.#####

1
2
#####.#####
#.........#
#......#..#
#.......#.#
#.........#
d..........
#.........#
#.......#.#
#......#..#
#.........#
###########

1
4
###########
#.......ee#
#........e#
#.........#
#.........#
..........#
#.........#
#.........#
#.........#
#.........#
#####.#####
enemies 3

3
5
#####.#####
#.........#
#.........#
#.........#
#.........#
l....e....#
#.........#
#.....#...#
#......#..#
#.........#
#####.#####
locked : 2
boss
enemies 1

1
3
###########
#.......#.#
#.........#
#.........#
#..#..#...#
...........
#.........#
#.#..#....#
#.........#
#.........#
#####d#####

2
5
###########
#.......ee#
#........?#
#.#.....#e#
#.........#
..........#
#....#..#.#
#.........#
#.........#
#.#.....#.#
#####.#####
enemies 3
sign Seek the matching key before you proceed.

4
5
#####.#####
#.........#
####......#
#.#.......#
#.........#
..........#
#.........#
#.........#
#.........#
#........X#
###########

2
1
#####.#####
###.......#
##.##.....#
##.##.....#
#..#......#
d.........#
#.........#
#...#.....#
#.........#
#.........#
#####.#####

4
0
#####.#####
#.........#
#.........#
#.........#
#.........#
#.........d
#.........#
#.........#
#.........#
#e........#
###########
enemies 1
door 0 : 0

3
4
#####.#####
#.........#
#.........#
#.........#
#.........#
#k.##.....l
#.........#
#...##....#
#.........#
#.........#
#####.#####
key : 3

3
1
#####.#####
#.........#
#.........#
#..###.#..#
#......#..#
....#.##..#
#.........#
#.........#
#...#.....#
#.........#
#####.#####

