5
5
#####D#####
#.........#
#.##..#...#
#...#.....#
#.#.......#
D..#.##...#
#.#.#.#...#
#.........#
#.........#
#........X#
###########

0
0
###########
#.........#
#.........#
#.........#
#.........#
#..##.....#
#.#..#....#
#.........#
##.#......#
#.........#
#####l#####
locked : 1

2
0
#####D#####
#s.#.....##
#.........#
#.........#
#..#..#...#
#e........D
#.........#
#..#..#...#
#.........#
#.........#
#####D#####
enemies 1
switch 0 : 0

4
1
#####d#####
#.........#
#........p#
#.........#
#.........#
D.........D
#.........#
#.........#
#.........#
#.........#
###########

3
0
#####D#####
#.........#
#.........#
#.........#
#.........#
#?...@....D
#.........#
#.........#
#.........#
#.........#
#####D#####
sign The dungeon remembers all who enter.

2
1
#####D#####
#e........#
#..p......#
#.........#
#.........#
D.........D
#.........#
#.........#
#.........#
#?........#
#####D#####
enemies 1
door 0 : 0
sign Many have walked this path.

3
2
#####D#####
##.#......#
##........#
#.##.#....#
#..#.#....#
D...##....D
#.........#
#.........#
#.........#
#.........#
#####D#####

1
0
#####l#####
#.........#
#.........#
##..#.....#
#k........#
#.........d
#...#..#..#
#.........#
#.........#
##.....#..#
#####D#####
key : 1

2
2
###########
#..#...#..#
#..##.#...#
#..##..#.##
#..#..##..#
D.........#
#.........#
#........##
#.........#
#.........#
#####D#####

4
4
#####d#####
#.........#
#..#......#
#.#.......#
#.........#
D.........d
#.........#
#.......#.#
#......#..#
#.........#
#####D#####

3
4
###########
#.........#
##.#...#.##
#.........#
#..#.#.#..#
D.........#
#..#...#..#
#.........#
##.#...#.##
#.........#
#####d#####

3
1
#####D#####
#.........#
#.........#
#.........#
#.........#
D.........D
#.........#
#.........#
###.......#
#.........#
#####d#####

1
1
###########
#.........#
#.........#
#.........#
#.##......#
d...#.....#
#.#.##....#
#..#......#
#..##.#...#
#.........#
#####D#####

4
5
###########
#.........#
#.........#
#.........#
#.........#
d....e....#
#.........#
#.........#
#.........#
#.........#
#####D#####
boss
enemies 1

4
2
#####D#####
#.........#
#......#..#
#.......#.#
#.........#
D.........D
#.........#
#.#.....#.#
#..#...#..#
#..k......#
###########
key : 2

4
0
#####D#####
#.........#
#.........#
#.........#
#....##...#
#....#....D
#...####..#
#.........#
#.........#
#e........#
###########
enemies 1

4
3
#####l#####
#.........#
#.........#
#.........#
#.........#
D.........D
#.........#
#.........#
#.........#
#.........#
###########
locked : 2

5
4
#####D#####
#.........#
##.....#.##
#.........#
#..#.#.#..#
#.........D
#....#.#..#
#.........#
##.#...#.##
#k........#
###########
key : 4

3
3
###########
#....k....#
#.........#
##..#..#..#
#.........#
D.........D
#.........#
#.........#
#.........#
##.....#..#
#####l#####
key : 3

