1
1
###########
#k........#
#.........#
#...#..#..#
#.........#
#..........
#.#..#..#.#
#.........#
#.........#
##........#
#####.#####
key : 3

2
5
###########
#........##
#......#..#
#........##
#....####.#
..........#
#.........#
#.........#
#.........#
#........##
###########

3
1
#####.#####
#.........#
#.........#
#.........#
#.........#
...........
#.........#
#.......#.#
#......#..#
#.........#
#####.#####

5
2
#####.#####
#.........#
#.........#
#..##.....#
#.........#
d.........#
#.........#
#.........#
#.........#
#.......#.#
###########

5
1
#####.#####
#.#.......#
#.........#
#.#.#.#.#.#
#.........#
#...#.#...d
#.........#
#.#.......#
#.........#
#.#.......#
###########

4
1
#####.#####
#..#......#
#..##.....#
#.#.#.....#
#...#.....#
#.........l
#.........#
#.........#
##........#
#k........#
#####.#####
key : 0

3
2
#####.#####
#k........#
#.........#
##..#..#..#
#.........#
...........
#...#..#..#
#.........#
#.........#
##.....#..#
#####.#####
key : 2

1
4
#####.#####
#.........#
#.........#
#.......#.#
#.........#
#....e....#
#.........#
#.........#
#.........#
#.........#
#####d#####
boss
enemies 1

2
3
###########
#.........#
#.........#
#.........#
#.........#
...........
#.........#
#.........#
#.........#
#.........#
#####l#####
locked : 1

3
0
###########
####......#
###.......#
#.........#
#.###.....#
#..#.@.....
#?##......#
######....#
#.........#
#.........#
###########
sign The dungeon remembers all who enter.

2
1
#####.#####
#.........#
#......#..#
#.......#.#
#.........#
#k........d
#.........#
#.........#
#.........#
#.........#
#####.#####
key : 1

2
4
#####d#####
#.........#
#.........#
#.###.....#
#..###....#
...##......
#.####....#
##.###....#
##........#
#e........#
#####.#####
enemies 1

4
2
#####.#####
#.........#
#.........#
#.........#
#.........#
l.........#
#.........#
#.........#
#.........#
#.........#
#####.#####
locked : 2

0
4
###########
##.......X#
#.........#
#.........#
#.........#
#.........#
#.........#
#.........#
#.........#
#..#......#
#####.#####

2
2
#####l#####
#.........#
##.#.....##
#.........#
#..#.#.#..#
d..........
#..#.#....#
#.........#
##.....#..#
#.........#
#####.#####

3
3
#####l#####
#.........#
#.........#
#.........#
#.........#
...#.......
#.........#
#.##......#
#.........#
#....e....#
###########
enemies 1

1
2
#####d#####
#.........#
#......#..#
#.......#.#
#.........#
..........#
#.........#
#.......#.#
#......#..#
#.........#
#####l#####
locked : 0

3
4
#####.#####
#.........#
#.........#
#.........#
#.........#
..........#
#.........#
#.......#.#
#......#..#
#.........#
###########

0
2
###########
#.........#
#.........#
#.........#
#.........#
#.........#
#.........#
#.........#
#.........#
#.........#
#####d#####

