2
1
#####D#####
#.........#
#.#.#.#.#.#
#.........#
#..#...#..#
D.........l
#.#...#.#.#
#.........#
#..#...#.##
#.........#
#####D#####

2
2
#####D#####
#.........#
#.........#
##.....#..#
#.........#
l.........#
#....#..#.#
#.........#
#.........#
##.....#..#
#####D#####
locked : 0

1
1
###########
#.........#
#.........#
#..#......#
#.........#
D......#..D
#.........#
#.#.....#.#
#......#..#
#.........#
#####D#####

3
1
#####D#####
#.........#
#.#.#.#.#.#
#.........#
#..#.#.#..#
D.........D
#.#.#.#.#.#
#.........#
#......#..#
#.........#
#####D#####

6
0
#####d#####
#.......#.#
#.........#
#.........#
#.....#...#
#.........#
#.........#
#.#..#..#.#
#.........#
#.........#
###########

4
0
#####d#####
#.........#
#.........#
#.........#
#...#.....#
#..####...D
#..#....#.#
#.........#
#.........#
#.........#
#####D#####

4
1
#####D#####
#e.....#..#
#......#..#
#....#.#..#
#......##.#
D....#....d
#......#..#
#.....##..#
#.........#
#?........#
#####D#####
enemies 1
sign Something glints behind that door…

5
0
#####D#####
#e........#
#.........#
#.........#
#.........#
#e........D
#.........#
#.........#
#.........#
#.........#
#####d#####
enemies 2

3
0
#####d#####
#.........#
#..#...#..#
#.#.....#.#
#.........#
#.....#...D
#.........#
#.........#
#.........#
#.........#
#####d#####

7
2
#####D#####
###.......#
#.........#
#.........#
#.........#
#.........#
#.........#
#.........#
#.........#
#X........#
###########

0
0
###########
#.........#
#..#..#..##
#.........#
#.........#
#...#..#..#
#.........#
#.........#
#.....#...#
#.........#
#####D#####

6
2
#####l#####
#.........#
#........##
#....#..###
#...e.....#
#....##...#
#.....#.#.#
#.........#
#.......p.#
#.........#
#####D#####
locked : 2
boss
enemies 1

4
2
#####D#####
#.#.....#.#
#.........#
#.........#
#.#..#..#.#
d.........#
#.........#
#.#..#..#.#
#.........#
#.........#
#####D#####

3
2
#####D#####
#.........#
#......#..#
#.......#.#
#.........#
D.........#
#.........#
#.......#.#
##.#...##.#
#k........#
#####D#####
key : 1

2
0
#####D#####
#.........#
#.........#
#.........#
#.........#
#....@.#..D
#....#....#
#....###..#
#.........#
#.........#
#####d#####

5
2
#####D#####
#e#.......#
#.........#
#..#...#.##
#........e#
D...#.#...#
#.........#
#..#.#...##
#.........#
#e#.......#
#####l#####
enemies 3

1
2
###########
#........k#
#.........#
##..#..#..#
#.........#
D.........#
#.#..#..#.#
#.........#
#.........#
##.....#..#
#####D#####
key : 2

5
1
#####D#####
#.........#
#......#..#
#.......#.#
#.........#
D.........D
#.........#
#.......#.#
#......#..#
#......k..#
###########
key : 3

1
0
#####D#####
#.........#
#..#..#...#
#.........#
#.........#
#.........D
#.........#
#.........#
#..#.....##
#........k#
#####D#####
key : 0

