6
0
#####d#####
#.........#
#.........#
#.........#
#...#.....#
#...e#....#
#.....#...#
#.........#
#.........#
#.........#
#####.#####
boss
enemies 1

2
1
#####.#####
#.........#
##.....#.##
#.........#
#.#...#.#.#
..........#
#..#.#.#..#
#.........#
#...#.#.#.#
#.........#
#####.#####

1
2
###########
#k##......#
#.#.......#
#...##....#
#..#......#
...........
#.........#
#.........#
#.........#
#.........#
###########
key : 1

3
1
#####.#####
#.........#
#......#..#
#.....#...#
#.......#.#
d.........d
#.........#
#.#.......#
#..#......#
#.........#
#####.#####

1
0
#####.#####
#.........#
#.........#
#.........#
#...@.....#
#...##?#...
#...###...#
#...#####.#
#......##.#
#.........#
#####.#####
sign You feel a chill that has nothing to do with the cold.

5
2
###########
#........e#
#.........#
#.........#
#.........#
..........#
#.#....#..#
#.##......#
#.........#
#.........#
###########
enemies 1
door 0 : 0 1

2
0
#####.#####
#.........#
#.........#
#...#.##..#
#.........#
#...###....
#...#####.#
#...###...#
#.........#
#.........#
#####l#####

2
3
#####l#####
#.........#
#.........#
#........##
#.###.....#
#.........#
#.##......#
#.........#
#.........#
#.........#
###########
locked : 1

4
1
#####.#####
#..#......#
#.#.......#
#.##......#
#.........#
d.........#
#.........#
#.........#
#.........#
#.........#
#####.#####

1
3
###########
#.........#
#..#..#..##
#.........#
#.........#
....#..#..#
#.........#
#.........#
#.........#
#.........#
#####l#####

0
1
###########
#......#.k#
#......#..#
#.......#.#
#.........#
..........#
#.#....#..#
#.#.......#
#..#......#
#.........#
#####.#####
key : 2

0
0
###########
#k.#......#
#...#.....#
#......#..#
#..####...#
#..#.###...
#.........#
#.........#
#.........#
#.........#
#####.#####
key : 0

3
0
#####l#####
#.........#
#.........#
#.........#
#.........#
#.........d
#.........#
#.........#
#.........#
#.........#
#####.#####
locked : 0

5
0
#####l#####
#.........#
#...#..##.#
#.#...#...#
#.###.#.#.#
#..##.#....
#.#.#.#.#.#
#...###...#
#.........#
#.........#
#####d#####
locked : 3

1
1
#####.#####
#.#.....#.#
#.........#
#...#...#.#
#.........#
....#.#....
#.........#
#.#.#...#.#
#.........#
#.......#.#
#####.#####

5
1
#####.#####
#e#.......#
#.........#
#.........#
#.#..#..#.#
...........
#.........#
#.#..#..#.#
#.........#
#s...e....#
###########
enemies 2
switch 0 : 0 1

7
0
#####.#####
#.........#
#.........#
#.........#
#...#.#...#
#...####..#
#....#....#
#...#####.#
#...#.###.#
#X........#
###########

4
0
#####.#####
#.........#
#.........#
#.........#
#.........#
#k........d
#.........#
#.........#
#.........#
#.........#
#####l#####
key : 3

3
2
###########
#.........#
#......#..#
#......#..#
#....#....#
d.........#
#.....#.#.#
#.........#
#.........#
#.........#
###########

