5
1
#####D#####
#.........#
#......#..#
#.......#.#
#.........#
D.........D
#.........#
#......#..#
#.........#
#....k....#
###########
key : 1

5
2
#####d#####
#.........#
#.........#
#.........#
#.........#
D..###....#
#.#..#....#
#.#.#.#...#
#.#.#.....#
#.........#
#####D#####

0
3
###########
#X........#
#...#.....#
#.........#
#.........#
#....##...#
#......##.#
#....##.#.#
#.......#.#
#......#..#
#####D#####

4
4
#####D#####
#......#..#
#.........#
#.........#
#......#..#
D.........#
#.........#
##........#
#.........#
#........k#
###########
key : 4

5
0
#####D#####
#.........#
#.........#
##.###....#
#..p#.....#
#..e##....D
#e##......#
###.##....#
###.......#
#........p#
#####D#####
enemies 2

1
2
###########
##e#......#
##?.......#
#e#.......#
#.###.....#
#..#......D
#.........#
#.........#
#.........#
#.........#
#####D#####
enemies 2
sign This door will not yield without a key.

2
3
#####d#####
#e........#
#.........#
#.........#
#....#....#
D....#e..e#
#...###...#
#.........#
#.........#
#?........#
#####D#####
enemies 3
sign Only the prepared may pass.

4
2
#####d#####
#.........#
#.#.......#
#.........#
#.........#
D.........D
#.........#
#.........#
#.#.......#
#.........#
#####d#####

2
2
#####D#####
#.........#
#..#...#..#
#.#.....#.#
#.........#
#.........D
#.........#
#.........#
#.........#
#.........#
#####l#####
locked : 4

3
3
#####D#####
#.........#
#.........#
#.........#
#.........#
D...###...d
#.#..k#...#
#.#.###...#
#...#.....#
#.........#
#####D#####
key : 3

4
1
###########
##.#.....##
#.........#
#.#.#...#.#
#.........#
D..#......D
#.........#
#.#.#.#...#
#.........#
##.......##
#####D#####

6
2
#####D#####
#.........#
#......#..#
#.......#.#
#.........#
#.........#
#.........#
#.........#
#.........#
#k........#
###########
key : 5

4
0
#####D#####
#.........#
#.........#
#....#.#..#
#...##....#
#...####..D
#..##@###.#
#......#..#
#...#.#...#
#.........#
#####D#####

3
2
#####l#####
#.........#
#.#...#.#.#
#.........#
#.#.#...#.#
#.........D
#.#.#.#.#.#
#.........#
#...#.#.#.#
#.........#
#####d#####

3
4
###########
#.........#
#.........#
#.........#
#.........#
d.........#
#.........#
#.........#
#.........#
#.........#
#####D#####

4
3
#####D#####
##.....#.##
#.........#
#.#.#.#...#
#.........#
D..#.#....D
#.........#
#.#.#.#.#.#
#.........#
#..#...#.##
###########

1
3
#####D#####
#.........#
#.........#
#.........#
#...#.#...#
D...#e#...#
#...#.#...#
#.........#
#.........#
#.........#
#####d#####
boss
enemies 1

3
0
###########
#.........#
#.#...#.#.#
#.........#
#..#.#.#..#
#.........#
#.#...#.#.#
#.........#
#..#.....##
#.........#
#####D#####

6
0
#####D#####
#.........#
#.........#
#.........#
#.........#
#.........#
#.........#
#.#.....#.#
#..#...#..#
#.........#
###########

