4
3
#####.#####
#.........#
#.........#
#.#.......#
#.........#
......#...d
#.........#
#.#.....#.#
#..#......#
#..k......#
###########
key : 6

2
0
#####.#####
#.........#
#.........#
#.........#
#.........#
#....@.....
#.........#
#.........#
#.........#
#.........#
#####.#####

2
2
###########
#.........#
#.........#
#.........#
#.....#.#.#
.....##....
#...#k#.#.#
#.........#
#.........#
#.........#
#####.#####
key : 0

4
2
#####.#####
#.........#
#.........#
##..#..#..#
#.........#
...........
#......#..#
#.........#
#.........#
#....k....#
###########
key : 3

1
1
###########
#.#.......#
#.........#
#.........#
#.....#.#.#
...##.##..#
#..##.##..#
#.#.#.....#
#.........#
#.........#
#####.#####

2
3
###########
#.........#
#..#...#..#
#.#.....#.#
#.........#
..........#
#.........#
#.#.......#
#..#......#
#.........#
#####d#####

3
2
#####.#####
#k.......##
#.........#
#.........#
#......#..#
..........l
#.........#
#..#..#..##
#.........#
#.........#
#####.#####
key : 1

5
4
#####.#####
#.........#
#.........#
#.........#
#.........#
#.....#...#
#.........#
#.........#
#.........#
#X........#
###########

3
1
#####l#####
#.........#
#.#.....#.#
#.........#
#.#.#.#.#.#
...........
#.#.#.#.#.#
#.........#
#...#...#.#
#.........#
#####l#####
locked : 0

2
1
#####.#####
#......#..#
#.........#
#.........#
#...#..#..#
...........
#.........#
##.....#..#
#.........#
#.........#
#####l#####

4
4
#####.#####
#.........#
#.........#
#.........#
#.......#.#
d..#.e....#
#...#.....#
#...#.#...#
#.........#
#.........#
#####.#####
boss
enemies 1

0
0
###########
#e.......e#
#.........#
#..###....#
#..#e##...#
#..#.###..#
#..#..#...#
#..#.##...#
#.........#
#.........#
#####.#####
enemies 3
door 0 : 0 1

5
1
#####d#####
#.........#
#.........#
###.#.....#
#.........#
#..##.....#
#.#.#.....#
#.#.......#
#.........#
#.........#
#####d#####

6
1
#####d#####
#.........#
#...#..#..#
#.........#
#.........#
#......#..#
#.........#
#.........#
##..#..#..#
#.........#
###########

1
0
#####.#####
#........e#
#.....#..##
#.........#
#.........#
#?.....#...
#.........#
#.........#
#..#..#..##
#........s#
#####.#####
enemies 1
switch 0 : 0 1
sign Many have walked this path.

3
0
#####.#####
#.........#
#..#......#
#.#.......#
#.........#
#..........
#.........#
#.#.......#
#..#......#
#.........#
###########

4
1
#####l#####
#.........#
#.........#
#.........#
#.........#
#..........
#.........#
#.........#
#.........#
#.........#
#####d#####
locked : 1

3
4
###########
#.........#
#..#..#...#
#.#.......#
#.......#.#
..........#
#.......#.#
#.........#
#.........#
#.........#
#####.#####

3
3
#####d#####
#.........#
#.........#
#....#.####
#.....#.#.#
l....#.....
#.......#.#
#.....##.##
#.........#
#.........#
#####.#####
locked : 3

