1
4
###########
#.........#
#.........#
#.........#
#.........#
d......#..#
#.....###.#
#......#..#
#.........#
#.........#
#####D#####

0
0
###########
#k........#
#.#.#.#.#.#
#.........#
#..#.#.#..#
#.........D
#.#.#.#...#
#.........#
#..#...#.##
#.........#
#####D#####
key : 1

2
4
#####D#####
##.....#..#
#.........#
#...#.#.#.#
#.........#
d..#.#.#..d
#.........#
#.#.#.#.#.#
#.........#
#..#...#.##
#####l#####

4
3
#####D#####
#.........#
#..#......#
#.#.......#
#.........#
#.........D
#.........#
#.........#
#.........#
#.......#.#
###########

2
3
#####D#####
#.........#
#.#...#.#.#
#.........#
#..#.#.#..#
D.........d
#.#.#.....#
#.........#
#..#...#.##
#........k#
#####D#####
key : 2

2
5
###########
#.##......#
#.........#
#.........#
#.........#
d....e....#
#...##....#
#...#.....#
#.........#
#.........#
#####D#####
boss
enemies 1

3
0
#####D#####
#.#.....#.#
#.........#
#.........#
#..#..#...#
#.........#
#.........#
#.#..#....#
#.........#
#.........#
###########

1
3
###########
#.........#
#.........#
#.........#
#.........#
D.........d
#.........#
#.......#.#
#......#..#
#.........#
#####D#####

3
4
#####l#####
#.........#
#.........#
#.........#
#.........#
D.........D
#.....#...#
#.#.......#
#..#......#
#.........#
#####D#####
locked : 2

1
0
#####D#####
#.........#
#..##.....#
#..#......#
#.........#
#....@....D
#.........#
#.........#
#.........#
#.........#
#####D#####

3
5
#####D#####
#.........#
#.........#
#.........#
#.........#
D.........#
#.........#
#.........#
#.........#
#........X#
###########

0
1
###########
#.......ee#
#...#.#.#?#
#.........#
#....#.#..#
D.........#
#.#...#.#.#
#.........#
#.........#
#.........#
#####D#####
enemies 2
sign The brave are rewarded.

3
3
#####D#####
#.........#
#.........#
#e#..#..#.#
#.........#
#.........D
#e#..#..#.#
#.........#
#.........#
#.........#
#####D#####
enemies 2

4
4
#####D#####
##.....#..#
#.........#
#.........#
#.#..#..#.#
D.........#
#.........#
##..#..#..#
#.........#
#........k#
###########
key : 3

2
0
#####D#####
#.........#
#.........#
#.........#
#....#....#
#..###....D
#k###.....#
######....#
#..##.....#
#.........#
#####D#####
key : 0

2
2
#####D#####
#.........#
#.........#
#...#..#..#
#..#..#...#
D..##.##..D
#..#.#.#..#
#..#.#.#..#
#.........#
#.........#
###########

2
1
#####d#####
#.........#
#..#......#
#.#.......#
#.........#
D.........D
#.........#
#.......#.#
#......#..#
#.........#
###########

1
1
#####D#####
#.........#
#.........#
#.........#
#.........#
D.........l
#.........#
#.......#.#
#......#..#
#.........#
#####d#####

1
2
###########
###.......#
#####.....#
######....#
#..###....#
l.........D
#.........#
#.........#
#.........#
#.........#
#####D#####
locked : 0

