6
0
#####.#####
#.........#
#.#.......#
#.........#
#.........#
#..........
#.........#
#.........#
#.#.....#.#
#k........#
###########
key : 0

4
3
#####.#####
#.......#.#
#.........#
#.........#
#.........#
d.........#
#.........#
#.......#.#
#......#..#
#.........#
###########

5
0
#####.#####
#.........#
#.........#
#.........#
#.........#
#?...@.....
#.......#.#
#.....##..#
#.........#
#.........#
#####.#####
sign A useful tool lies just ahead.

0
2
###########
#X.#......#
#..##.....#
#.##......#
#.........#
#.........#
#.........#
#.........#
#.........#
#.........#
#####.#####

3
0
#####.#####
#.........#
#.........#
#.#..#..#.#
#.........#
#.........d
#.#..#..#.#
#.........#
#.........#
#.#.....#.#
#####.#####

3
2
#####d#####
#.........#
#.#....#..#
#..#......#
#.##..#...#
....##.....
#.###.....#
#.##..#...#
#...#.#...#
#.........#
#####.#####

7
2
#####.#####
#.........#
#.........#
#.#.....#.#
#.........#
#.........#
#..#..#...#
#.........#
#.........#
#.........#
###########

4
0
#####.#####
#?......###
#.....#.#e#
#.....#...#
#.........#
#e...#.#...
#.........#
#.........#
#.......#.#
#.........#
#####.#####
enemies 2
sign The brave are rewarded.

6
2
#####.#####
#e.#......#
#...#.....#
###.#.....#
#...e#....#
....#....e#
#..#......#
####.#....#
#.........#
#.........#
#####.#####
enemies 3

2
0
###########
#e.......e#
#.........#
#.........#
#..#e#....#
#...####..#
#...##.##.#
#...##..#.#
#......##.#
#......##.#
#####.#####
enemies 3
door 0 : 0 1

3
3
###########
#..#.....k#
#.........#
#.........#
#...#..#..#
..........#
#.........#
#..#.....##
#.........#
#.........#
#####.#####
key : 3

5
1
#####.#####
#.........#
#.#.#.....#
#.#####...#
#.#####...#
...#......l
#.#####...#
#.###.#...#
#.#.#.....#
#.........#
#####.#####

3
1
###########
#.........#
#.........#
#.........#
#......#..#
d....#.#...
#.........#
#.........#
#.........#
#.........#
#####.#####

1
2
#####.#####
#.......#.#
#...#.....#
#.....#...#
#.........#
#....e#...#
#......#..#
#......#..#
#.........#
#.........#
#####d#####
boss
enemies 1

2
2
#####d#####
#.........#
#.........#
#.........#
#.........#
#.........#
#.........#
#.......#.#
#......#..#
#.........#
#####d#####

5
2
#####.#####
###.......#
#.........#
#..###....#
#....##...#
l..#...#..#
#..##.#...#
#..#......#
#.........#
#.........#
#####.#####
locked : 0

4
1
#####.#####
#........k#
#..#..#..##
#.........#
#.........#
...........
#.........#
#.........#
#..#..#...#
#.........#
#####.#####
key : 1

6
1
#####.#####
#e........#
#.#...#...#
#.........#
#..#?#.#..#
...........
#.#.#.....#
#.........#
#........##
#s...e...e#
###########
enemies 3
switch 0 : 0 1
sign The brave are rewarded.

4
2
#####.#####
#k.....#..#
#.........#
#.........#
#.#..#..#.#
..........d
#.........#
##..#..#..#
#.........#
#.........#
#####.#####
key : 2

