4
2
#####D#####
#.........#
#......#..#
#.......#.#
#.........#
#.........D
#.........#
#.#.....#.#
#..#...#..#
#k........#
###########
key : 3

2
5
###########
#........k#
#.........#
##..#..#..#
#.........#
D.........#
#...#..#..#
#.........#
#.........#
##.....#..#
###########
key : 5

4
3
#####d#####
#.#.....#.#
#.........#
#.........#
#..#..#...#
D.........D
#.........#
#.#..#..#.#
#.........#
#.........#
###########

1
4
###########
#.........#
#.........#
#.........#
#.........#
d.........#
#.........#
#.........#
#.........#
#.........#
#####D#####

3
0
#####D#####
#.........#
#.#.#.#.#.#
#.........#
#......#..#
#.........#
#.#.#.#...#
#.........#
#..#...#..#
#.........#
###########

1
2
###########
#e#ee.....#
#.###.....#
#...#.....#
#.........#
D....#....D
#....###..#
#.....###.#
#.......#.#
#......#..#
#####D#####
enemies 3

2
1
#####D#####
#.........#
#..#...##.#
#.#.....#.#
#.........#
D......#..D
#.........#
#.......#.#
#......#..#
#.........#
###########

1
1
#####l#####
##.#...#.##
#.........#
#..#.#.#.##
#.........#
#..#......D
#k........#
##.#...#.##
#.........#
#..#......#
#####D#####
key : 0

0
1
###########
##.....#..#
#.........#
#.........#
#...#..#..#
#.........#
#.........#
#...#..#..#
#.........#
#.........#
#####l#####
locked : 0

0
3
###########
#.........#
#.........#
#.........#
#.........#
#.........#
#.........#
#.........#
#.........#
#.........#
#####l#####
locked : 3

2
0
###########
#?........#
#.........#
#.........#
#.........#
#....@....D
#.........#
#.........#
#.........#
#.........#
#####D#####
sign Many have walked this path.

3
4
#####D#####
#.........#
#.........#
#.........#
#.........#
l....e....#
#.........#
#.........#
#.........#
#.........#
#####D#####
locked : 5
boss
enemies 1

2
4
#####D#####
#.........#
#......#..#
#.......#.#
#.........#
d.........D
#.........#
#.......#.#
#......#..#
#.........#
#####D#####

2
2
#####D#####
#.........#
#..#..##..#
#.#...#k#.#
#.....#...#
D.........D
#.........#
#.........#
#.........#
#.........#
#####l#####
key : 1

3
2
#####l#####
#.........#
#.........#
#.........#
#.........#
#..#......D
#.........#
#.........#
#.........#
#.........#
#####D#####
locked : 1

4
4
#####D#####
#.........#
#.........#
#.........#
#.........#
D.........#
#.........#
#.........#
#.........#
#........X#
###########

3
3
#####D#####
####......#
####......#
#.##......#
#....##...#
D.........l
#.....#.#.#
#....#.##.#
#......#.##
#.........#
#####d#####

2
3
#####D#####
#......#..#
#..#..#...#
#..##.e#..#
#..#e###..#
D.........d
#.........#
#....#....#
#......#..#
#.........#
#####D#####
enemies 2

1
3
#####l#####
#.........#
#......#..#
#.......#.#
#.........#
D.........d
#.........#
#.#.....#.#
#..#...#..#
#.........#
#####D#####

