5
2
#####D#####
#.........#
#...#.....#
##.##.....#
#.#.#.....#
l...##....#
#..#.#....#
#.........#
#.........#
#.........#
#####D#####
locked : 1

3
2
#####D#####
##........#
#.#.......#
#.###.....#
#.#.#.....#
D...#.....D
#.........#
#..##.....#
#.........#
#.........#
#####d#####

6
0
#####D#####
#.........#
#...#.....#
#.######..#
#..####...#
#....#.#..D
#k##.#....#
#..####...#
#.........#
#.........#
#####D#####
key : 1

4
1
#####D#####
#.........#
#..#...#..#
#.#.....#.#
#.........#
#.........D
#.......#.#
##.......##
#.........#
#.........#
#####l#####
locked : 0

7
0
#####D#####
#.........#
#.........#
#.........#
#......#..#
#.........D
#.....#...#
#.........#
#.........#
#k........#
###########
key : 6

4
3
#####d#####
#.........#
##.#.....##
#.........#
#.#.#.#...#
l.........#
#..#.#.#..#
#.........#
#.#.#...#.#
#.........#
###########
locked : 2

1
2
###########
#.#.....#.#
#.........#
#.#.#...#.#
#.........#
#...#.#...d
#.........#
#...#.#.#.#
#.........#
#.#.....#.#
#####d#####

5
1
#####l#####
#.........#
#.#.#.#.#.#
#.........#
#..#.#.#..#
D.........l
#.....#.#.#
#.........#
#..#...#.##
#........k#
#####D#####
key : 0

2
2
#####d#####
#.......#.#
#...#.##..#
#...#.....#
#...#.#.#.#
#.........D
#.........#
#.........#
#.......p.#
#.........#
#####D#####

2
3
#####D#####
##.#...#..#
#.........#
#.#...#...#
#.........#
D....#.#..#
#.........#
#.#.#.#.#.#
#.........#
##.#......#
#####D#####

4
2
#####d#####
#e........#
#.#.#...#.#
#.........#
#..#...#..#
D.........l
#.#.#...#.#
#.........#
#..#...#.##
#........e#
#####D#####
enemies 2

3
1
###########
#k........#
#......#..#
#.......#.#
#.........#
#.........D
#.........#
#.#.....#.#
#......#..#
#.........#
#####D#####
key : 2

6
1
#####D#####
#.........#
#......#..#
#.#.....#.#
#.........#
D.........D
#.........#
#.#.#..##.#
#..#...#..#
#.........#
#####l#####

7
1
#####l#####
#.........#
#..#...#..#
#.#.....#.#
#.........#
D.........#
#.........#
#.........#
#.........#
#.........#
###########
locked : 6

5
0
###########
#?.....#..#
#...#.#...#
#...#..#..#
#..#@#.#..#
#..#.#....D
#.#..#....#
#.#.##....#
#.#.......#
#.........#
#####D#####
sign Something glints behind that door…

1
3
#####D#####
#.........#
#.........#
#..#.#....#
#..###e...#
d..###....#
#..###....#
#.........#
#.........#
#.........#
#####D#####
boss
enemies 1

0
3
###########
#X........#
#.........#
#.........#
#.#.#.....#
#..##.....#
#.#.......#
#.........#
###.#.....#
#.........#
#####D#####

3
3
#####D#####
#.#.....#.#
#.........#
#.#...#.#.#
#.........#
D...#.#...#
#.........#
#.#...#.#.#
#.........#
#.........#
#####d#####

6
2
#####D#####
#.........#
#.....##..#
#...##..#.#
#...##.##.#
D...##.#..#
#.........#
#.........#
#.........#
#.........#
###########

