3
2
#####D#####
#?........#
#.........#
##........#
#....#.#..#
D..##.....D
#..#..#...#
#....######
#.......###
#........e#
#####D#####
enemies 1
sign Only the prepared may pass.

4
1
#####D#####
#.........#
#..##.....#
#.#.......#
#.........#
D.........D
#.........#
#.........#
#.#.......#
#.........#
#####d#####

2
2
#####d#####
#.........#
##.#.....##
#.........#
#..#...#..#
l.........d
#....#.#..#
#.........#
#..#.....##
#.........#
#####D#####
locked : 3

1
1
###########
#.........#
#..#...#..#
#.#.....#.#
#.........#
#.........D
#.........#
#.#.......#
#..#......#
#.........#
#####l#####
locked : 1

0
2
###########
#e........#
#.........#
#.........#
#..##.....#
#..##.....#
#.###.....#
###.......#
#.........#
#.........#
#####D#####
enemies 1

4
0
#####D#####
#.........#
#..#..#..##
#.........#
#.........#
#..#......D
#.........#
#.........#
#.....#..##
#.........#
#####D#####

2
3
#####D#####
#.........#
#.#.#.#...#
#.........#
#.#.#.#.#.#
d.........D
#.#.#.#...#
#.........#
#.#.#...#.#
#.........#
#####D#####

5
1
#####d#####
#.......#.#
##.....#..#
#...#.##..#
#.##.#....#
D.........#
#.........#
#.........#
#.........#
#.........#
###########

1
2
#####D#####
#.........#
#.........#
#.........#
#.........#
D.........D
#.........#
#.......#.#
#......#..#
#.........#
#####d#####

5
0
#####D#####
#.........#
#.........#
#..#..#..##
#.........#
#.........D
#...#..#..#
#.........#
#.........#
#k.#.....##
###########
key : 0

4
2
#####D#####
#.........#
#..#......#
#.#.......#
#.........#
D.........#
#.........#
#.........#
#.........#
#........k#
###########
key : 1

3
0
###########
#..#......#
#......##.#
#.#.#####.#
#..##.#...#
#..##@....D
#.........#
#.........#
#.........#
#.........#
#####D#####

0
4
###########
#X........#
#.........#
#.....#.#.#
#.........#
#.........#
#.........#
#.....p...#
#.........#
#.........#
#####D#####

1
3
###########
#.........#
#.........#
#.........#
#.........#
D.........d
#.........#
#.........#
#.........#
#.........#
#####D#####

1
4
#####D#####
#.........#
#..#......#
#...#.....#
#...#.....#
d....e....#
#......#..#
#.........#
#.....##..#
#.........#
#####D#####
boss
enemies 1

2
1
#####l#####
#.........#
#..#......#
#k#.......#
#.........#
#.........l
#.........#
#.#.......#
#..#......#
#.........#
#####D#####
key : 3

3
3
#####D#####
#.........#
##.#...#.##
#.........#
#...#.#...#
D.........#
#..#.#.#..#
#.........#
#.#.#...#.#
#.......ee#
###########
enemies 2

3
1
#####D#####
#.........#
#.........#
#.........#
#.........#
D.........D
#.........#
#.........#
#.........#
#.........#
#####D#####

2
4
#####D#####
#.........#
##.#...#.##
#.........#
#..#.#.#..#
D.........#
#..#.#.#..#
#.........#
##.#...#.##
#........k#
###########
key : 4

