2
1
#####l#####
#k........#
##.#...#..#
#.........#
#.#.#.#.#.#
...........
#..#...#..#
#.........#
#.#.#.#...#
#.........#
#####.#####
key : 1

6
0
#####.#####
#.........#
#..#......#
#.#....#..#
#......#..#
#.........d
#.........#
#.........#
#.........#
#.........#
#####d#####

5
1
#####.#####
#e.......?#
#.......#e#
#.........#
#.........#
....#....e#
#.........#
#.........#
#.........#
#s........#
#####.#####
enemies 3
switch 0 : 0 1
sign A useful tool lies just ahead.

2
0
###########
#.........#
#.........#
#.........#
#.........#
#..........
#.........#
#.........#
#.........#
#.........#
#####d#####

4
2
###########
#.........#
#.........#
#.......#.#
#.........#
l.........#
#.#..#..#.#
#.........#
#.........#
#.........#
###########
locked : 0

3
1
#####.#####
#.........#
#.........#
#.........#
#......#..#
.......#..#
#.#.......#
#.....###.#
#.........#
#.........#
#####.#####

4
0
#####.#####
#.........#
#.........#
#....#....#
#.........#
#....@.....
#.........#
#.........#
#.........#
#.........#
#####.#####

7
2
###########
#........e#
#.........#
#.........#
#.........#
..........#
#.........#
#.........#
#.........#
#.........#
#####.#####
enemies 1

1
1
#####.#####
#.........#
#.......#.#
#.........#
#.........#
#....e....#
#.........#
#.........#
#.......#.#
#.........#
#####l#####
locked : 2
boss
enemies 1

7
1
#####.#####
#k........#
##..#..#..#
#.........#
#.........#
.....#.....
#.........#
#.........#
#...#.....#
#.........#
#####.#####
key : 2

3
0
#####d#####
#.#.......#
#.........#
#.........#
#.........#
#..........
#.........#
#.#.....#.#
#..##..#..#
#.........#
#####.#####

2
2
###########
#........e#
#.#.......#
#.........#
#.........#
......#...#
#.........#
#.........#
#.#.....#.#
#.......?e#
###########
enemies 2
door 0 : 0 1
sign Something glints behind that door…

6
1
#####.#####
#.........#
#.#.#.#.#.#
#.........#
#...#...#.#
d.........#
#.#...#.#.#
#.........#
#.......#.#
#.........#
#####.#####

8
1
#####.#####
#.........#
#.........#
#..#......#
#.##k#....#
...##......
#.#.......#
######....#
#.##......#
#.........#
###########
key : 5

8
0
#####d#####
#.........#
#.........#
#.....##..#
#...#####.#
#....#.....
#...####..#
#....###..#
#.###.....#
#.........#
###########

5
0
#####.#####
#..#.....##
#.........#
#.........#
#......#..#
#..........
#.........#
#.....#..##
#.........#
#.........#
#####.#####

7
0
#####d#####
##.....#.##
#.........#
#..#...#.##
#.........#
#..#...#...
#.........#
##.#.#...##
#.........#
#..#...#.##
#####d#####

8
2
#####.#####
#.........#
#.........#
#....#....#
#...##....#
.....#....#
#..###....#
#....#....#
#.........#
#.........#
###########

0
1
###########
#X........#
#.........#
#.........#
#.........#
#.........#
#.........#
#.........#
#.........#
#.........#
#####.#####

4
1
#####.#####
#k........#
#.#.....#.#
#.........#
#.........#
..........l
#.........#
#.........#
#.......#.#
#.........#
#####.#####
key : 0

