4
2
#####.#####
#.........#
#.........#
#.........#
#...###...#
...##.s...#
#..#e.#...#
#.####e...#
#...#.#...#
#.........#
#####.#####
enemies 2
switch 0 : 0 1

2
0
#####d#####
#.........#
#......#..#
#.......#.#
#.........#
#k.........
#.........#
#.........#
#.........#
#.........#
#####.#####
key : 0

3
1
#####.#####
#.........#
#.........#
#.........#
#.........#
..........l
#.........#
#.........#
#.........#
#.........#
#####.#####

1
1
#####.#####
#e........#
##.##.....#
##e##.....#
#.###.....#
...#e#.....
#..#......#
#.........#
#.........#
#.........#
#####.#####
enemies 3

3
0
#####.#####
#.........#
#.........#
#.........#
#..#......#
#..##.##...
#...#.#...#
#.....#...#
#..#...#..#
#.........#
#####.#####

1
0
###########
#.........#
#..#......#
#.#.......#
#.........#
#..........
#...#.....#
#.......#.#
#......#..#
#.........#
#####d#####

4
1
#####.#####
##.#...#.##
#.........#
#..#.....##
#.........#
d..#.#.....
#.........#
#..#...#.##
#.........#
##.#...#.##
#####l#####

2
2
#####.#####
##s#...#.##
#.........#
#...#.#.#.#
#.........#
...#.#.#..#
#.........#
#...#...#.#
#.........#
##.#...#.##
#####.#####
switch 1 : 2

0
1
###########
#e.......e#
#e........#
#.........#
#.........#
#.........#
#.........#
#.........#
#.........#
#.........#
#####.#####
enemies 3
door 0 : 0 1

5
1
#####l#####
#..#.....##
#.........#
#.........#
#..#..#...#
#..........
#.........#
#..#......#
#.........#
#.........#
#####l#####
locked : 0

5
2
#####.#####
#.........#
#..#......#
#.###.....#
#.#.......#
..........#
#.........#
#.........#
#.........#
#........k#
###########
key : 3

4
0
#####.#####
#.........#
#.........#
#.........#
#...@.....#
#....##...d
#....##...#
#....###.##
#.........#
#?......#.#
###########
sign The dungeon remembers all who enter.

3
2
#####.#####
#.........#
#..#......#
#.#.......#
#.........#
l..........
#.........#
#.........#
#.........#
#.........#
#####.#####
locked : 2

1
2
###########
#..#......#
#.........#
#.........#
#.#.......#
...####....
#..#.##...#
#.#..#....#
#.e#......#
#e#.......#
#####.#####
enemies 2
door 1 : 2

6
1
#####l#####
#.........#
#.........#
#.........#
#.........#
#....e....#
#.........#
#.........#
#.........#
#.........#
#####.#####
locked : 3
boss
enemies 1

2
1
#####.#####
#k........#
#.#.....#.#
#.........#
#.........#
...........
#.........#
#.........#
#.#.....#.#
#.........#
#####.#####
key : 2

7
1
#####.#####
#.#.......#
#.........#
#.#.......#
#.........#
#....##...#
#......#..#
#.....#...#
#.......#.#
#......#X.#
###########

1
3
###########
#.........#
#......#..#
#.......#.#
#.........#
..........#
#.........#
#.#.......#
#..#......#
#.........#
###########

3
3
###########
##.#...#..#
#.........#
##.#.....##
#.........#
...#.#....#
#.........#
##.#.#...##
#.........#
##.#...#k##
###########
key : 4

