3
4
###########
#........k#
#.........#
#.........#
#.........#
..........#
#.........#
#.........#
#.........#
#.........#
#####.#####
key : 5

2
1
###########
#......#..#
#.........#
#.........#
#.........#
..........#
#.........#
#.#.......#
#.........#
#.........#
#####.#####

3
2
###########
#......k..#
#......#..#
#.......#.#
#.........#
...........
#......#..#
#.........#
#.#.......#
#.........#
#####.#####
key : 0

4
4
#####.#####
#.........#
#.........#
#.........#
#.........#
...#......l
#.##..#...#
#.##..#...#
#.?##.#...#
#e##......#
#####d#####
enemies 1
sign A locked path — look elsewhere first.

4
3
#####.#####
#.........#
#.....##..#
#....###..#
#...#...#.#
d...#.##...
#...#.#.#.#
#.........#
#.........#
#.........#
#####d#####

3
1
#####.#####
#.........#
#......#..#
#.......#.#
#.........#
...........
#.........#
#.#.......#
#..#......#
#.........#
#####.#####

0
0
###########
#.........#
#.........#
#.........#
#.........#
#..........
#.........#
#.........#
#.........#
#.........#
#####d#####

2
0
#####.#####
##........#
##........#
##.#......#
#.##@.....#
#....#.....
#.........#
#.........#
#.........#
#.........#
#####.#####

4
1
#####.#####
#.........#
#..#......#
#.#.......#
#.........#
#..........
#.........#
#.........#
#.........#
#k........#
###########
key : 2

5
4
#####d#####
#.........#
#.........#
#.........#
#.........#
...........
#.....###.#
#.....#...#
#.....#...#
#.........#
###########

4
2
#####.#####
#.........#
#.........#
#.........#
#.........#
..........d
#.........#
#.........#
#.........#
#.........#
#####.#####

3
0
#####.#####
#.........#
#.........#
#.........#
#.........#
#..........
#.........#
#.........#
#......#..#
#e........#
###########
enemies 1

4
5
###########
#.........#
#.........#
#.........#
#.........#
l....e....#
#.........#
#.........#
#.........#
#.........#
#####.#####
locked : 3
boss
enemies 1

3
3
###########
##........#
#.........#
#.........#
#.#.....#.#
...........
#.........#
##.....#..#
#.........#
#.........#
#####.#####

0
1
###########
#........k#
##.#...#.##
#.........#
#.#...#.#.#
..........#
#..#......#
#.........#
#.#...#.#.#
#.........#
###########
key : 3

1
0
#####d#####
#.........#
#..#......#
#.#.......#
#.........#
#.........#
#.........#
#.#.....#.#
#..#...#..#
#.........#
#####.#####

5
3
#####d#####
#.........#
#.#.#.#...#
#.........#
#..#.#.#..#
...........
#.#.#.#...#
#.........#
#..#...#..#
#.........#
###########

5
5
#####.#####
#.........#
#.........#
#.........#
#...#.....#
..........#
#.........#
#.........#
#.........#
#........X#
###########

5
2
#####.#####
#.........#
#.........#
#.#.##....#
#....##...#
#..#..#....
#e#e#.....#
#...#.#...#
#.........#
#e........#
###########
enemies 3

