2
2
###########
#.##......#
#.###.....#
#.##.###..#
#.##.##...#
D....##...#
#.........#
#.........#
#.........#
#.........#
#####D#####

4
1
#####D#####
#.........#
#......#..#
#.......#.#
#.........#
d.........D
#.........#
#.......#.#
#......#..#
#.........#
#####D#####

5
3
#####D#####
#........e#
#.....#..##
#.........#
#.........#
D..#......l
#.........#
#.........#
#..#..#..##
#........?#
#####D#####
enemies 1
sign A locked path — look elsewhere first.

3
2
#####D#####
#.........#
#..#...#..#
#.......#.#
#.........#
D.........#
#.........#
#.#.......#
#..#......#
#.........#
#####D#####

6
4
#####D#####
#.........#
#.........#
#.........#
#.........#
D......p..#
#.........#
#......p..#
#.........#
#........X#
###########

4
2
#####D#####
##.....#..#
#.........#
##.#.#...##
#.........#
D..#...#..D
#.........#
##.#.#.#.##
#.........#
#..#...#.##
#####d#####

2
1
#####d#####
#......##e#
#.....##..#
#.........#
#.........#
#..e#.....D
#..#e#.p..#
#..#.#..p.#
#.........#
#.........#
#####D#####
enemies 3

3
1
#####D#####
#.........#
#.........#
#.........#
#.........#
D..#......D
#.##......#
##........#
#.........#
#.........#
#####D#####

0
1
###########
##k#...#.##
#.........#
#.#.#.....#
#.........#
#..#.#.#..#
#.........#
#.#...#...#
#.........#
##.#...#.##
#####D#####
key : 3

6
1
#####D#####
#.........#
##........#
#.#.......#
#.##......#
#.........D
#.........#
#.........#
#.........#
#.........#
###########

6
2
#####D#####
#k#.....#.#
#.........#
#.#.#.#...#
#.........#
D...#.#...D
#.........#
#.#...#.#.#
#.........#
#.#.....#.#
###########
key : 1

5
4
###########
#.........#
##.##.....#
###.......#
#..#......#
l..#.e....#
#..##.#...#
#.....#.#.#
#.....###.#
#.........#
#####D#####
locked : 3
boss
enemies 1

4
3
###########
#.......ee#
#........?#
##........#
#.##......#
D.........#
#....#....#
#..##.....#
#..#......#
#.........#
#####D#####
enemies 2
sign The dungeon remembers all who enter.

1
1
#####D#####
#.........#
#......#..#
#.......#.#
#.........#
#.........#
#.........#
#.#.......#
#..#......#
#.........#
#####d#####

5
2
#####d#####
#.........#
#...#.#.#.#
#.........#
#...#.....#
d.........D
#.#.....#.#
#.........#
#.#.#.#...#
#.........#
#####D#####

4
0
#####D#####
#..#......#
#.........#
#.........#
#.........#
#....@#...d
#......##.#
#......#..#
#..#......#
#.........#
###########

6
3
#####D#####
#.........#
#.........#
#.........#
#.........#
D....##...D
#...#k#...#
#...#.....#
#.....#...#
#..#......#
###########
key : 4

5
1
#####D#####
##.#...#.##
#k........#
##.#.#.#.##
#.........#
#..#......d
#.........#
##.#...#..#
#.........#
##.....#..#
#####D#####
key : 0

3
0
###########
#.........#
###.......#
#.........#
#.........#
#.........D
#.........#
#.........#
#.........#
#.........#
#####D#####

