3
3
#####D#####
#.......#k#
#.........#
#.........#
#..#..#...#
D.........D
#.........#
#....#..#.#
#.........#
#.........#
#####l#####
key : 2

1
3
###########
#.?...e...#
#.#...#.#.#
#.........#
#.........#
D.........D
#.#.#...#.#
#.........#
#.#...#...#
#.........#
#####D#####
enemies 1
sign Seek the matching key before you proceed.

3
0
###########
#.........#
#.#.#.#.#.#
#.........#
#...#.#...#
#.........D
#.#.#.#.#.#
#.........#
#...#...#.#
#.........#
#####D#####

3
2
#####d#####
#k........#
#.#.....#.#
#.........#
#.........#
D..#......D
#.........#
#.........#
#.#.....#.#
#.........#
#####D#####
key : 1

3
4
#####D#####
#.........#
#......#..#
#.......#.#
#.........#
D.........#
#.........#
#.......#.#
#......#..#
#.........#
###########

3
1
###########
##.....#.##
#.........#
#...#...#.#
#.........#
D..#.#....D
#.........#
#.#.#...#.#
#.........#
#..#...#.##
#####l#####
locked : 0

5
1
#####d#####
##.....#..#
#.........#
##.#.#.#.##
#.........#
D..#...#..D
#.........#
##.#.#.#.##
#.........#
##.....#..#
###########

0
4
###########
#X........#
#.........#
#..##.#...#
#.#.#.....#
#.....#...#
#.##..#...#
#..#.#....#
#..p......#
#.........#
#####D#####

5
2
#####D#####
#.........#
#.........#
#.........#
#.........#
D.........#
#.........#
#.#.......#
#..#......#
#.........#
###########

4
0
#####D#####
#.........#
#.p.......#
#.........#
#...@.#...#
#....###..D
#..p....#.#
#.........#
#......##.#
#.........#
#####D#####

4
2
#####D#####
#k........#
#......#..#
#.......#.#
#.........#
D.........D
#.........#
#.#.......#
#..#......#
#.........#
#####D#####
key : 0

1
4
#####D#####
#.........#
##........#
##...#....#
#.##e.....#
D...##....#
#.........#
#.........#
#.........#
#.........#
#####d#####
boss
enemies 1

5
0
#####D#####
#.........#
#.........#
#.#..#..#.#
#.........#
#.........D
#.#.....#.#
#.........#
#.........#
#.#.......#
###########

2
4
#####d#####
#.........#
#......#..#
#.......#.#
#.........#
d.........#
#.........#
#.##....#.#
#..#...#..#
#.........#
#####D#####

4
1
#####l#####
#e........#
#.....p...#
#.........#
#.........#
D.........D
#.........#
#..p......#
#.........#
#e........#
#####d#####
enemies 2

2
2
#####D#####
#..#......#
##....#...#
#.#..#....#
#.........#
#.........l
#.........#
#.........#
#.........#
#.........#
#####d#####

4
3
#####l#####
#.........#
#.........#
##.#......#
#..#......#
D...###...#
#..###..#.#
##.##.##..#
#...#.###.#
#......#..#
###########
locked : 2

1
2
###########
#.k#......#
#.##..#...#
#..###.#..#
#.#.##.#..#
#.........D
#..#......#
#.........#
#.........#
#.........#
#####D#####
key : 4

2
3
#####D#####
#.........#
#.........#
#.........#
#.........#
l.........d
#.........#
#.........#
#.........#
#.........#
#####D#####
locked : 4

