3
3
#####d#####
#.........#
#.........#
#.........#
#.........#
...........
#.........#
#.........#
#.........#
#.........#
#####d#####

1
1
#####.#####
#.........#
#.........#
#..#.#.#..#
#.........#
....#.#...l
#.........#
#..#.#.#..#
#.........#
#k#.......#
#####.#####
key : 0

3
4
#####l#####
#.........#
#.........#
#.........#
#.........#
.....e....#
#.....#...#
#.....#...#
#.....#...#
#.........#
#####.#####
locked : 3
boss
enemies 1

2
2
#####l#####
#.........#
#.........#
#.........#
#.##......#
..........d
#.###.....#
#..#.#....#
#.........#
#.........#
#####d#####
locked : 2

2
1
#####.#####
#k........#
#.#.......#
#.........#
#.........#
...#.......
#.........#
#.........#
#.#.....#.#
#.........#
#####.#####
key : 2

1
2
#####.#####
#.........#
##.#...#..#
#.........#
#..#.#....#
l..........
#....#....#
#.........#
#......#.##
#.........#
#####l#####
locked : 1

3
2
#####d#####
#.........#
#.........#
#.........#
#.........#
...........
#.........#
#.........#
#.........#
#.........#
###########

2
5
###########
#........e#
#.........#
#.........#
#.###.....#
...##.....#
#.#..#....#
#...##..#.#
#...#.#...#
#.........#
###########
enemies 1

1
0
###########
##........#
##........#
##..#.....#
#?#.......#
#....@.....
#.........#
#.........#
#.........#
#.........#
#####.#####
sign Something glints behind that door…

4
3
#####d#####
#.#.......#
#.........#
#.#.#.#.#.#
#.........#
#...#.#....
#.........#
#.#...#.#.#
#.........#
#.#.....#.#
###########

2
0
#####.#####
#.........#
#...#.#...#
#.........#
#.#.#.#.#.#
#..........
#.#.#.#.#.#
#.........#
#.#.#.#.#.#
#.........#
#####.#####

2
3
#####.#####
#.........#
#..#......#
#.#.......#
#.........#
d..........
#.........#
#.#.......#
#..#......#
#.........#
#####d#####

4
4
#####.#####
#.........#
#.........#
#.......#.#
#......##.#
...##.#...#
#..##.....#
#.#.#.....#
#.........#
#........X#
###########

0
1
###########
#.........#
#.........#
#.........#
#.........#
#..........
#.........#
#.........#
#.........#
#.........#
#####.#####

0
2
###########
#.#.....#k#
#.........#
#.........#
#..#..#...#
..........#
#.........#
#.#..#..#.#
#.........#
#.........#
#####.#####
key : 3

3
0
#####.#####
#.........#
#.#.......#
#.........#
#.........#
#..#..#....
#.........#
#.........#
#.#.....#.#
#k........#
###########
key : 1

1
3
###########
#.......#.#
#.........#
#..#.#.#.##
#.........#
....#.....#
#.........#
#....#.#.##
#.........#
#.#.......#
#####.#####

3
1
#####.#####
#.........#
#.........#
#.........#
#.........#
...........
#.........#
#.........#
#.........#
#.........#
###########

2
4
###########
#e..?e....#
#.........#
#.........#
#.......#.#
...........
#.........#
#.........#
#.........#
#e.#......#
#####l#####
enemies 3
sign This door will not yield without a key.

