3
3
###########
#.##.....X#
#.........#
#.####....#
#.###.....#
D..###....#
#.........#
#.........#
#.........#
#.........#
#####D#####

4
3
#####D#####
#.........#
#.##......#
#.#...#...#
#.#.#.....#
D.........#
#.........#
#.........#
#.........#
#........e#
###########
enemies 1
door 0 : 0 1

5
0
#####D#####
#e.......e#
##.....#.##
#s........#
#e#.....#.#
#.........D
#....#.#..#
#.........#
#...#.#.#.#
#.........#
#####d#####
enemies 3
switch 0 : 0 1

6
0
#####d#####
#.......#.#
#.........#
#.........#
#.........#
#.........D
#.........#
#.#.......#
#..#......#
#.........#
#####D#####

2
1
#####D#####
#.........#
#.........#
#.........#
#..#k###..#
D...#..#..D
#..#..##..#
#..#.###..#
#.....#...#
#.........#
#####D#####
key : 0

0
1
###########
#.........#
#.........#
#...#..#..#
#.........#
#.........#
#......#..#
#.........#
#.........#
##........#
#####d#####

2
2
###########
#......#k.#
#...#.###.#
#...#.#.#.#
#...###.#.#
D....##...#
#.........#
#.........#
#.........#
#.........#
#####D#####
key : 7

3
1
#####D#####
##.#...#..#
#.........#
#.#...#...#
#.........#
D..#.#.#..D
#.........#
#.#.#.#...#
#.........#
##.#...#.##
#####D#####

3
2
#####D#####
#.........#
#.........#
#.........#
#....#.#..#
D....e.#..D
#.....###.#
#...##..#.#
#.........#
#.........#
#####d#####
boss
enemies 1

7
0
#####D#####
#.........#
#.........#
#.........#
#.........#
#.........#
#.........#
#.........#
#e........#
#e?......e#
###########
enemies 3
sign Beware what lurks ahead.

4
1
#####D#####
#.........#
#..#......#
##k##.....#
#.#.#.....#
D...#.....d
#.#.#.....#
#.........#
#.........#
#.........#
#####D#####
key : 2

6
1
#####D#####
#.........#
#.........#
#...##..#.#
#......##.#
D...#.#...#
#....##...#
#....#.##.#
#...#.....#
#........k#
###########
key : 5

4
0
#####D#####
#.........#
#.........#
#.........#
#.........#
#.........D
#.........#
#.........#
#.........#
#.........#
#####D#####

2
0
#####D#####
#.......#.#
#.........#
#..#...#.##
#.........#
#...#.....D
#.........#
#..#.#.#.##
#.........#
#.......#.#
#####l#####

4
2
#####d#####
#......#.##
#.....##.##
#....###..#
#..##.##..#
d..#......D
#.........#
##.##.....#
###.......#
#.........#
###########

1
0
###########
#?........#
#..##.....#
#..##.....#
#.###.....#
#..#.@....D
#.#..#....#
#.#..#....#
#..##.....#
###.......#
#####D#####
sign The dungeon remembers all who enter.

3
0
#####l#####
##.#......#
#..##.....#
#.#.......#
#...#.....#
#...#.....D
#.........#
#.........#
#.........#
#.........#
#####D#####
locked : 0

1
1
#####d#####
#..#......#
#..?p.#...#
#..#..##..#
#..#..e#pe#
D..##.#...#
#.........#
#.........#
#.........#
#.........#
#####D#####
enemies 2
sign Those who search shall find.

5
1
#####D#####
#.........#
#..#......#
#.#.....#.#
#......#..#
D.........#
#.........#
#.#.#.....#
#..#......#
#.........#
#####D#####

