0
1
###########
#.........#
#..#......#
#.#.....#.#
#.........#
#.........#
#.........#
#.....#.#.#
#.........#
#.........#
#####d#####

5
1
#####D#####
#.........#
##.#...#.##
#.........#
#.#.#.#...#
#.........D
#..#.#.#..#
#.........#
#.#...#.#.#
#.........#
###########

3
1
#####D#####
#.........#
#.........#
#.........#
#.........#
D...###...#
#...##.##.#
#...#...#.#
#...#.#.#.#
#......##.#
#####D#####

2
3
###########
#........##
#.........#
#.........#
#.........#
D.........D
#.........#
#.#.......#
#..#......#
#.#k......#
###########
key : 3

4
0
#####D#####
#.........#
#.........#
#.........#
#.........#
#....@....D
#.........#
#.........#
#.........#
#.........#
###########

4
2
###########
##e#?..#e##
#.........#
#...#.#.#.#
#.........#
D....#....D
#.........#
#.....#.#.#
#.........#
#..#...#.##
#####l#####
enemies 2
sign Turn back; you are not yet ready.

2
4
###########
#.........#
#.....##..#
#....#.##.#
#....#.##.#
D...#..#..l
#.......#.#
#.........#
#.........#
#.........#
#####d#####

3
0
###########
#k........#
#.........#
#.........#
#.##.p###.#
#..#.#....D
#....#.#..#
#.........#
#.........#
#.........#
#####D#####
key : 0

2
1
#####D#####
#.........#
#......#..#
#.......#.#
#.........#
#k........d
#.........#
#.........#
#.........#
#.........#
#####D#####
key : 1

4
1
#####D#####
#e.......e#
#.........#
#.........#
#.........#
D.........D
#.........#
#.........#
#.........#
#e........#
#####D#####
enemies 3

3
4
#####d#####
##.#......#
#..#......#
#.###.....#
#.###...p.#
#....e....D
#.........#
#.........#
#.........#
#.........#
#####D#####
boss
enemies 1

2
5
###########
#.........#
#.........#
#.........#
#...#.....#
l.........#
#.........#
#.........#
#.........#
#.........#
#####D#####
locked : 2

5
2
#####l#####
#.........#
#.........#
#..#..#...#
#.........#
D.........#
#...#.....#
#.........#
#.........#
#........##
###########
locked : 1

1
1
#####d#####
#.#.....#.#
#.........#
#.#.....#.#
#.........#
#...#.#...l
#.........#
#.#.#.#.#.#
#.........#
#.#.....#.#
#####D#####

2
2
#####D#####
#.........#
#.........#
#.....#...#
#..#......#
d....#....D
#.##......#
#.........#
#.........#
#.........#
###########

4
3
###########
#.....k##.#
#.....#...#
#....###..#
#.....##..#
D....#....D
#.........#
#.........#
#.........#
#.........#
###########
key : 2

4
4
#####D#####
#........p#
#.........#
#.#..##...#
#.##.#....#
D....##...#
#.##..#...#
#.#.##....#
#.........#
#........X#
###########

3
5
#####D#####
#.........#
#.........#
#.........#
#.........#
D.........#
#.........#
#.........#
#.........#
#.......?e#
###########
enemies 1
sign Only the prepared may pass.

1
2
###########
#.........#
##..#..#..#
#.........#
#.........#
l...#..#..#
#.........#
#.........#
##.....#..#
#.........#
#####D#####
locked : 3

