6
1
#####d#####
#.........#
#.........#
#..#......#
#.........#
D.........D
#..#......#
#.........#
#.........#
#........##
#####d#####

6
0
#####D#####
#.........#
#.........#
#.........#
#.........#
#....@....D
#...#.....#
#.##..#.#.#
#.##..#...#
#.........#
###########

4
1
#####d#####
#.........#
#.........#
#..#.#.#..#
#.........#
#.........D
#.........#
#....#.#.##
#.........#
#.......#k#
#####D#####
key : 0

3
4
###########
#......#.k#
#.........#
#.........#
#.........#
D.........#
#.........#
#.#.....#.#
#..#...#..#
#.........#
#####D#####
key : 4

1
3
#####D#####
#.#.......#
#.........#
#....##...#
#.........#
#...#e#...#
#....#....#
#....#....#
#.........#
#.........#
#####l#####
locked : 3
boss
enemies 1

5
3
#####D#####
#.........#
#.........#
#.........#
#.........#
D.........#
#.........#
#.........#
#.........#
#........e#
###########
enemies 1

4
5
###########
#.........#
#.........#
#.........#
#.........#
d..#..#...#
#.........#
#.........#
#.#.......#
#.........#
###########

0
3
###########
#X........#
#......#..#
#.........#
#.........#
#.........#
#.........#
#.........#
#.........#
#.........#
#####D#####

2
3
#####l#####
#.........#
#......#.##
#.......#.#
#.........#
#.........#
#....#....#
#.........#
#.......#.#
#.........#
#####l#####
locked : 4

4
4
#####D#####
#.......#.#
#.........#
#..#.#.#..#
#.........#
D...#.#...d
#.........#
#..#...#.##
#.........#
#.#.....#.#
###########

3
1
###########
#.........#
#......#..#
#.......#.#
#.........#
#.........#
#.........#
#.#.......#
#..#......#
#.........#
#####d#####

5
1
#####D#####
#.........#
#..#...#..#
#.#.....#.#
#.........#
D.........l
#.........#
#.#.......#
#..#......#
#.........#
#####d#####

6
2
#####D#####
#.........#
#......#..#
#.......#.#
#.........#
D.........#
#.........#
#.......#.#
#......#..#
#.........#
###########

5
0
###########
#.........#
#.....#...#
#.........#
#.........#
#.........D
#.........#
#.....#.#.#
#......#..#
#.#.......#
#####D#####

5
2
#####D#####
#.........#
#..#...#..#
#.#...#.#.#
#.........#
l.........D
#.........#
#.#.......#
#..#......#
##........#
#####D#####
locked : 0

4
3
#####D#####
##.....#..#
#.........#
#.........#
#......#..#
D.........D
#.........#
##..#..#..#
#.........#
#k........#
#####D#####
key : 3

7
1
#####d#####
#.........#
#.........#
#.........#
#.........#
#.........#
#.........#
#.......#.#
#......#..#
#.........#
###########

3
3
#####l#####
#..#......#
#.........#
#.........#
#.........#
#.........D
#.........#
#.........#
#.........#
#.........#
#####D#####

4
2
###########
#....k....#
#.........#
#.........#
#.........#
D.........D
#.........#
#.........#
#.........#
#.........#
#####D#####
key : 2

