3
0
#####D#####
#.........#
#.........#
#.........#
#.........#
#....@....D
#.........#
#.........#
#.........#
#.........#
#####D#####

1
1
#####D#####
#.........#
#.#...#.#.#
#.........#
#.#...#.#.#
#.........D
#.....#...#
#.........#
#.#.#.#.#.#
#.........#
#####D#####

2
1
#####D#####
##........#
#.........#
#.........#
#...#..#..#
D.........D
#.........#
#...#..#..#
#.........#
#.........#
#####D#####

2
0
###########
#.........#
#.#.....#.#
#.........#
#.........#
#....#....D
#.........#
#.........#
#.#.......#
#.........#
#####D#####

4
0
#####D#####
#.........#
#..#.....##
#.........#
#.........#
#..#..#...D
#.........#
#.........#
#..#..#..##
#.........#
###########

2
3
#####d#####
#e........#
#.........#
##........#
#.........#
D....#....D
#.#.#e....#
#.#..p....#
#.........#
#?.....p..#
#####D#####
enemies 2
sign A useful tool lies just ahead.

3
3
#####D#####
#.........#
#.........#
#.........#
#.........#
D..#......#
#.##......#
#####.....#
##..#.....#
##.......k#
###########
key : 4

2
4
#####D#####
#.........#
#.....#.#.#
#.........#
#.#.#.#.#.#
D.........#
#.#.#.#.#.#
#.........#
#...#.#.#.#
#........k#
###########
key : 3

0
1
###########
#k........#
#......#..#
#.......#.#
#.........#
#.........#
#.........#
#.......#.#
#......#..#
#.........#
#####D#####
key : 0

4
1
#####d#####
#.........#
#..#...#..#
#.#.....#.#
#.........#
D.........#
#.........#
#.......#.#
#......#..#
#.........#
###########

1
3
#####d#####
#.........#
#.........#
#.#..#..#.#
#.........#
D.........l
#.....#...#
#.........#
#.........#
#.#.....#.#
#####d#####

1
4
#####D#####
#.........#
#.........#
#.........#
#.........#
l....e....D
#.........#
#.........#
#.........#
#.........#
#####D#####
locked : 4
boss
enemies 1

2
2
#####D#####
#.........#
#.........#
#.#.....#.#
#.........#
D.........D
#.....#...#
#.........#
#.........#
#.#.....#.#
#####d#####

3
1
#####D#####
#e........#
#.........#
#..#.#...##
#...e##...#
D..###....D
#..#?..#..#
#..#.###..#
#.........#
#e........#
#####d#####
enemies 3
sign Beware what lurks ahead.

0
3
###########
#.........#
#.........#
#.........#
#.........#
#.........D
#..#.#....#
#.#.......#
#..#......#
#.........#
#####d#####

0
4
###########
#.......ee#
#........?#
#.........#
#.........#
D.........#
#.........#
#.........#
#.........#
#.........#
#####D#####
enemies 2
sign A locked path — look elsewhere first.

1
5
###########
#......#.X#
#..#......#
#..##.....#
#....##...#
D..#.##...#
#.........#
#.........#
#.........#
#.........#
###########

1
2
###########
#....k....#
#.........#
#.........#
#.........#
D.........D
#.........#
#.........#
#.........#
#.........#
#####D#####
key : 7

3
2
#####d#####
#.........#
#.........#
#.........#
#...#.....#
D..##.....D
#.#.#.....#
#.........#
#.........#
#.........#
###########

