2
0
###########
#........##
#.....##..#
#.....###.#
#......##.#
#......#...
#.....#.#.#
#.........#
#.........#
#.........#
#####.#####

1
1
#####.#####
#.......#.#
#..#......#
#.#.......#
#.....#...#
#..........
#.........#
#.#.......#
#..#......#
#.........#
#####.#####

4
1
#####d#####
#.........#
#..#......#
#.#.......#
#.........#
..........#
#.........#
#.......#.#
#......#..#
#.........#
###########

1
4
#####.#####
#.........#
#.........#
#.........#
#.........#
l....e.....
#.........#
#.........#
#.........#
#.........#
#####.#####
locked : 4
boss
enemies 1

0
4
###########
#..#?...e##
#........e#
#.........#
#..#......#
..........#
#.........#
#..#.....##
#.........#
#.........#
#####.#####
enemies 2
sign A locked path — look elsewhere first.

2
1
#####.#####
#.......#.#
#.........#
#.........#
#.....#...#
...........
#....#.#..#
#...#...#.#
#.....#.#.#
#.........#
#####.#####

2
2
#####.#####
#.#.....#.#
#.........#
#..#...#.##
#.........#
....#.#....
#.........#
#....#.#.##
#.........#
#.......#.#
#####d#####

1
5
###########
#.#......X#
#..#......#
#.#.......#
#.........#
..........#
#.........#
#.........#
#.........#
#.........#
###########

3
0
#####.#####
#.........#
#.........#
#.........#
#.........#
#....@.....
#.........#
#.........#
#.........#
#.........#
#####.#####

0
1
###########
#k........#
#..#......#
#.#.......#
#.........#
#.........#
#.........#
#.#..#....#
#..#......#
#.........#
#####.#####
key : 0

1
3
#####d#####
#.........#
#.........#
#.........#
#.........#
...##.....l
#..#......#
#.........#
#.........#
#.........#
#####d#####

1
2
###########
#.........#
#.........#
#.#.....#.#
#.........#
...........
#.....#...#
#.........#
#.........#
#k#.....#.#
#####.#####
key : 7

3
1
#####.#####
#e........#
#.........#
#..#.#...##
#...e##...#
...###.....
#..#?..#..#
#..#.###..#
#.........#
#e........#
#####d#####
enemies 3
sign Beware what lurks ahead.

4
0
#####.#####
#.........#
#.........#
#.........#
#.........#
#..........
#..#.#....#
#.#.......#
#..#......#
#.........#
###########

3
3
#####.#####
#.........#
#.#.....#.#
#.........#
#.........#
...#......#
#.........#
#.........#
#.#.....#.#
#........k#
###########
key : 4

0
3
###########
#.........#
#.#.#...#.#
#.........#
#.#.#.#.#.#
#..........
#.#.#.#.#.#
#.........#
#.......#.#
#.........#
#####d#####

3
2
#####d#####
#.........#
#.........#
#.........#
#.........#
...........
#.........#
#.........#
#.........#
#.........#
###########

2
4
#####.#####
#.........#
#.........#
#.........#
#...#.....#
...##.....#
#.#.#.....#
#.........#
#.........#
#........k#
###########
key : 3

2
3
#####d#####
#e.......?#
#.........#
#.........#
#.........#
...........
#.........#
#.........#
#.........#
#e........#
#####.#####
enemies 2
sign A useful tool lies just ahead.

