3
0
#####.#####
#.........#
#.#....##.#
#.#####...#
#.#.#.#...#
#...#......
#..##.#...#
#.........#
#.........#
#......#..#
#####.#####

4
3
#####.#####
#.........#
#...#.#.#.#
#.........#
#.#.#.#...#
..........#
#...#.#...#
#.........#
#.#.#.#..?#
#.....e.ee#
###########
enemies 3
sign Beware what lurks ahead.

2
3
###########
#.........#
#..#..##..#
##.##.....#
#.#..##...#
d..#......#
#....##...#
#.........#
#.........#
#.........#
#####.#####

3
3
#####.#####
#.#.......#
#.#.#.....#
#.###.#...#
#.........#
d.........#
#.........#
#.........#
#.........#
#.........#
#####.#####

0
0
###########
#k........#
#..#......#
#.#.......#
#.........#
#.........#
#.........#
#.........#
#.........#
#.........#
#####.#####
key : 1

3
2
#####.#####
#.........#
#..#...#..#
#.#.....#.#
#.........#
l.........d
#.........#
#.#.......#
#.##...#..#
#.#.......#
#####.#####
locked : 0

2
1
#####.#####
#e.#...#..#
#...#.#...#
#...e##...#
#..##e.#..#
....##.#..d
#.........#
#.....#...#
#.....###.#
#?........#
#####.#####
enemies 3
sign A useful tool lies just ahead.

5
2
#####.#####
#.........#
#..#......#
#.#.......#
#.........#
..........#
#.........#
#.......#.#
#......#..#
#........k#
###########
key : 4

6
1
#####.#####
###.......#
##........#
#.####....#
#.#.#.....#
#...##....#
#.........#
#.........#
#.........#
#X........#
###########

1
2
###########
##.#....k##
#.........#
##.#.#.#..#
#.........#
...#.#.#..#
#.........#
##.#...#.##
#.........#
##.#.....##
#####.#####
key : 2

3
1
#####.#####
#e.......e#
#..#...#.##
#.........#
#..#.#.#..#
..........l
#..#...#..#
#.........#
#..#...#..#
#.........#
#####l#####
enemies 2

4
2
#####.#####
#.........#
#..#......#
#.#.......#
#.........#
...........
#.........#
#.#.......#
#..#......#
#.........#
#####.#####

2
2
#####.#####
#.........#
#.#.....#.#
#.........#
#.........#
d.....#...d
#.........#
#.........#
#.#.....#.#
#.........#
#####.#####

1
1
###########
#.....k...#
#..#..#..##
#.........#
#.........#
....#..#...
#.........#
#.........#
#..#..#..##
#.........#
#####.#####
key : 0

4
1
#####l#####
#.........#
#.........#
#.........#
#.........#
...........
#.........#
#.........#
#.........#
#.........#
#####d#####
locked : 1

4
0
#####.#####
#.........#
##.....#..#
#.........#
#.........#
#....#.....
#.........#
#.........#
##..#..#..#
#.........#
###########

2
0
#####.#####
#.........#
#.#.......#
#.........#
#.........#
#....@.....
#?#.......#
#.........#
#.........#
#.........#
#####.#####
sign The dungeon remembers all who enter.

1
0
#####.#####
#..#......#
#.........#
#.........#
#.........#
#..........
#.........#
#.........#
#.........#
#.........#
#####.#####

5
1
#####d#####
#.........#
#.....#...#
#.........#
#.........#
#....e.....
#.#.......#
#..##.....#
###.#.....#
##........#
#####.#####
boss
enemies 1

