5
3
#####D#####
#.........#
#.#.....#.#
#.........#
#.........#
D....#....#
#.........#
#.........#
#.......#.#
#.......?e#
###########
enemies 1
door 0 : 0 1
sign The dungeon remembers all who enter.

2
1
#####D#####
#.........#
#.........#
#.........#
#...#..#..#
#.........d
#.........#
#..#..#..##
#.........#
#.........#
#####D#####

0
1
###########
#.........#
#.........#
#.....#...#
#....###..#
D.........#
#.........#
#.........#
#.........#
#.........#
#####d#####

4
4
#####D#####
#.........#
#...#.#...#
#.........#
#....##...#
D....##...#
#.....##..#
#.........#
#........e#
#......?ee#
###########
enemies 3
sign Many have walked this path.

1
0
#####D#####
#.#.......#
#..##.....#
##.#......#
#..###....#
#....@....D
#.........#
#.........#
#.........#
#?........#
###########
sign Those who search shall find.

1
2
###########
#.........#
#......#..#
#.......#.#
#.........#
l.........#
#.........#
#.......#.#
#......#..#
#.........#
#####D#####
locked : 0

3
3
#####D#####
#..#.....p#
#.###.....#
#.####.#..#
#...#.#...#
D..#.e....D
#.........#
#.........#
#........p#
#.........#
#####l#####
locked : 5
boss
enemies 1

2
2
#####D#####
#.........#
#.........#
#.........#
#....#....#
d.....#...l
#...####..#
#......#..#
#p..#..p#.#
#.........#
#####D#####

3
2
#####D#####
#k........#
##.....#..#
#.........#
#.........#
D...#..#..D
#.........#
#.........#
#...#..#..#
#.........#
#####D#####
key : 2

2
3
###########
#.........#
#.........#
#.........#
#..#..#...#
l.........#
#.........#
#.#..#....#
#.........#
#.........#
#####D#####
locked : 2

5
2
#####d#####
#.........#
#........##
#....###.##
#....#.#..#
D....#....D
#.....#.#.#
#.........#
#.........#
#.........#
###########

3
1
#####D#####
#.........#
#..#......#
#k#.......#
#.........#
#.........D
#.........#
#.......#.#
#.........#
#.........#
#####D#####
key : 1

1
1
#####d#####
#.........#
#..#...#..#
#.........#
#..#...#..#
D.........l
#..#.#.#..#
#.........#
##.....#.##
#k........#
#####D#####
key : 0

4
2
#####D#####
#.#.....#.#
#.........#
#.#.#.#.#.#
#.........#
l...#.#...D
#.........#
#.#...#.#.#
#.........#
#.#.......#
#####d#####
locked : 1

5
1
#####D#####
#.........#
#.........#
#.........#
#.........#
#.........D
#.....###.#
#.......#.#
#...p.....#
#k........#
###########
key : 5

3
4
###########
#........X#
#.........#
#.#.##....#
#...###...#
D..##.#...#
#...#.....#
#.#..#....#
#.........#
#.........#
#####D#####

0
0
###########
#.........#
#........##
#.........#
#....#....#
#.........D
#..#.#.#..#
#.........#
##.#...#.##
#.........#
#####D#####

4
3
#####l#####
#.........#
#.........#
#.....##..#
#.....#...#
D...##....D
#.....#...#
#.........#
#.........#
#.........#
#####D#####

4
1
#####D#####
#.........#
#..#..#...#
#s##.#....#
#e#e###...#
#.........l
#...#.....#
#.........#
#.........#
#.........#
#####D#####
enemies 2
switch 0 : 0 1

