0
1
###########
#.........#
#.........#
#.........#
#.........#
...##......
#.#.#.....#
#.#.......#
#..##.....#
#.........#
#####l#####
locked : 0

2
1
#####.#####
##.#...#.##
#k........#
##...#.#.##
#.........#
...#...#...
#.........#
##.#...#.##
#.........#
##.....#.##
#####d#####
key : 1

4
1
#####.#####
#.........#
#.........#
#.........#
#.........#
#.........d
#.........#
#k#.....#.#
#..#...#..#
#.........#
#####d#####
key : 5

1
0
#####.#####
#.........#
#.#.#.#...#
#.........#
#....#.#..#
#..........
#.#.......#
#.........#
#......#.##
#.........#
#####.#####

0
0
###########
#.........#
#.........#
#.........#
#.........#
#..........
#.........#
#.........#
#.........#
#.........#
#####.#####

0
2
###########
#.........#
##.....#.##
#.........#
#.#.#.#.#.#
..........#
#..#.#.#..#
#.........#
#.#.....#.#
#.........#
#####d#####

2
2
#####.#####
#.##....###
#.....#..##
#.##.#.####
#.##.#.#..#
....##....#
#.........#
#.........#
#.........#
#.........#
#####.#####

1
1
#####l#####
##.....#..#
#.........#
#.........#
#.#.....#.#
...........
#.........#
##.....#..#
#.........#
#.........#
#####.#####

3
0
#####.#####
#.........#
#####.....#
#..#.#....#
#.........#
#....#.....
#...##....#
#.........#
#.........#
#k........#
###########
key : 0

2
0
#####.#####
#..#......#
##.##.....#
#....#....#
#.####....#
#..##@.....
#.........#
#.........#
#.........#
#.........#
#####.#####

1
3
###########
#.........#
#..#...#..#
#.#.....#.#
#.........#
l.........#
#.........#
#.........#
#.........#
#.........#
###########
locked : 1

5
2
#####.#####
#.........#
#.........#
#....#.##.#
#.......#.#
.....##...#
#.#..####.#
#####.#...#
#...#.....#
###.......#
###########

1
2
#####d#####
#.........#
#.........#
#..#.....##
#.........#
..........l
#..#..#...#
#.........#
#.........#
#..#......#
#####.#####

5
1
#####d#####
#.........#
##........#
#.........#
#.........#
#..........
#.........#
#.........#
#.........#
#.........#
#####.#####

4
2
#####.#####
#.........#
#.........#
#.........#
#...e.....#
d....#.#...
#.......#.#
#.......#.#
#...#...#.#
#.......#.#
#####.#####
boss
enemies 1

6
1
#####.#####
#.........#
#.........#
#.........#
#.##......#
#.........#
#.........#
#.........#
#.........#
#k........#
###########
key : 7

4
3
###########
#........X#
#.........#
#.........#
#.........#
..........#
#.........#
#.........#
#.........#
#.........#
###########

3
2
#####.#####
#.........#
#.........#
#.........#
#..#......#
...#.#....#
#.###.....#
#...#.....#
#.##......#
#.........#
#####.#####

3
1
#####d#####
#.........#
#.........#
#.........#
#.........#
...........
#.........#
#.........#
#.........#
#.........#
#####.#####

