0
0
###########
#k......#.#
#.........#
#.#.#.....#
#.........#
#...#.#....
#.........#
#.#.....#.#
#.........#
#.#.......#
#####.#####
key : 3

5
2
###########
#........k#
#..#...#..#
#.#...#.#.#
#.........#
...#......#
#.........#
#.......#.#
#......#..#
#.........#
###########
key : 1

3
3
#####d#####
#.........#
#.........#
#.........#
#.........#
.....e....#
#.........#
#.........#
#.........#
#.........#
#####.#####
boss
enemies 1

2
2
###########
#.........#
#.........#
#.........#
#.........#
d..........
#.........#
#.........#
#.........#
#.........#
#####l#####

2
1
#####.#####
#e.......e#
#?........#
##.....#..#
#.........#
..........d
#...#..#..#
#.........#
#.........#
##.....#.e#
#####.#####
enemies 3
sign A useful tool lies just ahead.

2
3
###########
#.........#
#.........#
#.........#
#.........#
......##..#
#.......#.#
#.....#.#.#
#.........#
#.........#
#####d#####

3
0
#####.#####
#.........#
#.#....#..#
#.......#.#
#.........#
#..........
#.........#
#.#.......#
#.........#
#.........#
#####l#####
locked : 0

6
0
#####.#####
#.........#
#.........#
#.........#
#.........#
#.........#
#.........#
#.#.....#.#
#..#...#..#
#k........#
###########
key : 0

3
2
#####l#####
##.#...#..#
#.........#
#.#.#.#...#
#.........#
...#.#.#...
#.........#
#.#.#.#.#.#
#.........#
##.#...#.##
###########
locked : 3

3
1
#####.#####
#k........#
#.........#
#.........#
#.........#
...........
#.........#
#.......#.#
#......#..#
#.........#
#####.#####
key : 2

5
0
#####.#####
#..#......#
#.........#
#.........#
#.........#
#...#@.....
#?##......#
###.#.....#
#.........#
#.........#
#####.#####
sign Something glints behind that door…

5
1
#####.#####
#.........#
#..#...#..#
#.#.....#.#
#.........#
...........
#.........#
#.#.......#
#..#......#
#.........#
###########

4
0
#####l#####
#......#..#
#...#..#..#
#....##...#
#...###.#.#
#..........
#.........#
#.........#
#.........#
#.........#
#####.#####

2
0
#####.#####
#.........#
#.........#
#.........#
#.........#
#..........
#......##.#
#.....##..#
#.......#.#
#.........#
#####.#####

1
1
#####d#####
#.........#
#......#..#
#.........#
#.........#
d.........#
#.........#
#.#.....#.#
#.##...#..#
#.........#
#####.#####

1
0
#####.#####
##........#
#......#..#
#.#.....#.#
#.........#
#.........d
#.........#
#.........#
#.........#
#.........#
#####.#####

4
1
#####.#####
#.........#
#..#.....##
#.........#
#.........#
...#..#...#
#.........#
#.........#
#.........#
#.........#
#####.#####

0
1
###########
#.........#
#.....#...#
#..#.###..#
#.....##..#
......#...#
#...####..#
#.........#
#.........#
#.........#
#####d#####

4
3
#####.#####
#.........#
#...#.....#
#....#....#
#.........#
#.........#
#.........#
#.........#
#.........#
#X........#
###########

