4
0
#####.#####
#......#..#
#.....##..#
#....#....#
#.........#
#....@.....
#....#....#
#.####....#
#.#.#.....#
##........#
#####d#####

7
1
###########
#.........#
#..#..#...#
#.........#
#.........#
...#..#...#
#.........#
#.........#
#........##
#.........#
#####.#####

2
0
#####.#####
#.........#
#.........#
#.........#
#.........#
#..........
#.........#
#k#.....#.#
#..#...#..#
#.........#
#####.#####
key : 1

3
1
#####.#####
#.........#
#.........#
#.........#
#.#.#.....#
l...###...#
#...#####.#
#...#.....#
#.........#
#.........#
#####.#####
locked : 0

5
1
#####.#####
#.........#
#.###.....#
#..#.##...#
#.##.#....#
d.........#
#.........#
#.........#
#.........#
#.........#
###########

9
1
#####l#####
#.........#
#.........#
#.....#...#
#....###..#
...##e....#
#..##.....#
#..#......#
#...#.....#
#.........#
#####.#####
locked : 1
boss
enemies 1

1
0
#####.#####
#.........#
#.........#
#.........#
#.........#
#...#.##..#
#e##e.#...#
#?#####...#
#.###.#...#
#e##......#
#####.#####
enemies 3
door 0 : 0
sign A useful tool lies just ahead.

8
0
#####d#####
#.........#
#.........#
#.###.#..##
#.#.#.#...#
#...###...d
#...##....#
#.##.##...#
#.........#
#.........#
#####.#####

4
1
#####.#####
#.........#
#..#......#
#.#...#...#
#.......#k#
..........#
#.........#
#.#.......#
#..#......#
#.........#
#####.#####
key : 0

2
2
###########
#.......#k#
#......##.#
#...##..#.#
#....#.##.#
.....#.#..#
#.........#
#.........#
#.........#
#.........#
###########
key : 3

3
0
#####.#####
#.#.....#.#
#.........#
#..#.#.#..#
#.........#
#...#.#...l
#.........#
#..#.#.#..#
#.........#
#.......#.#
#####.#####

5
0
#####d#####
#.........#
#.#.#.#...#
#.........#
#.#.#.#.#.#
#.........d
#.#.#.#.#.#
#.........#
#.#.#.#.#.#
#.........#
#####.#####

7
0
#####.#####
#e........#
##.##.###.#
#e.#..#e#.#
#...#.#...#
#...#.#....
#...#.#.#.#
#..#......#
#.........#
#.........#
#####d#####
enemies 3

10
1
#####.#####
#.........#
#.........#
#.........#
#..#......#
#....#....#
#...##....#
#.#.##....#
##.#......#
#X........#
###########

9
0
#####.#####
#.........#
#.........#
#.........#
#.........#
#..........
#.........#
#...#..#..#
#.........#
#k........#
###########
key : 4

8
1
#####.#####
#..#......#
#.........#
#..###....#
#.........#
d.........#
#.........#
#.........#
#.........#
#.........#
#####l#####

0
0
###########
#.........#
#.........#
##..#..#..#
#.........#
#.........#
#.#.......#
#.........#
#.........#
##.....#..#
#####.#####

2
1
###########
#e...e....#
#.........#
#.........#
#....##...#
...#e##....
#..##.....#
##........#
##s.#.....#
####......#
#####.#####
enemies 3
switch 0 : 0

6
0
#####.#####
#.........#
#..#..#..##
#.........#
#.........#
#...#.....#
#.........#
#.........#
#..#..#..##
#.........#
#####.#####

