1
4
###########
#.........#
#.........#
#.........#
#.........#
d.........#
#.........#
#.........#
#.........#
#.........#
#####d#####

3
3
#####.#####
#.........#
#.......#.#
#.........#
#.........#
#..#..#....
#.........#
#.........#
#.#.....#.#
#k........#
###########
key : 4

1
3
#####.#####
#.........#
#.........#
#.....##..#
#.........#
d.........d
#.........#
#.........#
#.........#
#.........#
#####.#####

3
1
#####.#####
#.........#
#......#..#
#.......#k#
#.........#
..........#
#.........#
#.........#
#.........#
#.........#
#####.#####
key : 0

3
0
#####.#####
#..#......#
#.#.#.#...#
#...##....#
#...###...#
#....@.....
#.........#
#.......#.#
#.........#
#.........#
#####.#####

2
2
#####.#####
#.........#
##.#...#.##
#.........#
#.#.#...#.#
...........
#..#...#..#
#.........#
#.#...#.#.#
#.........#
###########

2
5
###########
#.##.....X#
#.........#
##.#......#
#.........#
..........#
#.........#
#.........#
#.........#
#.........#
###########

0
1
###########
#.........#
#..#...#..#
#.#.....#.#
#.........#
#.........#
#.........#
#.........#
#.........#
#.........#
#####d#####

2
3
#####.#####
#.........#
#.........#
#.........#
#.....#...#
.....##....
#....###..#
#......#..#
#.........#
#.........#
#####.#####

2
4
#####d#####
#.........#
#.........#
#.........#
#.........#
.....e.....
#.........#
#.........#
#.........#
#.........#
#####.#####
boss
enemies 1

0
3
###########
##.....#.k#
#.........#
#.........#
#...#.....#
#.........#
#.........#
#......#..#
#.........#
#.........#
#####.#####
key : 3

2
1
#####.#####
#.........#
#..#..#..##
#.........#
#.........#
....#..#...
#.........#
#.........#
#.....#..##
#.........#
#####.#####

4
1
#####.#####
#.........#
#.........#
#..##.....#
#...##....#
..........#
#.#####...#
#.#####...#
#.........#
#.........#
###########

1
0
###########
#.........#
#.........#
#.#.....#.#
#.........#
#..........
#....#..#.#
#.........#
#.........#
#.#.....#.#
#####l#####
locked : 0

4
0
#####.#####
#.........#
#.........#
#.........#
#.........#
#..........
#.........#
#.........#
#.........#
#.........#
###########

1
1
#####d#####
#e.......s#
#.........#
#.###.....#
#..##.....#
...........
#.........#
#.........#
#.........#
#e........#
#####.#####
enemies 2
switch 0 : 0 1

2
0
#####l#####
#.........#
#...#.#.#.#
#...#.....#
#....####.#
#..#k#.....
#..###....#
#..#......#
#.........#
#.........#
#####.#####
key : 1

1
2
###########
#e...e....#
#.........#
#.........#
#....#....#
.....#....d
#.....#...#
#.........#
#.........#
#e........#
#####.#####
enemies 3
door 0 : 0 1

3
4
#####.#####
#.........#
##.#...#..#
#.........#
#....#.#..#
..........#
#..#.#.#..#
#.........#
##.....#.##
#.........#
###########

