0
0
###########
#........##
#.....#..##
#....#..#.#
#......##.#
#...#.#...#
#...###...#
#....##...#
#.........#
#.........#
#####D#####

6
1
#####D#####
#.........#
#.........#
#.........#
#.........#
D.........D
#.........#
#.........#
#.........#
#.........#
###########

2
1
#####D#####
#.........#
#.....#...#
#.........#
#......#..#
D.........d
#.........#
#.........#
#.........#
#.........#
#####D#####

5
2
#####d#####
#........e#
#..#..#..##
#.........#
#.........#
D..#..#...d
#.........#
#.........#
#..#.....##
#........e#
#####l#####
enemies 2

3
0
#####D#####
#.........#
#..#...#..#
#k#.....#.#
#.........#
#.........l
#.........#
#.#.......#
#..#......#
#.........#
#####D#####
key : 0

1
0
#####D#####
#.......#.#
#...#.###.#
#.....#.#.#
#...#.#...#
#.........D
#.........#
#.........#
#...#.#...#
#.........#
#####D#####

3
1
#####D#####
#.........#
#.........#
#.........#
#.........#
l.........#
#.........#
#.........#
#.........#
#.........#
#####d#####
locked : 2

4
0
#####D#####
#.........#
#.#.#.#.#.#
#.........#
#..#...#..#
#.........D
#k#.#...#.#
#.........#
#..#...#.##
#.........#
#####l#####
key : 2

2
2
###########
#.........#
#..#......#
#.#.......#
#.........#
d.........#
#.........#
#.......#.#
#......#..#
#.........#
###########

6
2
#####l#####
#.........#
#.........#
#.........#
#.........#
D....e....#
#.........#
#.........#
#.........#
#.........#
#####D#####
locked : 0
boss
enemies 1

6
0
#####D#####
#..#......#
#..##..p..#
#..###.#.p#
#..###.#..#
#..#####..D
#.........#
#.........#
#.........#
#k........#
###########
key : 5

5
3
###########
##.....#.##
#.........#
#.....#.#.#
#.........#
d..#.#....#
#.........#
#.#.#.#.#.#
#.........#
##.#...#..#
###########

7
2
#####D#####
#.........#
#.........#
#.........#
#...###...#
#...#.##..#
#..##.....#
###.##.##.#
###...###.#
#X........#
###########

5
0
#####l#####
#.........#
#.........#
#.........#
#.........#
#.........D
#.........#
#.........#
#.........#
#.........#
#####D#####
locked : 1

5
1
#####D#####
#.........#
#.........#
#.........#
#.........#
D.........D
#.........#
#.#.....#.#
#..#...#..#
#.........#
#####D#####

4
2
###########
#.........#
#.........#
#...#..#..#
#.........#
D.........#
#...#.....#
#.........#
#.........#
##........#
#####d#####

4
1
#####d#####
#.........#
#.........#
#.........#
#.........#
D...#.....D
#....##.#.#
#....##...#
#.....###.#
#.......#.#
#####D#####

1
1
###########
#.#.....#k#
#.........#
#..#.#...##
#.........#
D...#.....#
#.........#
#..#.....##
#.........#
#.#.....#.#
#####D#####
key : 1

2
0
#####D#####
#.........#
#...#.#.#.#
#.....##..#
#....#.##.#
#....@....D
#.........#
#.........#
#.........#
#.........#
#####D#####

