7
1
#####.#####
#..#...#..#
#..##.#...#
#..#k#....#
#....##...#
......##...
#.........#
#.........#
#.........#
#.........#
#####d#####
key : 2

5
0
#####.#####
#.........#
#.##......#
#..#.#....#
#..###....#
#..?#@.....
#..##.....#
#....#....#
#..#....#.#
#.........#
#####.#####
sign A useful tool lies just ahead.

8
1
#####d#####
#.........#
#.........#
#.........#
#.........#
#....#.....
#..##.....#
##.###....#
#..#......#
#.........#
###########

7
0
#####d#####
#.........#
##..#..#..#
#.........#
#.........#
#......#...
#.........#
#.........#
##..#..#..#
#.........#
###########

6
1
#####.#####
#.........#
#.........#
#.........#
#.........#
...........
#.........#
#.........#
#.........#
#.........#
#####.#####

1
3
###########
#........X#
#..##.....#
#..##.....#
#...#.....#
..........#
#.#.......#
#.#.......#
##........#
#.........#
###########

1
2
#####.#####
#.........#
#.........#
#...###...#
#..##.##..#
#..#.e.....
#..#..#...#
#...#..#..#
#.........#
#.........#
#####d#####
boss
enemies 1

5
1
###########
##k.......#
#.#.......#
#..#......#
#.#.......#
...##.#...l
#.......#.#
#......##.#
#...#.....#
#.........#
#####.#####
key : 0

6
2
#####.#####
#e........#
#.........#
#.........#
#.........#
.........e#
#..#......#
#.........#
#.........#
#s........#
#####.#####
enemies 2
switch 0 : 0 1

5
2
#####.#####
#.........#
#.....#...#
#.........#
#.........#
l.........#
#.......#.#
#.........#
#.........#
#.#.......#
#####.#####
locked : 0

8
2
#####.#####
#..#......#
#.##......#
#....#....#
#.........#
..........#
#.........#
#.........#
#........e#
#......?ee#
###########
enemies 3
door 0 : 0 1
sign Beware what lurks ahead.

3
2
#####.#####
#e........#
#.........#
#e#.......#
#?........#
#e........d
#.........#
#.........#
#.........#
#.........#
#####.#####
enemies 3
sign Many have walked this path.

2
2
#####d#####
#.........#
#.........#
#.........#
#.........#
#.........#
#.........#
#.......#.#
#......#..#
#.........#
#####.#####

4
2
#####.#####
#e........#
#.........#
#.........#
#.........#
#e.......e#
#.........#
#.........#
#.........#
#.........#
#####.#####
enemies 3

0
2
###########
#k........#
#.........#
#.........#
#.........#
#.........#
#.........#
#.........#
#.........#
#.........#
#####.#####
key : 5

4
0
###########
#.........#
#..#......#
#.#.......#
#.........#
#.........#
#.........#
#.........#
#.........#
#.........#
#####.#####

6
0
#####.#####
#.........#
#..#..#...#
#.........#
#.........#
#..#..#....
#.........#
#.........#
#..#..#..##
#........k#
#####d#####
key : 1

7
2
#####.#####
#.........#
#.........#
#.........#
#.........#
..........#
#.........#
#.#.......#
#..#......#
#.........#
#####.#####

3
3
###########
#.........#
#.........#
#.........#
#.#.....#.#
d.........#
#.........#
#.#..#..#.#
#.........#
#.........#
###########

