2
1
#####D#####
#.........#
#.........#
#.........#
#....#.#..#
D....#.#..D
#....####.#
#.....#..##
#.........#
#.........#
#####D#####

1
2
###########
#.#.......#
#.........#
#.........#
#.#..#..#.#
D.........#
#.........#
#....#..#.#
#.........#
#.........#
#####d#####

3
3
###########
#.#.....#.#
#.........#
#.........#
#..#..#...#
d.........#
#.........#
#.#.......#
#.........#
#.........#
#####D#####

2
0
#####D#####
#.........#
#.........#
#....##...#
#.........#
#....@##..D
#.........#
#....###.##
#.....##..#
#.......#?#
#####D#####
sign A useful tool lies just ahead.

4
4
###########
#.........#
#.........#
#...#.....#
#.........#
d.........d
#.........#
#.......#.#
#......#..#
#.#.......#
###########

4
3
#####D#####
#.........#
#.........#
#.........#
#.........#
D.........d
#.........#
#.........#
#.........#
#.........#
###########

3
0
#####D#####
#.........#
#.........#
#.........#
#.........#
#k........D
#.........#
#.........#
#.........#
#.........#
#####l#####
key : 1

4
1
#####l#####
#.........#
#.##......#
#.##......#
#.........#
D..#......D
#.p#......#
####......#
#.........#
#.........#
###########
locked : 4

4
2
#####D#####
#..#.....##
#.........#
#.........#
#...#..#..#
D.........D
#.........#
#..#......#
#.........#
#.........#
#####D#####

4
0
#####l#####
##.#...#.##
#.........#
#..#.....##
#.........#
#....#.#..D
#.........#
##.#...#.##
#.........#
##.#...#.##
###########
locked : 0

1
1
###########
#?...e....#
#.........#
#....###..#
#....#e#..#
D......#..D
#.........#
#.........#
#.....#...#
#.........#
#####D#####
enemies 2
sign The brave are rewarded.

3
1
#####D#####
#..#...#..#
#.........#
#.#.#.#...#
#.........#
D..#.#....D
#.........#
#.#.....#.#
#.........#
#..#......#
#####l#####

0
0
###########
#k#.....#.#
#.........#
#....#.#.##
#.........#
#...#.#...#
#.........#
#..#...#.##
#.........#
#.#.....#.#
#####D#####
key : 2

5
2
#####D#####
#.........#
#.........#
#.........#
#.........#
#.........#
#.........#
#.........#
#.........#
#.........#
###########

5
5
#####D#####
#.........#
#.........#
#..####...#
#.#####...#
#..#.#....#
#.#...#...#
#.###.....#
#.........#
#X........#
###########

3
2
#####D#####
#k........#
#.........#
#.........#
#.........#
D.........d
#.........#
#.........#
#.........#
#.........#
#####D#####
key : 4

4
5
###########
#.........#
#...#.##..#
#....##.#.#
#....##.#.#
d....e....#
#.#.##.#..#
###.......#
#.........#
#.........#
#####D#####
boss
enemies 1

2
2
#####d#####
#........e#
#........##
#.........#
#.........#
D..#..#...#
#.........#
#.........#
#.....#..##
#........e#
#####D#####
enemies 2

1
0
#####D#####
#.........#
#.........#
#..#......#
#.........#
#.....##..D
#.....k#..#
#.....#...#
#.........#
#......#..#
#####D#####
key : 0

