4
4
###########
#.........#
#.........#
#.........#
#....#.#..#
d....#.#..d
#....####.#
#.....#..##
#.........#
#.........#
###########

4
0
#####l#####
#.#.......#
#.........#
#.........#
#.#..#..#.#
#..........
#.........#
#....#..#.#
#.........#
#.........#
###########
locked : 0

1
1
###########
#e#?....#e#
#.........#
#.........#
#..#..#...#
...........
#.........#
#.#.......#
#.........#
#.........#
#####.#####
enemies 2
sign The brave are rewarded.

4
3
#####.#####
#.........#
#.........#
#.........#
#.........#
..........d
#.........#
#.#.......#
#..#.....##
#.........#
###########

3
3
###########
#.........#
###.#.....#
####......#
#..#####..#
d..##.##..#
#..#..#.#.#
#....##.#.#
#.........#
#.........#
#####.#####

4
2
#####.#####
#.........#
#.##......#
#.##......#
#.........#
...#.......
#.##......#
####......#
#.........#
#.........#
#####.#####

2
0
#####.#####
#.........#
#.........#
#.........#
#.........#
#..#.@.....
#..#......#
#..#......#
#?##......#
##........#
#####.#####
sign A useful tool lies just ahead.

3
0
#####.#####
#.........#
#......#..#
#.......#.#
#.........#
#k.........
#.........#
#.......#.#
#......#..#
#.........#
#####l#####
key : 1

3
1
#####.#####
#.........#
#.#.#.#.#.#
#.........#
#....#.#..#
...........
#.#.#...#.#
#.........#
#......#.##
#.........#
#####l#####

2
1
#####.#####
#.#.....#.#
#.........#
#..#.#...##
#.........#
....#......
#.........#
#..#.#...##
#.........#
#.#.....#.#
#####.#####

2
2
#####d#####
#.........#
#..##.....#
######.##.#
#.###e.#e.#
....##.#..#
#..#......#
#.........#
#.........#
#.........#
#####.#####
enemies 2

0
0
###########
##k#...#.##
#.........#
#.#.....#.#
#.........#
#..#.#....#
#.........#
#.#.#...#.#
#.........#
##.#...#.##
#####.#####
key : 2

4
5
###########
#......##.#
#.....#.#.#
#.......#.#
#.........#
d....e....#
#.........#
#.........#
#.........#
#.........#
#####.#####
boss
enemies 1

1
0
#####.#####
#.........#
#.........#
#.........#
#.........#
#k....#....
#.........#
#.........#
#.......#.#
#.........#
#####.#####
key : 0

5
5
#####.#####
#.........#
#.....#...#
#.....#...#
#.....###.#
#.........#
#.........#
#.........#
#.........#
#X........#
###########

5
2
#####.#####
#.........#
#.........#
#.........#
#.........#
#.........#
#.........#
#.......#.#
#......#..#
#.........#
###########

1
2
###########
#.........#
#.........#
#..#......#
#.........#
......##..#
#......#..#
#.....#...#
#.........#
#......#..#
#####d#####

4
1
#####l#####
#.........#
#.........#
#.........#
#.........#
...........
#.........#
#.........#
#.........#
#.........#
###########
locked : 4

3
2
#####.#####
#k........#
#.........#
#.........#
#.........#
..........d
#.........#
#.......#.#
#......#..#
#.........#
#####.#####
key : 4

