3
1
#####D#####
#.........#
#.........#
#.........#
#.........#
#k........D
#.........#
#.........#
#.........#
#.........#
#####D#####
key : 1

3
2
#####D#####
#..#...#.##
#.........#
#..#...#.##
#.........#
D..#......#
#.........#
##.#.#.#.##
#.........#
##........#
#####d#####

5
2
#####D#####
#e........#
#.......#.#
#.........#
#.........#
D....#....D
#.........#
#.........#
#.......#.#
#?........#
#####D#####
enemies 1
sign Beware what lurks ahead.

5
0
#####D#####
#.........#
#.........#
#.........#
#.#.......#
#....@....D
#.........#
#.........#
#.........#
#?........#
###########
sign Many have walked this path.

5
1
#####D#####
#......#..#
#.....###.#
#....#....#
#....#.#..#
D.........D
#.........#
#.........#
#.........#
#.........#
#####D#####

7
2
#####d#####
#......#..#
#..##.#...#
#....###..#
#..####...#
#.........#
#.........#
#.........#
#.........#
#.........#
###########

5
3
#####D#####
#..#.....##
#.........#
#.#.#.#.#e#
#.........#
D..#.#.#..#
#.........#
#.#...#.#s#
#........?#
##e#...#e##
#####D#####
enemies 3
switch 0 : 0
sign The brave are rewarded.

2
3
###########
#........e#
#..#......#
#..#......#
#.###.....#
D.........#
#.#.......#
#.........#
#.........#
#........e#
###########
enemies 2
door 0 : 0

2
1
###########
##........#
#k........#
#.........#
#.........#
#.........d
#..#......#
#.........#
#.........#
#.........#
#####D#####
key : 2

4
1
#####D#####
#e........#
#.........#
#.........#
#.........#
D.........d
#.........#
#.........#
#.........#
#?........#
#####D#####
enemies 1
sign Those who search shall find.

6
2
#####D#####
#.........#
#.........#
#.........#
#.#.#.....#
D..#......D
#.#.#.....#
###.......#
#.........#
#.........#
#####d#####

4
0
###########
#.........#
#.###.....#
#...#.#...#
#.#..#....#
#...###...D
#.#..#....#
#.........#
#.........#
#.........#
#####D#####

4
2
#####d#####
#.........#
#......#..#
#.......#.#
#.........#
d.........D
#.........#
#.#.......#
#..#......#
#.........#
#####D#####

6
1
#####D#####
#.........#
#.........#
#.........#
#.........#
#.........D
#.........#
#.........#
#.........#
#k........#
###########
key : 0

1
2
#####D#####
#.......#.#
#.....###.#
#.....#.#.#
#.........#
#....e....#
#..#......#
#.........#
#...#.....#
#.........#
#####l#####
locked : 0
boss
enemies 1

4
3
###########
#.........#
#..#......#
#.........#
#.........#
D.........#
#.........#
#.........#
#.........#
#.........#
#####D#####

0
2
###########
#X........#
#.........#
#.........#
#.........#
#.........#
#.........#
#.........#
#.........#
#.........#
#####D#####

6
3
#####D#####
#.........#
#..#......#
#.#...#...#
#.........#
D.........#
#.....#...#
#.#.....#.#
##.#...#..#
#........k#
###########
key : 3

2
2
#####l#####
#.........#
#.........#
#..#..#..##
#.........#
d.........D
#...#..#..#
#.........#
#.........#
#..#.....##
#####D#####

