2
2
###########
#.........#
#.........#
##..#..#..#
#.........#
d.........D
#...#..#..#
#.........#
#.........#
##........#
#####D#####

2
3
#####D#####
#k........#
#.........#
#.........#
#.......#.#
D.....#...d
#.........#
#.......#.#
#......#..#
#.........#
#####D#####
key : 3

3
3
#####D#####
#e........#
#.........#
#.........#
#.........#
D.........D
#.........#
#.........#
#.........#
#....e....#
###########
enemies 2

1
3
###########
#.........#
#.........#
#.........#
#.........#
#.........D
#.........#
#.........#
#.........#
#.........#
#####D#####

3
1
#####l#####
#.........#
#.#.......#
#.........#
#.........#
D..#..#...d
#.........#
#.........#
#.......#.#
#.........#
#####D#####

4
0
#####D#####
#.........#
#.........#
#.........#
#.........#
#.........D
#.........#
#.........#
#e........#
#ee.......#
###########
enemies 3

1
1
###########
#.........#
#.........#
#..#..#...#
#.........#
#.........#
#..#..#...#
#.........#
#.........#
#.........#
#####D#####

3
0
#####D#####
#.........#
###.......#
#.####....#
#.###.....#
#..##@....D
#.........#
#...#.....#
#.........#
#.........#
#####D#####

2
0
###########
#.........#
#......#..#
#.......#.#
#.........#
#....#....D
#.........#
#.#.....#.#
#.##..##..#
#.........#
#####D#####

2
4
#####D#####
#.........#
#.........#
#.........#
#.........#
d.........D
#.........#
#.........#
#.........#
#.........#
#####d#####

3
4
#####d#####
#.........#
##........#
#.........#
#.........#
D.........#
#.........#
#.........#
##..#.....#
#.........#
###########

1
4
#####D#####
#.........#
#.........#
#.........#
#.........#
D.........D
#.....###.#
#.....#k..#
#......##.#
#.........#
#####D#####
key : 6

2
5
#####D#####
#.........#
#.........#
#.......p.#
#.........#
D.........#
#....###..#
#....#e#..#
#........p#
#........e#
###########
enemies 2

1
5
#####D#####
#.........#
#..##.....#
#..#......#
#.........#
D.........#
#.........#
#..#......#
####......#
#X........#
#####D#####

3
2
#####D#####
#.........#
#.......#.#
#.........#
#.........#
d..#..#...D
#.........#
#.........#
#.#.....#.#
#.........#
###########

0
4
###########
#k........#
#.........#
#..#......#
#......#..#
#...#..#..l
#...#.....#
#.....#.#.#
#.........#
#......##.#
#####D#####
key : 7

4
1
#####D#####
#.........#
#.........#
#.........#
#.........#
D....#....#
#.........#
#.........#
#.......#.#
#........k#
###########
key : 0

2
1
#####D#####
#.........#
##..#..#..#
#.........#
#.........#
D......#..d
#.........#
#.........#
##..#.....#
#.........#
#####l#####
locked : 0

0
5
###########
##........#
###.......#
##........#
#...##....#
l...#e....#
#.#.......#
#.#.#.....#
###.......#
#.........#
#####D#####
locked : 6
boss
enemies 1

