1
0
###########
##.#......#
#..##.....#
#..##.....#
#..#......#
#..##.....#
#.........#
#.........#
#.........#
#.........#
#####.#####

0
2
###########
#.........#
#..#...#..#
#.#.....#.#
#.........#
#.........#
#.........#
#.#.......#
#..#......#
#.........#
#####l#####
locked : 2

1
3
###########
#.........#
#.....#...#
#.....#...#
#.........#
d.........#
#.........#
#.........#
#.........#
#.........#
#####.#####

3
3
#####.#####
#.........#
#..#..#..##
#.........#
#.........#
....#..#..#
#.........#
#.........#
#..#..#..##
#.........#
#####.#####

4
4
###########
#.........#
#..#..#..##
#.........#
#.........#
d..#.......
#.........#
#.........#
#..#..#..##
#.........#
#####d#####

2
3
#####.#####
#.........#
#.........#
#.........#
#.........#
...##......
#.#.......#
##..#.....#
#...#.....#
####......#
#####.#####

5
3
#####.#####
#.........#
#.........#
#.........#
#.........#
#..........
#.........#
###....##.#
#..#...#..#
#.........#
###########

3
1
#####.#####
#..#.....##
#.........#
#.........#
#...#.....#
#..........
#.........#
#?....#..##
#e........#
#ee.......#
###########
enemies 3
sign A useful tool lies just ahead.

2
2
#####l#####
#.........#
#..#...#..#
#.#.....#.#
#.........#
...........
#.........#
#.........#
#.........#
#.........#
#####.#####

1
2
#####l#####
#.........#
#..#......#
#.#.......#
#.........#
#.........d
#.........#
#.#.......#
#..#......#
#.........#
#####l#####
locked : 0

2
0
#####.#####
#.........#
#.........#
#.##.#....#
#..##.....#
#...##.....
#.##@#....#
#..#.#....#
#.........#
#?........#
###########
sign Something glints behind that door…

3
2
#####.#####
#.........#
#.#.#.....#
##.#......#
#.........#
...##......
#.##......#
#.........#
#.........#
#.........#
#####.#####

5
4
#####d#####
#.........#
#.........#
#.........#
#...e###..#
.....#....#
#....#....#
#.....#####
#.....#..##
#.........#
#####.#####
boss
enemies 1

6
4
#####.#####
#.........#
#......#..#
#.......#.#
#.....#.#.#
#.....#...#
#...#.#...#
#....#....#
#.........#
#X........#
###########

4
3
#####.#####
#.........#
#.....#...#
#.....##..#
#.....##..#
..........d
#..#......#
#.#.......#
#.##......#
#.........#
#####.#####

2
1
###########
#....k....#
#.........#
#.........#
#.........#
.....#.....
#....##...#
#.....##..#
#.........#
#.........#
#####.#####
key : 0

4
2
#####.#####
#.........#
#.........#
#.#..#..#.#
#.........#
#..........
#..#..#...#
#.........#
#.........#
#k#.....#.#
###########
key : 1

2
4
###########
#........k#
#...#.....#
#.........#
#...#.....#
..........#
#.........#
#.........#
#.........#
#.........#
###########
key : 2

4
5
###########
#........k#
#..#......#
#.#.......#
#.........#
..........#
#.........#
#.........#
#.........#
#.........#
###########
key : 4

