4
2
#####.#####
#.........#
#.........#
#.........#
#.........#
...........
#.........#
#.#.......#
#..#......#
#.........#
###########

2
0
#####d#####
#k........#
##.....#.##
#.........#
#....#.#..#
#..........
#..#...#..#
#.........#
##.#.....##
#.........#
#####.#####
key : 0

1
1
###########
#.........#
#......#..#
#..#...##.#
#.........#
d..........
#.........#
#.#.......#
#..#......#
#.........#
#####.#####

5
1
#####d#####
#.........#
#..#...#..#
#.#.....#.#
#.........#
#.........#
#.........#
#.........#
#.........#
#.........#
#####.#####

3
0
#####.#####
#.........#
#.........#
#.........#
#.........#
#....@.....
#?..#.....#
###.......#
###.#.....#
####......#
#####.#####
sign The brave are rewarded.

3
3
#####.#####
#.........#
#...#.....#
#.........#
#.........#
.....#.....
#.........#
#.........#
##..#..#..#
#.........#
#####d#####

6
1
#####.#####
#.........#
#.........#
#..####...#
#....#.#..#
#.........#
#..#..#...#
#.#?###...#
#......#..#
#e.......e#
###########
enemies 2
sign Beware what lurks ahead.

4
0
#####.#####
##........#
#.........#
#.........#
#.........#
#...#......
#.....##..#
#.....###.#
#...#.#.#.#
#.........#
###########

3
1
#####.#####
##.....#..#
#.........#
#.........#
#.#..#..#.#
...........
#.........#
#......#..#
#.........#
#.........#
#####l#####

1
0
###########
#.........#
#.#....#..#
#.......#.#
#.........#
#...#.....d
#.........#
#.......#.#
#......#..#
#.........#
#####d#####

2
1
#####.#####
#.........#
##.....#.##
#.........#
#.#.#.#.#.#
...........
#..#.#.#..#
#.........#
#.#.#.#.#.#
#.........#
#####.#####

3
2
#####.#####
#k........#
#.........#
#.........#
#.........#
...........
#.........#
#.........#
#.........#
#.........#
#####.#####
key : 1

2
2
#####l#####
#.........#
#.........#
#.........#
#.........#
...........
#.........#
#.......#.#
#......#..#
#.........#
#####.#####

4
1
#####l#####
#.........#
#.#.#.....#
#.#.#.....#
#.###..##.#
...........
#......#..#
#.........#
#.........#
#.........#
#####d#####
locked : 0

4
3
#####d#####
#.........#
#.........#
#.........#
#.........#
..........#
#.........#
#.........#
#.........#
#.........#
###########

2
3
###########
#........k#
#.........#
#.........#
#.........#
..........#
#.........#
#.........#
#.........#
#.........#
#####.#####
key : 3

0
2
###########
#X........#
#.........#
#.........#
#.........#
#...#.....#
#....#....#
#...#.....#
#.........#
#.........#
#####.#####

3
4
###########
#......#..#
#.........#
#...#.#.#.#
#.........#
...#...#..#
#.........#
#.#.#.#.#.#
#.........#
##.#...#k##
###########
key : 2

1
2
#####.#####
#.........#
#.........#
#.........#
#..#e###..#
....####..#
#....##...#
#..#.###..#
#...#..#..#
#......#..#
#####l#####
locked : 3
boss
enemies 1

