5
0
#####.#####
#.........#
#.#.#.#.#.#
#.........#
#....#.#..#
#.........l
#k#.#...#.#
#.........#
#.........#
#.........#
#####.#####
key : 1

6
0
#####.#####
#.........#
#.........#
#.....##..#
#....#k#..#
#..........
#..#......#
#..###.#..#
#..#..#...#
#..#......#
#####.#####
key : 2

4
1
#####.#####
#.........#
#.........#
#.........#
#.........#
d..........
#.........#
#.........#
#.........#
#.........#
#####.#####

3
2
#####.#####
#.........#
#.#.....#.#
#.........#
#.........#
d..#......#
#.........#
#.........#
#.#.....#.#
#.........#
#####.#####

6
1
#####.#####
#.........#
#.........#
#.........#
#.........#
.....#....#
#.........#
#.#.......#
#..#......#
#.........#
#####.#####

1
0
#####l#####
#.........#
#.........#
#.........#
#..?##....#
#s.####....
#...#####.#
#.....#e..#
#.....##..#
#......####
#####.#####
enemies 1
switch 0 : 0 1
sign Only the prepared may pass.

2
2
###########
#.........#
#.....#...#
#.........#
#.........#
...#......#
#..#......#
#.##......#
##.##.....#
##........#
#####.#####

3
0
#####.#####
#.........#
#.........#
#.........#
#.........#
#?...@.....
#.........#
#.........#
#.........#
#.........#
#####.#####
sign The brave are rewarded.

7
1
#####.#####
#.##......#
#.#......##
#..#.##...#
#....#....#
d....e.#..#
#.........#
#.........#
#.........#
#.........#
#####.#####
boss
enemies 1

8
1
#####.#####
#.........#
#.....#...#
#.....###.#
#.......#.#
#.........#
#.#.......#
#.#.......#
#.........#
#X........#
###########

0
0
###########
#.#.......#
#.........#
#.........#
#.#..#..#.#
#.........#
#.........#
#.#..#..#.#
#.........#
#.........#
#####l#####
locked : 0

2
1
#####.#####
#.#.....#.#
#.........#
#.........#
#.#.....#.#
...........
#.........#
#....#..#.#
#.........#
#.........#
#####d#####

3
1
#####d#####
##.#...#.##
#.........#
#.#.#.#.#.#
#.........#
...#...#..d
#.........#
#.#...#...#
#.........#
##.#...#.##
#####.#####

4
2
#####.#####
#.........#
#.........#
#.........#
#.#.....#.#
..........#
#.........#
#....#....#
#........?#
#.......ee#
###########
enemies 2
door 0 : 0 1
sign Beware what lurks ahead.

2
0
#####.#####
#.........#
#..#...#..#
#.#....##.#
#.........#
#..........
#.........#
#.......#.#
#.##...#..#
#.........#
#####.#####

5
1
#####.#####
#.........#
##.....#.##
#.........#
#.#.#.#.#.#
l.........#
#..#...#..#
#.........#
#.#.#.#.#.#
#.........#
#####.#####
locked : 1

7
0
#####.#####
##.#......#
##........#
##........#
#.........#
#.........d
#.........#
#.........#
#.........#
#.........#
###########

1
1
###########
#..#.....k#
#..##..#..#
#..###....#
#..##.##..#
......##..#
#..#####..#
#.........#
#........##
#.........#
#####.#####
key : 7

4
0
#####.#####
##........#
#.........#
#.........#
#...#..#..#
#.........d
#k........#
##..#.....#
#.........#
#.........#
#####.#####
key : 0

