5
0
#####D#####
#.........#
#......#..#
#.......#.#
#.........#
#.........D
#.........#
#.........#
#.........#
#k........#
###########
key : 0

2
2
#####D#####
#.........#
#.........#
#.........#
#.........#
d.........d
#.........#
#.#.......#
#..#......#
#.........#
#####D#####

5
2
###########
#.........#
#.........#
#.........#
#.........#
D.........#
#.........#
#.........#
#.........#
#.........#
###########

1
2
#####D#####
#.........#
#......#..#
#.......#.#
#.........#
D.........D
#.........#
#.#.......#
#..#......#
#.........#
#####D#####

3
0
#####D#####
#.........#
#e#.#.....#
###.##....#
#..#......#
#..##.....D
#.........#
#.........#
#.........#
#.........#
#####D#####
enemies 1

2
4
###########
#.........#
#.........#
#.......p.#
#.........#
d.........#
#.........#
#.........#
#.........#
#.........#
###########

2
0
###########
#e........#
#?.....#..#
#....#....#
#e#.......#
#...#.....D
#...#.....#
#.........#
#.........#
#..#......#
#####D#####
enemies 2
sign The dungeon remembers all who enter.

3
2
#####D#####
#.........#
#.........#
#.........#
#.........#
D...#.....#
#...#.#...#
#...#.#...#
#.........#
#........k#
###########
key : 3

4
0
#####D#####
#.........#
#.........#
#.....##..#
#.....#?..#
#....@.#..D
#.........#
#.........#
#.........#
#.........#
#####D#####
sign Those who search shall find.

2
1
#####l#####
#......#..#
#.....##..#
#....####.#
#....##...#
D....#....d
#.........#
#.........#
#.........#
#.........#
#####D#####

0
3
###########
####.....X#
#.........#
##.#......#
#.#.#.....#
D.........#
#.........#
#.........#
#.........#
#.........#
#####D#####

3
1
#####D#####
#e#e......#
#.###.....#
#...#.....#
#.........#
D.........D
#.........#
#.........#
#.........#
#e........#
#####D#####
enemies 3

2
3
#####d#####
####......#
###.#.....#
##..#.....#
#..#.#....#
d..#.#....d
#.........#
#.........#
#.........#
#.........#
###########

4
1
#####D#####
#.........#
#.........#
#..#..#..##
#........k#
D.........#
#..#..#...#
#.........#
#.........#
#........##
#####D#####
key : 1

1
3
#####D#####
#.........#
#..##.#...#
#..#.##...#
#.#.e.....#
D...###...#
#..##.#...#
#...#..#..#
#..##..#..#
#..#...#..#
#####d#####
boss
enemies 1

6
1
#####l#####
#.........#
#.........#
#.........#
#.........#
#.........#
#.........#
#.#.......#
#..#......#
#.........#
###########
locked : 0

0
2
###########
#......##.#
#...#..#..#
#...###.#.#
#....##...#
#.........D
#.........#
#.........#
#.........#
#.........#
#####D#####

1
1
###########
#.........#
#..#......#
#.#.......#
#.........#
#.........D
#.........#
#.......#.#
#......#..#
#.........#
#####l#####
locked : 3

5
1
#####D#####
#k.#......#
##........#
#....#....#
#....#....#
D.........D
#.........#
#.........#
#.........#
#.........#
#####l#####
key : 2

