3
0
#####.#####
#.........#
#........##
#....##.#.#
#....##.#.#
#.....#....
#....#.#..#
#.........#
#...#.....#
#.........#
#####d#####

4
0
#####d#####
#.........#
#.........#
#.........#
#.........#
#..........
#.........#
#.........#
#.........#
#.........#
###########

2
4
#####.#####
#.........#
#.#.#.....#
#.###.#...#
#.##e.....#
l....##....
#....#....#
#.........#
##........#
#.........#
#####.#####
locked : 0
boss
enemies 1

2
5
###########
#........k#
#..#.....##
#.........#
#..#.#....#
..........#
#....#.#..#
#.........#
#..#.....##
#.........#
###########
key : 3

2
0
###########
#?........#
#.........#
#.........#
#.........#
#....@.....
#.........#
#.........#
#.........#
#.........#
#####.#####
sign The dungeon remembers all who enter.

0
1
###########
#.........#
#......#..#
#.......#.#
#.........#
#..........
#.........#
#.......#.#
#......#..#
#.........#
#####d#####

1
1
#####d#####
#.........#
#...#.#...#
#...###...#
#.........#
#..........
#.........#
#.........#
#......#..#
#.........#
#####d#####

2
1
#####d#####
#.........#
#.........#
#.........#
#......#..#
...........
#.........#
##..#..#..#
#.........#
#.........#
#####.#####

4
1
#####.#####
#.........#
#..#..#..##
#.........#
#.........#
....#.....#
#.........#
#........e#
#.....#..##
#.....e?se#
###########
enemies 3
switch 0 : 0 1
sign The dungeon remembers all who enter.

1
3
###########
#e...e....#
#.........#
#.........#
#.........#
...........
#.........#
#.........#
#.........#
#e........#
#####.#####
enemies 3
door 0 : 0 1

3
3
#####.#####
#.........#
#...#..##.#
#...#.#.#.#
#...#.....#
....###....
#...k#....#
#...##....#
#.........#
#.........#
###########
key : 1

0
2
###########
#..#...#.e#
#.........#
#.#.#...#.#
#.........#
...#.#.#..#
#.........#
#...#...#.#
#.........#
#..#.....##
#####.#####
enemies 1

2
2
#####.#####
#e......?##
#.........#
#.........#
#......#..#
..........d
#.........#
#..#..#...#
#.........#
#e.......e#
#####.#####
enemies 3
sign The brave are rewarded.

1
2
#####.#####
#k........#
#.........#
#.........#
#.........#
...........
#.........#
#.........#
#.........#
#.........#
#####.#####
key : 0

1
4
###########
#........k#
##.#...#.##
#.........#
#....#.#..#
..........#
#..#.#.#..#
#.........#
##.#...#..#
#.........#
#####.#####
key : 2

3
4
#####.#####
####......#
#.#.#..##.#
#.#.......#
#.#######.#
..........#
#.........#
#.........#
#.........#
#........X#
###########

3
1
#####.#####
#.........#
#.#...#...#
#.........#
#..#.#.#..#
...........
#...#.#.#.#
#.........#
#..#...#.##
#.........#
#####.#####

3
2
#####.#####
#.........#
#.#.......#
#.........#
#.........#
.....#.....
#.........#
#.........#
#.#.......#
#.........#
###########

2
3
#####.#####
#.........#
#.#.#.#.#.#
#.........#
#....#.#..#
d.........l
#.#...#.#.#
#.........#
#..#...#.##
#.........#
#####.#####

