6
2
#####.#####
##.....#.##
#.........#
##.#.#....#
#.........#
d....#.#..#
#.........#
#..#...#.##
#.........#
#......#.##
#####.#####

6
0
#####.#####
#.........#
#.....##..#
#.....###.#
#.........#
#..........
#.........#
#.........#
#.........#
#.........#
###########

7
1
#####l#####
#.........#
#.........#
#.........#
#...#.....#
#...#e.....
#.##......#
#.........#
#.........#
#.........#
#####.#####
locked : 5
boss
enemies 1

3
1
#####.#####
#.........#
#.........#
#.#.......#
#.........#
...........
#..#..#...#
#.........#
#.........#
#k#.....#.#
#####.#####
key : 2

4
1
#####.#####
#.........#
#.........#
##.....#..#
#.........#
..........#
#.......#.#
#.........#
#.........#
##.....#..#
#####d#####

2
2
###########
#........k#
#.........#
#.........#
#.........#
......#...#
#...#.....#
#....#....#
#.........#
#.........#
#####.#####
key : 1

0
0
###########
#.........#
#..#...#..#
#.#.....#.#
#.........#
#.........#
#.........#
#.......#.#
#......#..#
#.........#
#####l#####
locked : 2

4
0
#####d#####
#.........#
#..#...#..#
#.#.....#.#
#.........#
#..........
#.........#
#.........#
#.........#
#.........#
#####.#####

8
1
#####.#####
#.........#
#...#.#.#.#
#.....##..#
#......#..#
#....#....#
#...##....#
#.........#
#.........#
#X........#
###########

6
1
#####.#####
#k........#
#.........#
#.........#
#..##.....#
....#.....d
#...##....#
#.........#
#.........#
#.........#
#####l#####
key : 5

2
1
###########
#.........#
##.#...#..#
#.........#
#.#.#.....#
...........
#......#..#
#.........#
#.#.#.#...#
#.........#
#####.#####

3
0
#####.#####
#.........#
#..#......#
#.#.......#
#.........#
#..........
#.........#
#.........#
#.........#
#.........#
#####d#####

1
0
#####l#####
#.........#
#.....##..#
#.......#.#
#.........#
#.........#
#.........#
#.........#
#.....#...#
#.........#
#####.#####

3
2
#####.#####
#.........#
#.........#
#.........#
#.........#
..........#
#.........#
#.........#
#........?#
#.......se#
###########
enemies 1
switch 0 : 0 1
sign The brave are rewarded.

5
1
#####d#####
#.........#
#......#..#
#.......#.#
#.........#
d.........l
#.........#
#.#.......#
#..#......#
#.........#
#####.#####

5
2
###########
#......##.#
#...#.....#
#.....##..#
#.....##..#
l..####...#
#..#..#...#
#.........#
#...#..#..#
#.........#
#####.#####
locked : 1

7
2
#####.#####
#.........#
#.........#
#.........#
#......#..#
..........#
#.........#
#.........#
#.........#
#.......?e#
###########
enemies 1
door 0 : 0 1
sign Turn back; you are not yet ready.

2
0
#####.#####
#.........#
#.........#
#.........#
#.........#
#....@.....
#?##......#
###.......#
##.#......#
#.........#
#####.#####
sign The ceiling is higher than it looks.

5
0
#####.#####
#.........#
#.........#
#.##.##...#
#....#....#
#...#.....d
#k##.##...#
#....#....#
#.........#
#.........#
#####.#####
key : 3

