3
1
#####D#####
##.....#.##
#k........#
##.#.#....#
#.........#
D....#.#..D
#.........#
#..#...#.##
#.........#
#......#.##
#####D#####
key : 2

6
1
#####D#####
#k........#
#.....##..#
#.....###.#
#.........#
D.........d
#.........#
#.........#
#.........#
#.........#
#####l#####
key : 5

6
0
#####D#####
##.....#..#
#.........#
#.........#
#......#..#
#.........D
#.........#
##..#.....#
#.........#
#.........#
###########

5
2
###########
#.........#
#.#.#.....#
#.........#
#..#.#.#..#
l.........#
#.#.#.#.#.#
#.........#
#..#...#.##
#.........#
#####D#####
locked : 1

7
2
#####D#####
#.........#
#.........#
#.#.....#.#
#.........#
D.........#
#..#..#...#
#.........#
#.........#
#......?#e#
###########
enemies 1
door 0 : 0 1
sign Turn back; you are not yet ready.

2
2
###########
#........k#
#..#..#...#
#.........#
#.........#
D...#..#..#
#.........#
#.........#
#..#......#
#.........#
#####D#####
key : 1

3
2
#####D#####
#.........#
#.......#.#
#....####.#
#.#.#...#.#
D.........#
#.#.#.....#
##........#
##..#.p...#
#.....s?.e#
###########
enemies 1
switch 0 : 0 1
sign The brave are rewarded.

0
0
###########
#.........#
#.#.#.#.#.#
#.........#
#....#.#..#
#.........#
#.#.#.#...#
#.........#
#..#...#.##
#.........#
#####l#####
locked : 2

2
1
###########
#.........#
#.........#
#.........#
#.........#
D.........D
#.........#
#.........#
#.........#
#.........#
#####D#####

1
0
#####l#####
#......#.##
#.....##..#
#.....###.#
#....#....#
#....#.#..#
#.........#
#.........#
#.........#
#.........#
#####D#####

5
0
#####D#####
#.........#
#.#.#.#.#.#
#.........#
#..#.#.#..#
#.........d
#...#.#.#.#
#.........#
#......#.##
#........k#
#####D#####
key : 3

2
0
#####D#####
#.........#
#.........#
#.........#
#.........#
#....@.#..D
#.........#
#....####.#
#.......#.#
#?p.......#
#####D#####
sign The ceiling is higher than it looks.

3
0
#####D#####
#.........#
#..#......#
#.#.......#
#.........#
#.........D
#.........#
#.......#.#
#......#..#
#..#......#
#####d#####

5
1
#####d#####
#.........#
#.........#
#.........#
#.........#
d.........l
#.........#
#.........#
#.........#
#.........#
#####D#####

8
1
#####D#####
#.........#
#p........#
#.###.....#
#.#.......#
#...#.....#
#.........#
#.........#
#.........#
#X........#
###########

7
1
#####l#####
#.........#
#.........#
#.........#
#.........#
#...pe....D
#.........#
#.........#
#.........#
#.........#
#####D#####
locked : 5
boss
enemies 1

4
1
#####D#####
#..#.....##
#.........#
#.........#
#...#..#..#
D.........#
#.........#
#..#..#...#
#.........#
#.........#
#####d#####

4
0
#####d#####
#.........#
#.........#
#.........#
#.........#
#.....#...D
#.........#
#.........#
#.........#
#.........#
#####D#####

6
2
#####D#####
#.#.......#
#.........#
#.........#
#...#.....#
d.........#
#...#.....#
##........#
#..##.....#
#.........#
#####D#####

