6
2
###########
#.#.....#k#
#.........#
#....#...##
#.........#
....#.#...#
#.........#
#..#...#.##
#.........#
#.#.....#.#
###########
key : 8

4
1
#####.#####
#.........#
#..#..#..##
#.........#
#.........#
....#..#...
#.........#
#.........#
#..#..#...#
#.........#
#####.#####

6
0
#####d#####
#.........#
#......#..#
#.......#.#
#.........#
#......#..d
#.........#
#....#....#
#..#......#
#.........#
###########

6
1
#####.#####
#.........#
#.........#
#...##....#
#..###....#
d..##e.....
#.........#
#.........#
#.........#
#.........#
#####.#####
boss
enemies 1

1
1
#####.#####
#.........#
#...#...#.#
#.......#.#
#....##.#.#
d....##....
#...#####.#
#.........#
#.........#
#.........#
#####.#####

4
2
###########
#........k#
#...#.#...#
#.#.##....#
#.........#
......#...#
#.........#
#.........#
#.........#
#.........#
###########
key : 3

1
2
###########
#........k#
##.#.....##
#.........#
#..#...#..#
..........#
#..#.#.#..#
#.........#
##.....#.##
#.........#
#####.#####
key : 1

3
0
#####.#####
#.........#
#..#......#
#.#.......#
#.........#
#..........
#.........#
#.........#
#.........#
#.........#
#####.#####

1
0
#####.#####
#.........#
#......#..#
#.......#.#
#.........#
#.........d
#.........#
#.........#
#.........#
#.........#
#####.#####

0
1
###########
#.....e#ee#
#..#...?..#
#..###.#..#
#.........#
...#..##..#
#.....##..#
#....#....#
#.........#
#.........#
#####.#####
enemies 3
door 0 : 0 1
sign The dungeon remembers all who enter.

5
0
#####d#####
#.........#
##.#...#.##
#.........#
#..#.#.#..#
#..........
#..#...#..#
#.........#
##.....#.##
#.........#
#####d#####

0
0
###########
#e........#
#s........#
#.........#
#.........#
#..........
#.........#
#.........#
#.........#
#.........#
#####.#####
enemies 1
switch 0 : 0 1

2
2
#####.#####
#.#.....#.#
#.........#
#.#.#.#.#.#
#.........#
l...#.#...#
#.........#
#.#.#.#...#
#.........#
#.#.....#.#
###########
locked : 0

7
1
#####.#####
#.........#
#.........#
#.....###.#
#...##.#..#
#....#....#
#....####.#
#....#..#.#
#.........#
#X........#
###########

3
1
#####.#####
#.........#
#.........#
#...#####.#
#.....#k#.#
....###...#
#...##.##.#
#......#..#
#.........#
#.........#
#####.#####
key : 0

2
1
#####.#####
##.#...#..#
#.........#
#.#.#.#.#.#
#.........#
...#.#.#..l
#.........#
#.#.#.....#
#.........#
##.#.....##
#####.#####

5
1
#####.#####
#.........#
#..#......#
#.#.......#
#.........#
..........#
#.........#
#.......#.#
#......#..#
#.........#
#####.#####

2
0
#####.#####
#.........#
#.........#
###.......#
#.##......#
#..#.@.....
#.........#
#.........#
#.........#
#.........#
#####.#####

4
0
#####.#####
#e........#
#.........#
#...#..#..#
#e........#
#e.........
#...#..#..#
#.........#
#.........#
#.........#
#####d#####
enemies 3

