1
2
#####.#####
#.........#
#.....#...#
#......#..#
#.#.......#
#..........
#.........#
#.#.......#
#..#......#
#.........#
#####.#####

2
4
###########
#...e?....#
#..e#.....#
#..#e.....#
#.........#
...........
#.........#
#.........#
#.........#
#.........#
###########
enemies 3
sign Many have walked this path.

3
5
#####.#####
#.........#
#.........#
#.........#
#.........#
#..........
#.........#
#.........#
#.........#
#k........#
###########
key : 4

1
6
#####.#####
#.........#
#.....##..#
#...#.###.#
#...##..#.#
#....e.#..#
#....####.#
#.........#
#.........#
#.........#
#####d#####
boss
enemies 1

0
6
###########
##X#......#
#.........#
#.##......#
#.#.#.....#
#....#....#
#.........#
#.........#
#.........#
#.........#
#####.#####

3
6
#####.#####
#.........#
#.........#
#.........#
#.........#
..........#
#.........#
#.......#.#
#......#..#
#........k#
###########
key : 8

2
5
###########
#.#.....#.#
#.........#
#.........#
#..#......#
..........d
#.........#
#.#..#..#.#
#.........#
#.........#
#####.#####

2
6
#####d#####
#.........#
#.......#.#
#.........#
#.........#
d..........
#.........#
#.........#
#.#.....#.#
#.........#
#####.#####

2
3
#####.#####
#.........#
#..#......#
#.#.......#
#.........#
d..........
#.........#
#.#.......#
#..#......#
#.........#
###########

1
3
###########
#.........#
#......#..#
#.......#.#
#.........#
..........#
#.........#
#.#.....#.#
#..#...#..#
#.........#
#####.#####

3
1
#####l#####
#.........#
#..#......#
#.#.......#
#.........#
...........
#.........#
#.......#.#
#......#..#
#.........#
###########
locked : 0

2
7
###########
#........k#
##.....#.##
#.........#
#..#.#....#
..........#
#..#...#..#
#.........#
##.....#.##
#.........#
###########
key : 9

2
0
#####d#####
#.........#
#.........#
#.........#
#.........#
#?...@.....
#.........#
#.........#
#.........#
#.........#
#####.#####
sign Something glints behind that door…

2
2
#####.#####
#.........#
#.....##..#
#..#..e#..#
#...###...#
......##..d
#..#..#...#
##........#
#.........#
#.........#
#####.#####
enemies 1

2
1
###########
#.........#
#.........#
#.......###
#.....###.#
.....#.....
#.....##..#
#..#.######
#.........#
#.........#
#####l#####

3
2
#####.#####
#.........#
#.........#
#.........#
#...####..#
.....##...#
#...##s#..#
#...#..#..#
#...#.#...#
#.....?..e#
###########
enemies 1
switch 0 : 0 1
sign Turn back; you are not yet ready.

0
2
###########
#e.......?#
##.#...#.##
#.........#
#.#.#.#.#.#
#.........#
#..#.#.#..#
#.........#
#.#.#.#...#
#.........#
#####.#####
enemies 1
door 0 : 0 1
sign Beware what lurks ahead.

1
0
###########
#.........#
#.........#
#.........#
#.........#
#.........#
#.........#
#.........#
#.........#
#.........#
#####d#####

3
0
#####.#####
#.........#
#.......#.#
#.........#
#.........#
#..#..#....
#.........#
#.........#
#.......#.#
#k........#
###########
key : 0

