4
2
#####d#####
#.........#
#.........#
#.........#
#.....#...#
D..p.#.#..#
#....#.#..#
#.........#
#.........#
#.........#
#####D#####

7
1
#####d#####
#.........#
#...#...#.#
#....###..#
#......##.#
#...#e....#
#....#.#..#
#.........#
#.........#
#.........#
#####D#####
boss
enemies 1

3
1
#####D#####
#........##
#.##......#
#.#.......#
#.........#
l.........D
#.........#
#.#.......#
#..#......#
#.........#
#####D#####
locked : 0

5
0
#####D#####
#.........#
#.........#
#.....##..#
#....###..#
#.....#...D
#.........#
#.........#
#e........#
#e........#
###########
enemies 2

5
3
###########
#.......ee#
#.....#.#.#
#.........#
#.#.#.#.#.#
D.........#
#.#.#...#.#
#.........#
#...#.#.#.#
#........e#
###########
enemies 3

2
2
###########
#.........#
#.........#
#.#.......#
#..#......#
D..##.....#
#.#.......#
#####.....#
#.........#
#.........#
#####D#####

5
1
#####l#####
#.........#
#.........#
#.........#
#.........#
D.........d
#.........#
#.........#
#.........#
#.........#
#####D#####
locked : 3

6
2
#####D#####
#.........#
#..#...#..#
#.#.....#.#
#.........#
D.........#
#.........#
#.#.......#
#..#......#
#.........#
###########

3
0
#####D#####
#.........#
#.........#
#.#..#..#.#
#.........#
#.........l
#k#..#..#.#
#.........#
#.........#
#.#.....#.#
#####D#####
key : 0

5
2
#####D#####
#.........#
#...#..#..#
#.........#
#.........#
d....#....D
#.........#
#.........#
##..#..#..#
#.........#
#####D#####

2
0
#####D#####
#.........#
#.........#
#.........#
#.........#
#....@....D
#.........#
#.........#
#.........#
#.........#
#####D#####

0
0
###########
#.........#
#..#......#
#.#.......#
#.........#
#.........#
#.........#
#.........#
#.........#
#.........#
#####d#####

6
1
#####D#####
#k........#
##.....#.##
#.........#
#.#.#...#.#
#.........D
#..#...#..#
#.........#
#...#.#.#.#
#.........#
#####d#####
key : 9

3
2
#####D#####
#.......#.#
#...#.#.#.#
##....#...#
#..####.#.#
D......#..#
#..##.....#
#.........#
#.........#
#.........#
#####d#####

2
1
###########
#....e....#
#.........#
#..###....#
#..#.?....#
D....#....D
#.........#
#.........#
#.........#
#.........#
#####D#####
enemies 1
sign Seek the matching key before you proceed.

1
0
#####d#####
#.........#
#......#..#
#.......#k#
#.........#
#.........#
#.........#
#.......#.#
#......#..#
#.........#
#####D#####
key : 1

4
1
#####D#####
#k........#
#..#......#
#...#..#..#
#.........#
D.........D
#.........#
#.#.....#.#
#..#...#..#
#.........#
#####l#####
key : 3

4
0
#####D#####
#.........#
#.........#
#.........#
#.........#
#.........D
#.........#
#.........#
#.........#
#.........#
#####D#####

8
1
#####D#####
#.........#
#.....#.#.#
#.###.#.#.#
#.#.#####.#
#...#.#...#
#.#...#...#
#.p.......#
#.........#
#X........#
###########

