2
5
###########
#s...e....#
#.........#
#.........#
#..#......#
...#.......
#.#.......#
#.........#
#.........#
#....e....#
###########
enemies 2
switch 0 : 0

2
7
###########
#........e#
#.........#
#.......#.#
#.........#
..........#
#.........#
#.........#
#.........#
#.........#
###########
enemies 1
door 0 : 0

4
4
#####.#####
#.........#
#####.....#
#.#.......#
#...##....#
#....#....#
#.###.#...#
#.........#
#...#.....#
#X........#
###########

2
6
###########
#..e......#
#..#......#
#...e#....#
#...##.#..#
...#e#.....
#..#.#.#..#
#.........#
#.........#
#.........#
###########
enemies 3
door 1 : 1 2

2
4
#####.#####
#e.......e#
#.........#
#..#..#..##
#.........#
...........
#...#..#..#
#.........#
#.........#
#e.......?#
#####d#####
enemies 3
sign Beware what lurks ahead.

1
3
###########
#....k....#
#.........#
#..#......#
#.........#
...........
#.........#
#.........#
#.........#
#.........#
#####.#####
key : 4

1
4
###########
#......?.s#
#......#..#
#.......#.#
#.........#
..........#
#.........#
#.........#
#.........#
#.........#
#####.#####
switch 1 : 1 2
sign A useful tool lies just ahead.

2
1
#####.#####
#..#......#
#.........#
#.........#
#...#..#..#
..........l
#.........#
#........##
#.........#
#.........#
#####.#####

2
2
#####.#####
#.........#
#.........#
#.........#
#....#....#
l..###....d
#..#.#....#
#.........#
#.........#
#.........#
###########
locked : 1

3
1
#####.#####
#.........#
#.........#
#.........#
#.........#
..........#
#.........#
#.........#
#.........#
#.........#
###########

3
4
#####d#####
#.........#
#.........#
#.#.......#
#.#.......#
...#.e....#
#..#......#
##........#
#...#.....#
#.........#
#####.#####
boss
enemies 1

1
1
###########
#k........#
##.#.....##
#.........#
#.#.....#.#
...........
#..#......#
#.........#
#.#.#.#...#
#.........#
#####.#####
key : 3

3
0
#####.#####
#.........#
##.#...#.##
#.........#
#.#...#.#.#
#..........
#....#.#..#
#.........#
#.#.......#
#k........#
###########
key : 1

2
0
#####.#####
#.........#
#.........#
#.........#
#.........#
#..##@.....
#?.#.#....#
####.#....#
####......#
#.........#
#####.#####
sign The brave are rewarded.

2
3
#####.#####
#.........#
#.........#
#.........#
#.........#
d..........
#.........#
#.........#
#.........#
#.........#
#####l#####

0
2
###########
###.......#
###.#.....#
####......#
#.#.#.....#
#...##....#
#.##......#
#.........#
#.........#
#.........#
#####d#####

1
0
###########
#k........#
#.#.......#
#.........#
#.........#
#..#..#....
#.........#
#.........#
#.......#.#
#.........#
#####.#####
key : 0

1
2
#####d#####
#.........#
#..##.....#
###.##....#
#...##.#..#
.....#.....
#.........#
#.........#
#.........#
#.........#
#####.#####

3
3
#####l#####
#.........#
#.........#
#.........#
#..#......#
#..........
#..#......#
#.........#
#.........#
#.........#
###########
locked : 0

