3
0
#####.#####
#.........#
#.........#
#.........#
#.........#
#..........
#.........#
#.........#
#.........#
#k........#
###########
key : 0

2
2
#####.#####
#..#.....##
#.........#
#.........#
#..#..#...#
l..........
#.........#
#..#..#..##
#.........#
#.........#
#####.#####
locked : 0

3
2
#####.#####
#.........#
#..#......#
#..#..##..#
#..##..#..#
...####...d
#..#k#.#..#
#.........#
#.........#
#.........#
#####d#####
key : 3

2
0
#####.#####
#.........#
#.........#
#.........#
#?##......#
#....@.....
#.#.......#
#.........#
#.........#
#.........#
#####.#####
sign Those who search shall find.

2
3
#####.#####
#?........#
#.........#
#.........#
#.........#
...........
#.....#...#
#....#e...#
#.....#...#
#.........#
#####.#####
enemies 1
sign Seek the matching key before you proceed.

0
0
###########
##k#...#.##
#.........#
#.#.#.#.#.#
#.........#
#....#....#
#.........#
#.#.#.#.#.#
#.........#
##.#.....##
#####.#####
key : 2

4
1
#####.#####
##.#...#.##
#.........#
#.#.#.#.#.#
#.........#
#..#.#.....
#.........#
#.#...#.#.#
#.........#
##.#...#.##
###########

3
3
#####.#####
#.........#
#.........#
#.........#
#.........#
d.........#
#.........#
#.........#
#.........#
#.........#
###########

1
2
###########
#.........#
#......#..#
#.......#.#
#.........#
l..........
#.........#
#.......#.#
#......#..#
#.........#
#####.#####
locked : 2

1
1
###########
#..k......#
#..#...#..#
#.#.....#.#
#.........#
..........l
#.........#
#.........#
#.........#
#.........#
#####.#####
key : 1

4
2
#####d#####
#.........#
#..#..#...#
#.#.......#
#.........#
..........#
#..#......#
#.#.......#
#..#......#
#.........#
###########

3
1
#####.#####
#..#.....##
#.........#
#.........#
#...#..#..#
...........
#.........#
#..#.....##
#.........#
#.........#
#####.#####

1
3
#####d#####
#.........#
#.........#
#.........#
#......##.#
...#..##..d
#..#.##.#.#
###.....#.#
#.....##..#
#.........#
#####.#####

1
0
#####.#####
#.........#
#.........#
#.........#
#.........#
#..........
#.........#
#.........#
#.........#
#.........#
#####.#####

2
1
#####.#####
#?e#......#
#.#e#.....#
#.#.......#
#.........#
..........l
#.........#
#.........#
#.........#
#.........#
#####.#####
enemies 2
sign Seek the matching key before you proceed.

2
4
#####.#####
#.........#
#..#..##..#
#.#..#..#.#
#.....#...#
..........#
#.........#
#.......#.#
#......#..#
#.........#
###########

0
4
###########
#........X#
#.........#
#.........#
#....####.#
....####..#
#.......#.#
#....#.#..#
#...#.....#
#.........#
#####.#####

1
4
#####.#####
#.........#
#.........#
#.........#
#.........#
d....e....#
#.........#
#.........#
#.........#
#.........#
#####.#####
boss
enemies 1

0
3
###########
#.........#
#.........#
#.........#
#.........#
#..........
#.........#
#.........#
#.........#
#.........#
#####d#####

