1
3
#####d#####
#.........#
#.........#
#.........#
#.........#
D.........d
#.........#
#.........#
#.........#
#.........#
#####D#####

2
2
#####D#####
#..#.....##
#.........#
#.........#
#..#..#...#
l.........D
#.........#
#..#..#..##
#.........#
#.........#
#####D#####
locked : 0

1
0
#####D#####
#.........#
#..#......#
#..#..##..#
#..##..#..#
#..####...D
#..#.#.#..#
#.........#
#.........#
#.........#
#####D#####

3
3
#####D#####
#......#..#
#.........#
#.........#
#......#..#
d.........#
#.........#
##.....#..#
#.........#
#.........#
###########

2
1
#####D#####
#e........#
#..#..#...#
#.........#
#.........#
D..#......l
#.........#
#.........#
#..#..#..##
#?.......e#
#####D#####
enemies 2
sign Seek the matching key before you proceed.

1
2
###########
#.........#
##..#..#..#
#.........#
#.........#
l....#....D
#.........#
#.........#
##..#..#..#
#.........#
#####D#####
locked : 2

4
2
#####d#####
#.........#
#.........#
#.........#
#.........#
D.........#
#......#..#
#.........#
#.....##..#
#.........#
###########

2
0
#####D#####
#.........#
#..#......#
#..?##....#
#..#.#....#
#....@....D
#.........#
#.........#
#.........#
#.........#
#####D#####
sign Those who search shall find.

2
4
#####D#####
#.........#
#.#....#..#
#.......#.#
#.........#
D.........#
#.........#
#.#.......#
#..#......#
##........#
###########

1
1
###########
#....k....#
#.........#
#.........#
#.........#
D.........l
#.........#
#.........#
#.........#
#.........#
#####D#####
key : 1

4
1
#####D#####
#.........#
#.........#
#.........#
#.........#
#.........D
#.........#
#.......#.#
#......#..#
#.........#
###########

0
3
###########
#.........#
#.........#
#...#..#..#
#.........#
#.........D
#...#..#..#
#.........#
#.........#
#.........#
#####d#####

3
1
#####D#####
#.........#
#..#......#
#.#.......#
#.........#
D.........D
#.........#
#.........#
#.........#
#.........#
#####D#####

0
0
###########
#k.#.....##
#.........#
#.........#
#...#..#..#
#.........#
#.........#
#..#.....##
#.........#
#.........#
#####D#####
key : 2

1
4
#####D#####
#.........#
#.........#
#.........#
#.........#
d....e....#
#.........#
#.........#
#.........#
#.........#
#####D#####
boss
enemies 1

0
4
###########
#..p.....X#
##..#.....#
##.##.....#
#..##.#...#
D..####...#
#.####....#
#...##....#
#..##..#..#
#.........#
#####D#####

3
2
#####D#####
#k........#
#.........#
#.........#
#.........#
D.........d
#.........#
#.#.......#
#..#......#
#.........#
#####d#####
key : 3

3
0
#####D#####
#.........#
#..#......#
#.#..#....#
#.........#
#.........D
#.........#
##......#.#
#......#..#
#k........#
###########
key : 0

2
3
#####D#####
#e.......?#
#.........#
##..#..#..#
#.........#
D.........D
#...#.....#
#.........#
#.........#
##.....#..#
#####D#####
enemies 1
sign Seek the matching key before you proceed.

