3
1
#####.#####
#.........#
#.........#
#.........#
#.........#
d..........
#.........#
#.........#
#.........#
#.........#
###########

1
3
###########
#..#.....##
#.........#
#.........#
#...#.....#
..........#
#.........#
#..#..#..##
#.........#
#.........#
#####d#####

3
2
#####.#####
#k........#
#.........#
#.........#
#.........#
...........
#.........#
#.........#
#.........#
#.........#
#####d#####
key : 3

0
0
###########
#.........#
#.........#
#.........#
#.........#
#.........#
#.........#
#....#....#
#......#..#
#.........#
#####.#####

3
4
#####.#####
##.#.....##
#.........#
##.#.#.#..#
#.........#
...........
#.........#
##...#....#
#.........#
##k#...#.##
###########
key : 4

1
2
###########
#.........#
#.........#
#.........#
#.........#
...........
#.........#
#.........#
#.........#
#.........#
#####.#####

2
1
#####.#####
#.........#
#.........#
#.........#
#.........#
...........
#.........#
#..##.....#
#.........#
#.........#
#####.#####

2
0
#####.#####
##.....#.##
#k........#
##.#.#.#.##
#.........#
#..#.#.#...
#.........#
##...#.#.##
#.........#
##.....#..#
#####l#####
key : 0

2
2
#####.#####
#........k#
#..#.....##
#.........#
#.........#
....#..#...
#.........#
#.........#
#..#.....##
#.........#
#####.#####
key : 1

1
1
###########
#....?....#
#.........#
#.#.e##...#
#.###e#...#
...##.#....
#..e#.#...#
#.##......#
#.........#
#.........#
#####.#####
enemies 3
sign Many have walked this path.

4
0
#####d#####
#.........#
#.........#
#.........#
#.........#
#.........#
#.........#
#.........#
#.........#
#.........#
###########

2
5
###########
#.........#
#.........#
#.#.......#
#..#......#
l..#.e....#
#.........#
#.........#
#.........#
#.........#
#####.#####
locked : 1
boss
enemies 1

1
0
#####.#####
#.........#
##..#.....#
#.........#
#..#@#....#
#..?##.....
#..##.....#
#.........#
#.........#
#.........#
#####.#####
sign The walls are warm to the touch.

3
3
#####.#####
#.........#
#.........#
#.#.......#
#...#e#...#
...#e###...
#.#..?.##.#
#.#..#....#
#.........#
#.........#
###########
enemies 2
sign The brave are rewarded.

3
0
#####l#####
#.........#
#.#.#.#.#.#
#.........#
#.#.#.#.#.#
#.........d
#.#...#...#
#.........#
#.#.......#
#.........#
#####d#####
locked : 0

4
2
#####d#####
#.........#
#.........#
#..#......#
#.........#
#.........#
#.....#...#
#.......#.#
#..#...#..#
#.........#
###########

2
4
###########
#.........#
##.#...#.##
#.........#
#.#...#.#.#
l.........l
#....#.#..#
#.........#
#.#.#.#.#.#
#.........#
#####.#####
locked : 3

2
3
#####d#####
#.........#
#..#..#...#
#.........#
#.........#
......#...l
#.........#
#.........#
#..#..#...#
#.........#
#####.#####

3
5
#####.#####
#.........#
#.........#
#.........#
#.........#
..........#
#.........#
#.........#
#.........#
#........X#
###########

