2
2
#####.#####
#.........#
#.........#
#.........#
#.........#
...#.#.#...
#..#..#...#
#..#.##...#
#...#..#..#
#..#...#..#
#####.#####

3
1
#####l#####
#.........#
##..#..#..#
#.........#
#.........#
....#......
#.........#
#.........#
##..#..#..#
#.........#
#####.#####

1
1
#####.#####
#.##......#
#.#.#.....#
#.#.......#
#.........#
#..........
#.........#
#.........#
#.........#
#.........#
#####d#####

3
4
###########
#........e#
#.........#
#.#..#..#.#
#.........#
..........#
#.....#...#
#.........#
#.........#
#.#....?#e#
###########
enemies 2
door 0 : 0
sign Many have walked this path.

5
1
#####.#####
#.........#
#......#..#
#.......#.#
#.........#
d.........#
#......#..#
#.........#
#.........#
#.........#
###########

3
2
#####.#####
#k#.....#.#
#.........#
#.#...#.#.#
#.........#
......#....
#.........#
#.#.#.#...#
#.........#
#.#.......#
#####.#####
key : 1

0
1
###########
#k........#
#......#..#
#.......#.#
#.........#
#.........#
#.........#
#.......#.#
#......#..#
#.........#
#####.#####
key : 5

5
0
#####l#####
#.........#
#.#.#.#...#
#.#.###...#
#.###.....#
#..#.##...d
#..#.#....#
#.#..#....#
#.........#
#.........#
###########
locked : 0

3
0
#####d#####
#.........#
#.........#
#..#......#
#..###....#
#..?#@.....
#.........#
#.........#
#.........#
#.........#
#####.#####
sign What you seek is close.

1
3
###########
#........X#
#.........#
#.........#
#.........#
..........#
#.........#
#.........#
#.........#
#.........#
#####.#####

2
0
###########
#.........#
#.#.......#
#...#.....#
#.........#
#..........
#...#.....#
#.........#
#.........#
#.........#
#####d#####

2
1
#####d#####
#.........#
#.#.#.#...#
#.........#
#.....#...#
...##......
#.#####...#
#.........#
#.........#
#.........#
#####l#####
locked : 1

3
3
#####d#####
#.........#
#.........#
#.........#
#.........#
...........
#.........#
#.......#.#
#......#..#
#.........#
#####.#####

1
2
###########
#....e....#
#.........#
#.#.....#.#
#.........#
...........
#....#..#.#
#.........#
#.........#
#e#.....#e#
#####.#####
enemies 3

4
3
#####.#####
#.........#
#.........#
#.........#
#.........#
..........#
#.........#
#.........#
#.........#
#........k#
###########
key : 4

4
2
#####.#####
#e.......e#
##.#.....##
#.........#
#....#.#..#
...........
#..#.#.#..#
#.........#
##.....#.##
#e.....?.s#
###########
enemies 3
switch 0 : 0
sign Those who search shall find.

2
3
#####.#####
#.........#
#.........#
#.........#
#.........#
.....e....#
#.........#
#.........#
#.........#
#.........#
#####d#####
boss
enemies 1

4
1
#####.#####
#.........#
#.........#
#.........#
#.........#
...........
#.........#
#.......#.#
#......#..#
#.........#
#####.#####

4
0
#####.#####
#.........#
#......#..#
#.......#.#
#.........#
#k.........
#.........#
#......#..#
#.........#
#.........#
#####l#####
key : 0

