2
0
#####.#####
#.........#
#.........#
#.........#
#.........#
#k........#
#.........#
#.........#
#.........#
#.........#
#####.#####
key : 1

3
2
#####d#####
#k........#
#.........#
#.........#
#.........#
....#.#....
#.........#
#....##...#
#.........#
#.........#
#####.#####
key : 2

1
0
#####l#####
#........e#
#..#..#..##
#.........#
#.........#
#.....#....
#.........#
#.........#
#..#..#..##
#........?#
#####.#####
enemies 1
door 0 : 0 1
sign Only the prepared may pass.

6
0
#####.#####
#..#......#
#.........#
#.........#
#...#.....#
#.........#
#.........#
#..#.....##
#.........#
#k........#
###########
key : 0

5
1
#####.#####
#......s#e#
#...#.##..#
#..###....#
#..#......#
.....#.#...
#.........#
#.........#
#.........#
#....e....#
###########
enemies 2
switch 0 : 0 1

1
1
#####.#####
#.........#
#......#..#
#.......#.#
#.........#
..........#
#.........#
#.........#
#.........#
#.........#
###########

3
1
###########
#..e..ee..#
#..#..##..#
#..#..##..#
#.....###.#
......##...
#.........#
#.........#
#.........#
#.........#
#####.#####
enemies 3

3
0
#####.#####
#.........#
#.........#
##........#
#..#......#
#..........
#....#....#
#.#.......#
#..#......#
#.........#
#####.#####

4
0
#####.#####
#......#..#
#.....#...#
#..##.#...#
#..##.#...#
#..#@###..d
#.........#
#.........#
#.........#
#.#.......#
#####.#####

0
1
###########
#........k#
##.#...#.##
#.........#
#.#.#.#.#.#
..........#
#..#.#....#
#.........#
#...#...#.#
#.........#
#####.#####
key : 3

4
3
#####.#####
#.........#
#......#..#
#.......#.#
#.........#
l.........#
#.........#
#.........#
#.........#
#.........#
###########
locked : 1

4
2
#####.#####
#.........#
#......#..#
#.......#.#
#.........#
d.........l
#.........#
#.........#
#.........#
#.........#
#####.#####

2
2
###########
#.........#
#......#..#
#.......#.#
#.........#
#.........d
#.........#
#.......#.#
#......#..#
#.........#
#####d#####

5
0
#####.#####
#.........#
##.#......#
##.####...#
#...##....#
#...#.#....
#.........#
#.........#
#.........#
#.........#
#####.#####

2
3
###########
#.........#
#.........#
#.........#
#.....#.#.#
d....e#...#
#.........#
#.........#
#.........#
#.........#
#####.#####
boss
enemies 1

0
0
###########
#.........#
#.........#
#.#.......#
#.........#
#..........
#.#..#..#.#
#.........#
#.........#
#.#.....#.#
#####l#####
locked : 0

4
1
#####.#####
##.#...#.##
#.........#
#...#.#...#
#.........#
d..#...#..d
#.........#
#.#.#.#.#.#
#.........#
##.#...#.##
#####.#####

5
2
#####.#####
#.........#
#......#..#
#.......#.#
#.........#
..........#
#.........#
#.......#.#
#......#..#
#.........#
###########

3
3
#####.#####
#..#......#
#...#..#..#
#...#..#..#
#...###X#.#
.....##...#
#.....#.#.#
#....#....#
#...#.#.#.#
#.........#
#####.#####

