3
2
#####D#####
#.........#
#.........#
#.........#
#.........#
D.........d
#.........#
#.........#
#.........#
#.........#
#####D#####

4
2
#####D#####
#.........#
#......#..#
#.......#.#
#.........#
d....#....D
#.........#
#........##
#.........#
#.........#
###########

5
1
#####D#####
#.........#
#.........#
#.........#
#.........#
D.........#
#.........#
#.........#
#.........#
#.........#
###########

3
0
#####D#####
#.........#
#..#..#...#
#..####...#
#..#@.....#
#?.###....D
#..##..#..#
#...#.....#
#.........#
#.........#
#####D#####
sign A useful tool lies just ahead.

6
0
#####D#####
##.....#..#
#.........#
#.........#
#...#.....#
#.........#
#.........#
#...#..#..#
#e........#
#e.......e#
###########
enemies 3

4
1
#####D#####
##e#......#
#.........#
#.#...#.#.#
#.........#
D..#.#.#..d
#.........#
#.#.#.#...#
#.........#
#..#...#s##
#####D#####
enemies 1
switch 0 : 0

1
3
#####D#####
#.##......#
#.##......#
#..#.#....#
#.##e.....#
l..###....#
#.....##..#
#...#.##..#
#..##.....#
#......#..#
#####D#####
locked : 4
boss
enemies 1

3
3
#####D#####
#.........#
#.........#
#.........#
#.........#
d.........d
#..##.....#
#.##......#
#.........#
#.........#
#####D#####

3
1
###########
#....k....#
#.........#
#..#..#...#
#.........#
D.........D
#.....#...#
#.........#
#.........#
#..#.....##
#####D#####
key : 0

4
0
#####D#####
#.........#
#.........#
#....p....#
#.p.......#
#.........D
#.........#
#.........#
#.........#
#.........#
#####l#####

5
0
#####l#####
#.........#
#..#......#
#.#.......#
#...##....#
#.........D
#.........#
##......#.#
#......#..#
#.........#
#####D#####
locked : 0

3
4
#####D#####
##........#
#.........#
#.........#
#...#..#..#
d.........#
#.........#
##..#..#..#
#.........#
#.........#
###########

2
4
###########
#.#....e#e#
#.......e.#
#.#.#.#.#?#
#.........#
D.....#...#
#.........#
#.#.#.#...#
#.........#
#.#.......#
#####D#####
enemies 3
door 0 : 0
sign The dungeon remembers all who enter.

1
2
###########
##.....#.##
#k........#
#.....#.#.#
#.........#
#....#.#..l
#.........#
#.#...#.#.#
#.........#
#..#...#.##
#####D#####
key : 5

2
3
#####D#####
##.....#..#
#.........#
#.........#
#.......#.#
d.........D
#.........#
##..#..#..#
#.........#
#.........#
#####D#####

4
3
#####D#####
#.........#
#......#..#
#.......#.#
#.........#
D.........#
#.........#
#.......#.#
#......#..#
#........k#
###########
key : 6

0
3
###########
#..#.....X#
#......#.##
#....#.#.##
#.....###.#
#....###..#
#...###...#
#.........#
#.........#
#.........#
#####D#####

2
2
#####D#####
#.........#
#.#.....#.#
#.........#
#....#.#..#
#.........d
#k#.#.#.#.#
#.........#
#..#...#.##
#.........#
#####D#####
key : 4

2
0
###########
#..#.....##
#.........#
#.........#
#..#..#...#
#.........#
#.........#
#..#..#..##
#.........#
#.........#
#####D#####

