3
0
#####.#####
##.....#..#
#.........#
#.........#
#...#.....#
#..........
#k........#
##..#..#..#
#.........#
#.........#
#####.#####
key : 0

1
2
###########
#......#.k#
#..#...#..#
#.#.....#.#
#.........#
..........#
#.........#
#.#.......#
#..##.....#
#.......#.#
#####.#####
key : 2

4
2
#####d#####
#.........#
#.........#
##..#.....#
#.........#
#..........
#...#..#..#
#.........#
#.........#
#......#..#
#####.#####

6
2
#####d#####
#.........#
#.........#
#.........#
#.........#
#....e....#
#....#....#
#.........#
#.........#
#.........#
#####.#####
boss
enemies 1

3
1
#####.#####
#.#.......#
#.........#
#...#...#.#
#.........#
....#.#...d
#.........#
#.#.#.#.#.#
#.........#
#.........#
###########

2
3
###########
#........k#
#.........#
#.#.......#
#.........#
....####..#
#..##.#...#
#..#..##..#
#.....##..#
#.........#
#####.#####
key : 1

2
0
#####.#####
#.........#
#.........#
#.........#
#.........#
#....@.....
#.........#
#.........#
#.........#
#.........#
#####.#####

5
3
#####.#####
#......#..#
#......#..#
#...####..#
#...#.#...#
....#.#...#
#.........#
#.........#
#.........#
#.........#
###########

5
2
#####.#####
#......##.#
#.....##..#
#.....##.##
#.....##..#
#...#......
#k#..#....#
##.#.#....#
#..#......#
#.........#
#####d#####
key : 4

2
2
#####.#####
#.........#
#.........#
#..##.....#
#.#.#.....#
...........
#.........#
#.........#
#.........#
#.........#
#####.#####

1
1
#####d#####
#..#...#..#
#..e#.#...#
#..###s#..#
#....#....#
...........
#.........#
#.........#
#.........#
#.........#
#####.#####
enemies 1
switch 0 : 0

3
3
#####.#####
#.........#
#.........#
#.........#
#.........#
.........e#
#.........#
#.........#
#.........#
#.........#
#####.#####
enemies 1
door 0 : 0

2
1
#####.#####
#.........#
#.........#
#......#..#
#.........#
...........
#.....#...#
#.#.....#.#
#..#...#..#
#.........#
#####.#####

4
3
#####.#####
#.........#
#..#......#
#.#.......#
#.........#
..........#
#.........#
#.#.......#
#..#......#
#.........#
#####.#####

3
2
#####.#####
#.........#
##.#...#..#
#.........#
#.#.#.#.#.#
d..........
#..#......#
#.........#
#.#...#.#.#
#.........#
#####d#####

7
2
#####.#####
#.........#
#.........#
#.........#
#.##......#
#.........#
#.###..##.#
#.....#...#
#.....#...#
#X........#
###########

1
0
###########
#.........#
#.........#
#.....#...#
#.......#.#
#..#..##...
#..###....#
#.........#
#.........#
#.........#
#####.#####

0
1
###########
#.........#
#.........#
#.........#
#.........#
#.........#
#.........#
#.#.......#
#..#......#
#.........#
#####d#####

4
0
#####.#####
#.........#
#.........#
#.........#
#.........#
#.........#
#.........#
#.........#
#e........#
#e?......e#
###########
enemies 3
sign The brave are rewarded.

