4
4
#####D#####
#.........#
#.....#...#
#p...#.##.#
#....#..#.#
D..#.##...#
#..#.#....#
#..##.....#
#.........#
#........X#
###########

3
1
#####D#####
#e#.......#
#.........#
#.........#
#..#..#...#
D........?#
#.........#
#.#..#....#
#.........#
#.........#
#####D#####
enemies 1
sign The brave are rewarded.

4
3
#####D#####
#.........#
##.#...#..#
#.........#
#...#.#.#.#
D.........D
#..#.#.#..#
#.........#
#.#.#.....#
#.........#
###########

2
0
#####d#####
#.........#
#......#..#
#.......#.#
#.........#
#.........D
#.........#
#.........#
#.........#
#.........#
#####D#####

1
3
###########
#........k#
#.........#
#......#..#
#.........#
D.........#
#.#..#..#.#
#.........#
#.........#
#......#..#
#####D#####
key : 1

3
4
#####D#####
#......#..#
#......#..#
#....##...#
#.........#
d....e....D
#.........#
#.........#
#.........#
#.........#
#####D#####
boss
enemies 1

1
0
#####D#####
#.##......#
#.##......#
#..###....#
#..#@.....#
#..###....D
#..p....p.#
#.........#
#.........#
#.........#
#####d#####

4
1
#####D#####
#.........#
#...#..#..#
#.........#
#.........#
#....#....d
#.........#
#.........#
#...#..#..#
#.........#
###########

3
5
###########
#.##.....k#
#.........#
#..##.....#
#.........#
D.........#
#.........#
#.........#
#.........#
#.........#
###########
key : 2

1
1
###########
#e...e....#
#.........#
#.........#
#.........#
D.........D
#.........#
#.........#
#.........#
#?........#
#####D#####
enemies 2
sign What you seek is close.

1
2
###########
#.........#
#.........#
#.........#
#.........#
D.........D
#..##.....#
#...#.....#
#...#.....#
#.........#
#####D#####

0
0
###########
#.........#
#..#...#..#
#.#.....#.#
#.........#
#.........#
#.........#
#.........#
#.........#
#.........#
#####D#####

3
3
#####l#####
#.........#
#.........#
#.#..#....#
#.........#
#.........d
#..#..#...#
#.........#
#.........#
#.#.....#.#
#####D#####
locked : 1

2
2
#####D#####
#......####
#..#..#.#.#
#.......#.#
#.....#...#
l.........d
#.........#
#.........#
#.........#
#.........#
###########
locked : 0

3
0
#####D#####
#.........#
#.........#
#.........#
#.p.......#
#.........D
#.........#
#.........#
#.........#
#e........#
###########
enemies 1

2
1
#####D#####
#.........#
#...#.#.#.#
#.........#
#..#.#.#..#
D.........l
#.#.#.#.#.#
#.........#
#..#...#.##
#........k#
#####D#####
key : 0

2
4
###########
#.#......k#
#.........#
#.........#
#.#..#....#
D.........#
#.........#
#.#..#..#.#
#.........#
#.........#
#####D#####
key : 3

4
2
###########
#.........#
#.........#
#..#......#
#.........#
d.........D
#..#..#...#
#.........#
#.........#
#..#.....##
###########

2
3
#####D#####
#.........#
##.#...#.##
#.........#
#...#.#.#.#
d.........D
#..#.#.#..#
#.........#
#.#.#.#.#.#
#.........#
#####l#####

