8
2
#####D#####
#.........#
#.........#
#.........#
#.........#
d.........#
#.........#
#.........#
#.........#
#.........#
###########

9
1
#####l#####
#.........#
#.........#
#.........#
#.#.#.....#
#.........#
#.##.#....#
#..#......#
#.........#
#......p..#
###########
locked : 6

7
0
#####D#####
#.........#
#.........#
#...###...#
#.........#
#..#####..D
#...###...#
#..#.#....#
#.........#
#.........#
###########

4
0
#####l#####
#........k#
#..#..#..##
#.........#
#.........#
#...#.....D
#.........#
#.........#
#..#.....##
#.........#
#####D#####
key : 0

4
1
###########
#.........#
#......##.#
#.....##..#
#.........#
D.........D
#.........#
#.........#
#.....#...#
#.........#
#####D#####

4
2
###########
#.........#
#.........#
#.#..#..#.#
#.........#
D.........#
#..#..#...#
#.........#
#.........#
#.......#e#
###########
enemies 1

2
1
###########
##.#...#e##
#.........#
##.#.#.#.##
#.........#
D..#.#.#..#
#.........#
##.#.#...##
#.........#
##.....#e##
###########
enemies 2
door 0 : 0 1

3
0
#####D#####
#.........#
#.........#
#.........#
#.........#
#.........#
#.........#
#.........#
#.........#
#.........#
#####l#####
locked : 1

8
1
#####D#####
#.........#
#..#...#..#
#.........#
#..#.#....#
#.........d
#?.#.#....#
#s........#
##.#...#.##
#e.......e#
#####l#####
enemies 2
switch 0 : 0 1
sign A locked path — look elsewhere first.

0
0
###########
#X........#
#.....#...#
#....#....#
#...#.#...#
#.........#
#.........#
#.........#
#.........#
#.........#
#####D#####

6
2
###########
#.........#
#..##.....#
#.#.......#
#.........#
d.........#
#.........#
#..##.....#
#.........#
#.........#
#####D#####

6
0
#####D#####
#.........#
#......##.#
#.....##.##
#...@.....#
#....#....D
#.....##..#
#.........#
#.........#
#.........#
#####D#####

5
0
#####D#####
##.#...#.##
#.........#
##.#.#...##
#.........#
#..#.#.#..D
#.........#
#..#.#.#.##
#.........#
##.#......#
#####D#####

5
1
#####D#####
#.........#
#.........#
#.........#
#.........#
D.........#
#.........#
#.......#k#
#......#..#
#.........#
#####D#####
key : 1

7
1
#####d#####
#.........#
#.........#
#.........#
#.........#
D.........D
#.....#.#.#
#.#.......#
#..##.....#
#.........#
#####D#####

7
2
#####D#####
#k........#
##.#...#.##
#.........#
#..#...#..#
D.........#
#..#......#
#.........#
#..#...#..#
#.........#
#####D#####
key : 4

2
0
#####d#####
#.........#
#.......#.#
#.........#
#..#.#.#..#
#.........D
#k#.#.....#
#.........#
#..#...#.##
#.........#
#####D#####
key : 6

6
1
#####D#####
#.........#
#......#..#
#.......#.#
#.........#
D.........d
#.........#
#.#.....#.#
#..#...#..#
#.........#
#####d#####

1
0
#####D#####
#.........#
#.........#
#.........#
#.........#
#....e....#
#.........#
#.........#
#.........#
#.........#
#####d#####
boss
enemies 1

