5
0
#####l#####
#.........#
#.........#
#.#..#..#.#
#.........#
#.........D
#e#..#..#.#
#.........#
#.........#
#.#.......#
#####D#####
enemies 1

7
3
#####D#####
#.........#
#.........#
#..#.###..#
#..#.###..#
#...#.....#
#..##..#..#
#..##..#..#
#.........#
#.........#
###########

7
0
#####D#####
#.........#
#.........#
#....###.##
#...@.###.#
#..####...#
#...##.#..#
#...#...#.#
#.........#
#.........#
#####D#####

4
1
###########
#.........#
#.........#
#.........#
#.........#
D......#..#
#...#..#..#
#.#.......#
#..#......#
#.........#
#####d#####

4
0
#####D#####
#.........#
#.........#
##.#......#
#.##......#
#..p......D
#.........#
#.........#
#.........#
#.........#
#####l#####
locked : 2

2
1
#####D#####
#.........#
#.#.......#
#.##..#...#
#.p##.....#
D..####...#
#.#..##...#
#.........#
#.........#
#........X#
###########

1
1
###########
#.........#
#.........#
#.........#
#.........#
d....e....#
#.........#
#.........#
#.........#
#.........#
#####D#####
boss
enemies 1

6
4
###########
#........k#
#..#...#..#
#.#.....#.#
#.........#
D.........#
#.........#
#.#.......#
#..#......#
#.........#
###########
key : 6

6
0
#####D#####
###.......#
##.##.....#
#...#.....#
#k###.....#
#.........l
#.........#
#.........#
#.........#
#.........#
#####D#####
key : 0

6
2
###########
#k........#
##.....#..#
#.........#
#....#.#..#
D.........l
#..#.#.#..#
#.........#
##.#...#..#
#.........#
###########
key : 2

2
0
#####D#####
#.........#
#.........#
##..#..#..#
#.........#
#.........D
#....#..#.#
#.........#
#.........#
#......#..#
#####l#####
locked : 6

8
0
#####D#####
#......##.#
#......#..#
#.....##..#
#.........#
#.....##..D
#.....###.#
#s........#
#e........#
#ee.......#
###########
enemies 3
switch 0 : 0

6
1
#####D#####
#.........#
#...#.....#
#.........#
#.........#
l.........D
#.........#
#.#.....#.#
#..#...#.##
#.........#
###########
locked : 0

8
1
###########
#.........#
#..#......#
#.#.......#
#.........#
D.........#
#.........#
#.#.......#
#..#......#
#.........#
###########

5
1
#####d#####
#..#......#
#.........#
#.........#
#.........#
D.........#
#.........#
#.......#k#
#......#..#
#......#..#
#####D#####
key : 1

3
0
#####l#####
#.........#
#......#..#
#.......#.#
#.........#
#.........#
#.........#
#.#.....#.#
#..#...#..#
#.........#
#####D#####

6
3
###########
#.........#
##.......##
#.........#
#......#..#
l.........D
#..#.#....#
#.........#
##.#.....##
#.........#
#####D#####
locked : 1

1
0
#####d#####
#e........#
#.........#
#.........#
#?........#
#e........d
#.........#
#.........#
#.........#
#.........#
#####D#####
enemies 2
door 0 : 0
sign This door will not yield without a key.

0
0
###########
#.........#
#..#......#
#.#.......#
#.........#
#.........#
#.........#
#.#.......#
#..#......#
#.........#
#####d#####

