4
0
###########
#.........#
#...#.....#
#..#......#
#.###.....#
#.........D
#.........#
#.........#
#.........#
#.........#
#####l#####
locked : 0

4
1
###########
#.........#
####......#
#.......#.#
#.#.......#
D.........D
#.........#
#......#..#
#.........#
#.........#
#####D#####

4
2
#####d#####
#?........#
#.........#
#.........#
#.#e#.....#
D..##.....D
#.........#
####......#
#e##......#
#.........#
#####D#####
enemies 2
sign Many have walked this path.

4
4
###########
#........e#
#.........#
#.........#
#.#.#.#.#.#
D......#..#
#.#.###.#.#
#######.#.#
#.##..#...#
#........?#
###########
enemies 1
door 0 : 0
sign Many have walked this path.

7
3
###########
#.........#
#.........#
#.........#
#.........#
d.........#
#.........#
#.#.....#.#
#..#...#..#
#.........#
###########

2
2
###########
#k........#
#.........#
#...##....#
#...###...#
#.........D
#....##...#
#...###...#
#.........#
#.........#
#####D#####
key : 3

5
2
#####D#####
#e.#.....##
#.........#
#.........#
#..#..#...#
D.........D
#.........#
#..#..#..##
#.........#
#e.......?#
#####D#####
enemies 2
sign Those who search shall find.

5
0
#####l#####
#.........#
#.........#
#.........#
#...@.....#
#..#.##...D
#....##...#
#.#..#p...#
#..##.#...#
#.......p?#
#####D#####
sign Turn back; you are not yet ready.

4
3
#####D#####
#.#.....#.#
#.........#
#.........#
#.#.....#.#
D.........D
#.........#
#....#....#
#.........#
#.........#
#####D#####

0
3
###########
#X........#
#.........#
#.........#
#....#.#..#
#...##....#
#....#.##.#
#....#.##.#
#...#.###.#
#.........#
#####D#####

5
3
#####D#####
##.....#..#
#.........#
#.........#
#...#..#..#
D.........#
#.........#
##........#
#.........#
#.........#
###########

7
2
#####D#####
#.........#
#.........#
#.........#
#.........#
#.........d
#.........#
#.......#.#
#......#..#
#.........#
###########

2
3
#####d#####
#.........#
#......#..#
#.........#
#..###.#..#
D...##....#
#..#k#....#
#....###..#
#...#.#...#
#.........#
#####D#####
key : 6

6
0
#####D#####
#.........#
#.#.#.#.#.#
#.........#
#..#.#.#..#
#.........#
#...#.#.#.#
#.........#
#..#...#.##
#s.......e#
###########
enemies 1
switch 0 : 0

6
2
#####D#####
#......#..#
#........##
#.........#
#......#..#
#....##k..#
#....#.#..#
#....#....#
#.....##..#
#......####
#####D#####
key : 1

3
2
#####D#####
#.........#
#.........#
#.........#
#.........#
#.........d
#.........#
#.......#.#
#......#..#
#.........#
#####d#####

3
3
#####D#####
#.........#
#......#..#
#.......#.#
#.........#
d.........#
#.........#
#.......#.#
#......#..#
#.........#
#####D#####

5
1
#####D#####
#..#.....##
#.........#
#.........#
#..#..#...#
D.........D
#.........#
#..#.....##
#.........#
#....k....#
###########
key : 0

1
3
#####D#####
#.........#
#...#.....#
#..#......#
#.##......#
#..##e....#
#.###.....#
#.........#
#.........#
#.........#
#####d#####
boss
enemies 1

