0
2
###########
#.........#
#..#......#
#.#......##
#.........#
#.........#
#.........#
#.......###
#......#..#
##........#
#####l#####
locked : 1

4
4
#####D#####
##.....#..#
#.........#
#.........#
#.#..#..#.#
#.........#
#.........#
##..#.....#
#.........#
#k........#
###########
key : 3

2
2
#####D#####
#..#...#.##
#.........#
#.#.#.#...#
#.........#
D....#.#..d
#.........#
#.#...#.#.#
#.........#
##.#...#..#
###########

1
3
###########
#.........#
#.........#
#.........#
#.........#
D.........#
#.........#
#.#.......#
#..#......#
#.........#
#####D#####

1
5
###########
#.......#.#
#.......#.#
#...####..#
#....#....#
#.....#...l
#.........#
#.........#
#.........#
#.........#
#####d#####

3
5
#####d#####
#.........#
#..#......#
#.#.......#
#.........#
D.........D
#.........#
#.#.......#
#..#......#
#..k......#
###########
key : 4

1
2
#####l#####
#e........#
###.......#
#####..p..#
#..e##....#
D..#......D
#.##.#....#
#.........#
#.........#
#?........#
#####D#####
enemies 2
sign This door will not yield without a key.

3
4
###########
#..#......#
##..#.....#
#...#.....#
#..##..#..#
d....#....D
#...####..#
#p.#..##..#
#...#.....#
#.........#
#####D#####

3
3
#####D#####
#.........#
#.#.......#
#.........#
#.........#
#.....#...d
#.........#
#.........#
#.#.......#
#.........#
###########

2
5
#####d#####
#.........#
#.........#
#.........#
#.........#
#.........D
#.........#
#.........#
#.........#
#.........#
#####d#####

1
1
###########
#....k....#
#.........#
#.........#
#.........#
D.........D
#.........#
#.........#
#.........#
#.........#
#####D#####
key : 0

2
6
#####D#####
#X........#
####......#
###.......#
#.##..#...#
D...###...#
#..#......#
#.#.#.#...#
#.#.#.....#
#.........#
#####D#####

2
0
#####D#####
#.........#
##.....#.##
#.........#
#.#.#...#.#
#.........D
#..#...#..#
#.........#
#.....#...#
#k........#
###########
key : 1

1
6
###########
#......#..#
#......##.#
#..##..#..#
#..#......#
l..##e....#
#.........#
#.........#
#.........#
#.........#
#####D#####
locked : 4
boss
enemies 1

1
0
#####D#####
#.........#
#.........#
#.........#
#.........#
#....@....D
#.........#
#.........#
#.........#
#.........#
#####D#####

0
0
###########
#e.......e#
#.........#
#..#..#..##
#.........#
#.........#
#..#..#...#
#.........#
#.........#
#..#.....##
#####D#####
enemies 2

2
1
#####D#####
#.........#
#..#......#
#.#.......#
#.........#
D.........D
#.........#
#.......#.#
#......#..#
#.........#
###########

3
6
#####D#####
#......#..#
#..#..#...#
#..###.#..#
#..##..#..#
D.........#
#.........#
#.........#
#.........#
#.......ee#
###########
enemies 2

2
3
#####D#####
#.........#
#.#....#..#
#..#.###..#
#.#.#.#...#
d.........#
#.........#
#.........#
#.........#
#.........#
#####D#####

