4
0
#####D#####
#.........#
#.........#
#.........#
#.......p.#
#..##p....#
#..#......#
#..##.##..#
#...#..#..#
#......#..#
###########

1
2
###########
#..#.....##
#.........#
#.........#
#..#......#
D.........D
#.........#
#..#.....##
#.........#
#.........#
#####d#####

3
2
#####d#####
#.........#
#.#.....#.#
#.........#
#.........#
D..#..#...D
#.........#
#.........#
#.#.....#.#
#.........#
#####D#####

2
3
#####D#####
#.........#
#.........#
#.........#
#.........#
d.........l
#.........#
#.........#
#.........#
#.........#
#####D#####

3
3
#####D#####
#.........#
#.........#
#....#....#
#.........#
D.........D
#.....#...#
#.........#
#.........#
#k#.....#.#
###########
key : 1

0
3
###########
#k........#
#..#......#
#.#.......#
#.........#
#.........#
#.........#
#.#.......#
#..#......#
#.........#
#####D#####
key : 3

4
2
#####D#####
#.........#
#.##......#
#.#.......#
#......#..#
#.........#
#.........#
#.........#
#.........#
##........#
###########

2
2
#####d#####
#.#.......#
#.........#
#.........#
#..#..#...#
D.........d
#.........#
#.#..#....#
#.........#
#.........#
#####d#####

2
4
#####D#####
#.........#
#.........#
#...p.....#
#.........#
l....e....#
#.........#
#.........#
#.........#
#.........#
#####D#####
locked : 1
boss
enemies 1

3
4
#####D#####
#.........#
#.#.#.#...#
#...###...#
#..##.....#
D.........#
#.........#
#.........#
#.........#
#........X#
###########

1
0
#####D#####
#.........#
#.....#...#
#.........#
#.........#
#.........d
#.........#
#.........#
#.........#
#.........#
#####D#####

2
1
#####D#####
#.#.......#
#..#...#..#
#.#.....#.#
#.........#
l.........D
#.........#
#.#.....#.#
#..#...##.#
#..#......#
#####D#####
locked : 0

2
0
#####D#####
#.........#
#.........#
#.........#
#...@.....#
#...####..l
#...###...#
#.....#...#
#.....#.#.#
#.......#?#
#####D#####
sign A locked path — look elsewhere first.

3
1
#####D#####
#e........#
#.........#
#.........#
#.........#
D....##...D
#....##...#
#...#e....#
#.........#
#....e....#
###########
enemies 3

3
0
#####D#####
#.........#
#.........#
#.........#
#.........#
#.....##..D
#....##.#.#
#....#....#
#......#.##
#........k#
#####D#####
key : 0

1
4
###########
#........k#
#.#...#...#
#.#.#.....#
#.#..##...#
D...#.....#
#...##....#
#.........#
#.........#
#.........#
#####D#####
key : 4

1
3
#####D#####
#e.......?#
#.........#
#.........#
#....##...#
D....#....D
#....#....#
#.........#
#.........#
#e........#
#####D#####
enemies 2
sign A useful tool lies just ahead.

1
1
###########
#.........#
#.........#
#.........#
#.........#
d......#..D
#....#..#.#
#....###..#
#......####
#.......###
#####D#####

0
0
###########
#.........#
##.....#..#
#.........#
#.........#
#...#..#..#
#.........#
#.........#
#...#..#..#
#.........#
#####D#####

