4
2
#####D#####
#e##......#
#.###.#...#
#...#.....#
#...###...#
D...#e#..?#
#.........#
#......#..#
#.........#
#........##
#####D#####
enemies 2
sign Something glints behind that door…

2
1
#####l#####
#k........#
#......#..#
#.......#.#
#.........#
D.........D
#.........#
#.......#.#
#......#..#
#.........#
#####D#####
key : 0

1
1
#####D#####
##.....#..#
#.........#
#.........#
#....#....#
D.........D
#.........#
##..#.....#
#.........#
#.........#
#####l#####
locked : 0

6
2
#####d#####
#.........#
#.........#
#...#.#.#.#
#...#.##..#
#...####..#
#...e#....#
#...####..#
#..##.#...#
#..#......#
#####D#####
boss
enemies 1

1
0
###########
#es#e.....#
#.?##.....#
#...###...#
#.........#
#.........D
#.........#
#.........#
#.........#
#.........#
#####D#####
enemies 2
switch 0 : 0 1
sign A locked path — look elsewhere first.

5
1
#####d#####
#.........#
#.........#
#..#..#...#
#.........#
#.........D
#..#..#...#
#.........#
#.........#
#........##
###########

4
1
#####D#####
#k........#
#......#..#
#.......#.#
#.........#
D.........D
#.........#
#.........#
#.........#
#.........#
#####d#####
key : 2

1
2
###########
#.........#
#.........#
#.........#
#.........#
D...##....#
#..###.#..#
#...#.#...#
#..##.....#
#..#...#..#
#####d#####

0
1
###########
##.#...#.##
#.........#
##.#.#.#..#
#.........#
#..#.#.#..#
#.........#
#....#.#..#
#.........#
##.#...#.##
#####D#####

5
2
#####D#####
#k........#
#.........#
#....#....#
#...##....#
D.........D
#.........#
#.........#
#.........#
#.........#
#####d#####
key : 4

3
2
#####D#####
#.........#
#.#...#.#.#
#.........#
#...#.#.#.#
D.......k.#
#.#.#.#.#.#
#.........#
#.#.....#.#
#.........#
#####D#####
key : 3

2
0
#####D#####
#.........#
#.........#
#.....#...#
#?#.##....#
#...@###..D
#...####..#
#..#####..#
#.........#
#.........#
#####D#####
sign The brave are rewarded.

3
0
#####D#####
#.........#
#.###.....#
#..##.....#
#...#.....#
#.........d
#.........#
#.........#
#.........#
#.........#
#####D#####

7
2
#####D#####
#.........#
#.........#
#.........#
#.........#
#.........#
#.........#
#.........#
#.........#
#X........#
###########

3
1
#####D#####
#.........#
#.....#..##
#.........#
#.........#
d..#..#...D
#.........#
#.........#
#..#.....##
#.........#
#####D#####

2
2
#####d#####
#.........#
#......#..#
#.......#.#
#.........#
D.........D
#.........#
#.#.......#
#..#......#
#.........#
#####D#####

4
0
#####D#####
#.........#
##.#...#.##
#.........#
#.#.#.#.#.#
#.........D
#..#.#.#..#
#.........#
#...#.#...#
#.........#
###########

5
3
###########
#........e#
#.........#
#.........#
#.........#
D.........#
#.........#
#.........#
#.........#
#.........#
###########
enemies 1
door 0 : 0 1

2
3
###########
#..p......#
#.........#
#.........#
#.........#
D.........#
#.........#
#.........#
#...p.....#
#.........#
###########

