4
0
#####D#####
#.........#
#.........#
#.........#
#.........#
#.........D
#.........#
#.........#
#.........#
#.........#
#####D#####

1
2
###########
#..k......#
#..#...#..#
#.#.....#.#
#.........#
D.....#...d
#.........#
#.........#
#.........#
#.........#
#####D#####
key : 2

3
3
#####D#####
#.........#
#..#......#
#.#.......#
#.........#
l.........#
#.........#
#.........#
#.........#
#.........#
###########
locked : 1

1
0
#####D#####
#.........#
#.........#
#.........#
#.........#
#.........l
#.........#
#.........#
#.........#
#.........#
#####d#####

2
3
#####D#####
#.........#
#.........#
#.........#
#.........#
D........X#
#.........#
#.........#
#.........#
#.........#
#####D#####

2
2
#####D#####
#.........#
#..#......#
#.#.......#
#.........#
D.........D
#.........#
#.......#.#
#......#..#
#.........#
#####d#####

3
0
#####D#####
#.........#
#.........#
#.........#
#.........#
#.........D
#.........#
#.........#
#.........#
#.........#
#####D#####

3
2
#####d#####
#k........#
#..#......#
#.#.......#
#.........#
D.........l
#.#.......#
#.......#.#
#......#..#
#.........#
#####D#####
key : 1

2
0
#####d#####
###.......#
#.#.#.....#
#..##.....#
#.#.......#
#..##@....D
#..#......#
#.##......#
#......p..#
#.........#
#####D#####

4
1
#####d#####
#.........#
#..#....#.#
#.........#
#.........#
D...#.....l
#.........#
#.........#
#.........#
#.........#
#####D#####

1
3
###########
#.........#
#.........#
#.........#
#.........#
d....e....#
#.........#
#.........#
#.........#
#.........#
#####D#####
boss
enemies 1

6
1
#####D#####
#.........#
#.........#
#.........#
#.........#
#.........#
#.........#
#.........#
#.........#
#k........#
###########
key : 3

2
1
#####D#####
#.........#
#.........#
#.........#
#.........#
D....##...D
#....#.#..#
#....#....#
#.........#
#.........#
#####D#####

0
0
###########
#.........#
#.........#
#.....#..##
#.........#
#.........#
#...#..#..#
#.........#
#.........#
#..#.....##
#####D#####

5
1
#####D#####
#.........#
#.#.#.#.#.#
#.......e.#
#...#...#e#
D.........#
#...#.#...#
#.........#
#.#.....#.#
#.........#
#####D#####
enemies 2

4
2
#####D#####
##.....#.##
#.........#
##.#.#.#.##
#.........#
l..#......#
#.........#
#....#...##
#.........#
##.....#.##
###########
locked : 2

3
1
#####D#####
#.........#
#..#...#k##
#.#.....#.#
#.........#
D...#.....D
#.........#
#.........#
#.........#
#.........#
#####d#####
key : 0

5
0
#####D#####
#.........#
#.........#
#.........#
#.#.##....#
#.....#...D
#...#.....#
#.#.......#
#####.....#
#.........#
###########

1
1
###########
#.........#
#..#..#..##
#.........#
#.........#
l.........D
#.........#
#.........#
#..#.....##
#.........#
#####D#####
locked : 0

