0
2
###########
#........X#
###.#.....#
###.......#
#.####....#
D..##.....#
#..#......#
#.........#
#.........#
#.........#
#####D#####

5
1
#####D#####
#e........#
#.#.#.#...#
#.........#
#...#.#...#
D.........D
#.#.#.#.#.#
#.........#
#.#...#.#.#
#e........#
#####l#####
enemies 2

4
0
#####D#####
#.........#
#.........#
#.........#
#.........#
#....@....D
#....##...#
#....##...#
#...#.....#
#..p......#
#####D#####

3
1
#####l#####
#.p.......#
#.........#
#.........#
#.........#
D..#......D
#.........#
#p#.......#
#.........#
#.........#
#####D#####
locked : 4

5
2
#####D#####
#.........#
#.........#
##..#.....#
#..##.....#
D..###....#
#..###....#
#...##....#
#.........#
#........k#
###########
key : 3

2
0
#####l#####
#.........#
#.........#
#.........#
#.........#
#....#....D
#.....##..#
#.....#...#
#.........#
#.........#
#####D#####

4
1
#####D#####
##.#.....##
#.........#
##.#.#.#.##
#.........#
D..#...#..D
#.........#
##...#.#.##
#.........#
#..#...#.##
#####D#####

3
2
#####D#####
#.........#
#..#......#
#.#.......#
#.........#
D.........#
#.........#
#.......#.#
#......#..#
#.........#
#####d#####

3
0
#####D#####
#k#.....#.#
#.........#
#.#.#.#...#
#.........#
#...#.#...D
#.........#
#...#.#.#.#
#.........#
#.#.....#.#
#####D#####
key : 0

4
2
#####d#####
#.........#
#.#.#.#.#.#
#.........#
#..#.#.#..#
D.........d
#...#.#.#.#
#.........#
#..#...#.##
#........k#
#####D#####
key : 1

6
1
#####l#####
#.........#
#.........#
#.........#
#.........#
#.........#
#.........#
#.........#
#.........#
#.........#
###########
locked : 1

2
2
#####D#####
#.........#
#.....#...#
#.........#
#.#.......#
d...#.#...#
#.#.......#
#...###..##
#.#...#...#
#.........#
#####D#####

5
0
#####D#####
#.........#
#.........#
#.........#
#.........#
#.........D
#.........#
#.........#
#.........#
#.........#
###########

0
1
###########
#.........#
#..#......#
#.#.......#
#.........#
#.........D
#.........#
#.#.......#
#..#......#
#.........#
#####D#####

4
3
###########
#........##
#.........#
#.........#
#...#..#..#
d.........#
#.........#
#..#..#..##
#.........#
#.........#
###########

2
1
#####D#####
#.........#
#.........#
#.#.##....#
#.#..k#...#
D..###....d
#....#....#
#.....#...#
#.........#
#.........#
#####l#####
key : 4

1
1
#####D#####
#.........#
##........#
#.........#
#.........#
D.........d
#.........#
#.........#
##..#..#..#
#.........#
#####D#####

1
0
###########
#.........#
###.......#
#.##......#
#..#####..#
#..#####..D
#..#.###..#
#.........#
#.........#
#.........#
#####l#####
locked : 3

1
2
#####D#####
#.........#
#.........#
#.........#
#.........#
d....e....#
#.........#
#.........#
#.........#
#.........#
#####D#####
boss
enemies 1

