3
0
#####D#####
##.....#..#
#.........#
#.........#
#.#..#..#.#
#.........D
#.........#
#...#..#..#
#.........#
#.........#
#####D#####

2
1
#####D#####
#.........#
#.....#..##
#.........#
#.........#
D...#..#..D
#.........#
#.........#
#..#..#..##
#.........#
#####D#####

4
2
###########
#.........#
#..#..#...#
#.........#
#.........#
d...#..#..D
#.........#
#.........#
#..#..#...#
#.........#
###########

3
4
#####D#####
#.........#
#.........#
#.........#
#.........#
#.........#
#.....##..#
##........#
#.....###.#
#e.....#e.#
###########
enemies 2
door 0 : 0 1

1
1
#####l#####
#.........#
#.........#
#..#..#..##
#.........#
d.........D
#.....#...#
#.........#
#.........#
#........##
#####D#####

1
0
###########
#.........#
#......#..#
#.......#.#
#.........#
#.........d
#.........#
#.......#.#
#......#..#
#.........#
#####d#####

4
0
#####D#####
#..#.....##
#.........#
#.........#
#.........#
#.........D
#.........#
#.....#..##
#.........#
#.........#
#####D#####

5
0
#####D#####
#.........#
#.........#
#.........#
#....###..#
#.........#
#....##...#
#....#..###
#.....##..#
#k........#
###########
key : 1

0
1
###########
#.#.....#.#
#.........#
#.#.#.#.#.#
#.........#
#...#.#...D
#.........#
#.#...#.#.#
#.........#
#.#.......#
#####l#####
locked : 0

2
2
#####D#####
#.........#
#......#..#
#.......#.#
#.........#
D.........D
#.........#
#.#.......#
#..#......#
#.........#
###########

1
2
#####D#####
#k........#
##........#
#.........#
#.........#
D......#..#
#.........#
#.........#
##..#.....#
#.........#
#####D#####
key : 2

1
4
###########
#X........#
#.........#
#.........#
#.........#
#.........#
#.........#
#.........#
#.........#
#.........#
#####D#####

2
0
#####d#####
#.........#
#.........#
#.........#
#.........#
#....@....D
#.........#
#.........#
#.........#
#.........#
#####D#####

2
3
###########
#...k.....#
#...#.#.#.#
#.........#
#..#.#....#
D.........l
#.#.#.#.#.#
#.........#
#..#...#.##
#.........#
###########
key : 3

2
4
#####D#####
#..#...#..#
#...#..#..#
#...##....#
#..###.#..#
l....e....#
#.........#
#.........#
#.........#
#.........#
#####D#####
locked : 3
boss
enemies 1

4
1
#####d#####
#k........#
##..#..#..#
#.........#
#.........#
D.........d
#.........#
#.........#
##..#..#..#
#.........#
###########
key : 0

3
1
#####D#####
#......#..#
#..#......#
#...#.#...#
#...#.##..#
D.........#
#..#......#
#.........#
#.##......#
#.........#
#####d#####

4
3
###########
#........e#
#.........#
#...#.....#
#.#.#.....#
D...#.....#
#.....#.#.#
#.....#.#?#
#.....#...#
#........e#
###########
enemies 2
sign Beware what lurks ahead.

0
2
###########
#......e.e#
#...p.?#..#
#....###..#
#....#s#..#
D.........#
#.........#
#p........#
#.........#
#.........#
#####D#####
enemies 2
switch 0 : 0 1
sign Only the prepared may pass.

