4
3
#####d#####
#e#.....#.#
#.........#
#....#.#..#
#.........#
D...#.#...d
#.........#
#....#.#.##
#.........#
#e#.....#.#
#####D#####
enemies 2
door 0 : 0

5
3
#####D#####
#.........#
#..#......#
#.#.......#
#.........#
D.........#
#.........#
#.........#
#.........#
#.........#
###########

2
1
#####D#####
#.........#
#..#..#...#
#.........#
#.........#
D.........d
#.........#
#.........#
#..#..#..##
#........k#
#####D#####
key : 0

3
1
#####D#####
#.........#
##..#.....#
#.........#
#.........#
D.........D
#.........#
#.........#
##..#.....#
#.........#
###########

1
2
#####l#####
#e........#
##..#..#..#
#.........#
#.........#
D....#...e#
#.........#
#.........#
##..#.....#
#e........#
#####D#####
enemies 3

3
3
#####D#####
#.........#
#..#......#
#.#.......#
#.........#
D.........l
#.........#
#.........#
#.........#
#.........#
#####d#####

0
2
###########
#.........#
#.........#
#.........#
#.........#
#.........#
#.........#
#.#.....#.#
#..#...#..#
#.........#
#####l#####
locked : 0

2
4
###########
#........X#
#.........#
#p........#
#.........#
D...#.....#
#.#.......#
#.........#
###.......#
#........p#
#####D#####

3
4
#####D#####
#.........#
#.........#
#.........#
#.........#
l....e....#
#...p.....#
#.........#
#.........#
#.........#
#####D#####
locked : 2
boss
enemies 1

4
2
#####D#####
#.........#
#.........#
#..#..#...#
#.........#
#k........D
#..#..#...#
#.........#
#.........#
#..#.....##
#####D#####
key : 1

3
2
#####D#####
#.........#
#.#.#.#.#.#
#.........#
#.#.#.#.#.#
D.........D
#.....#...#
#.........#
#.#.#...#.#
#.........#
#####D#####

2
2
#####D#####
#.........#
#.........#
#.........#
#.........#
d.........d
#.........#
#.........#
#.........#
#.........#
#####D#####

4
4
#####D#####
#.........#
#......#..#
#.......#.#
#.........#
d.........#
#.........#
#.......#.#
#......#..#
#.........#
###########

1
1
###########
#ee.......#
#e........#
#s........#
#.........#
#.........D
#.........#
#.........#
#.........#
#.........#
#####D#####
enemies 3
switch 0 : 0

3
0
#####D#####
#.........#
#.........#
#.........#
#.........#
#.........D
#....##...#
#...#.#...#
#.....#...#
#.........#
###########

2
3
###########
#.........#
#.........#
#.........#
#.........#
d.........D
#.........#
#.........#
#.........#
#.........#
#####D#####

2
0
###########
#.........#
#.........#
#..###....#
#..#@.....#
#....#....D
#.#.##....#
####.#....#
#.........#
#.........#
#####D#####

5
2
#####D#####
#.........#
#..#...#..#
#k#.....#.#
#.........#
#.........D
#.........#
#.......#.#
#......#..#
#.........#
#####D#####
key : 2

6
2
#####D#####
#.........#
#.........#
#.........#
#.........#
#.........#
#.........#
#.........#
#.........#
#k........#
###########
key : 4

