5
0
#####D#####
#.........#
#.........#
#.........#
#.........#
#....##...D
#...#.#...#
#.........#
#.........#
#e........#
###########
enemies 1

3
1
#####d#####
#.........#
#.....#...#
#.#.......#
#.........#
D.........D
#.........#
#.#.......#
#..#......#
#.........#
#####l#####
locked : 0

5
4
###########
#.........#
#.........#
#.........#
#.........#
d....e....D
#.........#
#.........#
#.........#
#.........#
#####D#####
boss
enemies 1

1
1
#####D#####
#.........#
#.#.#.#.#.#
#.........#
#..#.#.#..#
#.........D
#...#.#...#
#.........#
#........##
#.........#
#####d#####

3
0
###########
#k......#.#
#......#..#
#.......#.#
#.........#
#......#..D
#.........#
#.........#
#.........#
#.........#
#####D#####
key : 0

6
4
#####D#####
#.........#
#.........#
#.........#
#.........#
#.........#
#.........#
#.........#
#.........#
#X........#
###########

0
1
###########
#k.....#..#
#####.##..#
#.###.....#
#..###....#
#.........#
#...p.....#
#.........#
#.........#
#.........#
#####D#####
key : 5

5
1
#####D#####
#.........#
#.........#
#.........#
#.........#
D.....p...D
#.........#
#.........#
#.........#
#....k....#
###########
key : 2

4
3
###########
#..#...#..#
#..##.##..#
##.#..#...#
#...#..#..#
l..#......#
#.##......#
##..#.....#
#.........#
#.........#
#####D#####
locked : 1

4
0
#####D#####
#.......#.#
#...#.#...#
####.#..#.#
#.#.....#.#
#....@....D
#.........#
#.........#
#.........#
#.........#
#####D#####

4
1
#####l#####
#k.#.....##
#.........#
#.#...#.#.#
#.........#
D..#......D
#.........#
#...#...#.#
#.........#
#..#...#..#
#####D#####
key : 1

2
2
#####d#####
#........##
#..#...#..#
#.#.....#.#
#....#....#
D.........#
#.........#
#.........#
#.........#
#.........#
#####D#####

3
2
#####D#####
#.#.......#
#.........#
#.........#
#.........#
D....#....#
#.........#
#......#..#
#.........#
#.........#
#####D#####

5
3
#####D#####
#e........#
#.........#
#.........#
#.........#
D.........d
#.........#
#.........#
#.........#
#e..?e....#
###########
enemies 3
sign Only the prepared may pass.

2
1
#####d#####
##.#...#.##
#.........#
#.#.#.#.#.#
#.........#
#....#.#..D
#.........#
#.#.#.#.#.#
#.........#
##.#.....##
#####d#####

5
2
#####D#####
#.........#
#.........#
#.........#
#.........#
D.........D
#.........#
#.........#
#.........#
#.........#
###########

4
2
#####D#####
#.........#
##..#..#..#
#.........#
#.........#
D.........l
#.........#
#.........#
##.....#..#
#.........#
#####D#####

1
2
###########
#.........#
#.........#
#.........#
#.....###.#
D....#.#..#
#...#..#..#
#.......#.#
#.....#.###
#.........#
#####d#####

5
5
###########
####.....e#
#.#.......#
#..#......#
#...#.....#
D.........#
#.........#
#.........#
#.........#
#.........#
###########
enemies 1

