4
0
###########
#k.#.....##
#.........#
#.........#
#.........#
#.........D
#.........#
#..#......#
#.........#
#.........#
#####D#####
key : 0

8
2
#####D#####
#.........#
##..#..#..#
#.........#
#.........#
#...#.....#
#.........#
#.........#
#......#..#
#k........#
###########
key : 3

4
2
#####D#####
#..#.....##
#.........#
#.........#
#......#..#
D.........#
#.........#
#..#..#...#
#.........#
#.........#
#####l#####
locked : 1

5
2
#####l#####
#.........#
#..#......#
#.#...#...#
#.........#
l....#....D
#.........#
#.#.....#.#
#..#...#..#
#.........#
#####D#####
locked : 0

5
0
#####D#####
#.........#
#.........#
#.........#
#...@#....#
#..####...D
#..#.#....#
#....#....#
#..#..#...#
#.........#
###########

2
2
#####D#####
#.........#
#.........#
#.........#
#....#.#..#
#.....##..D
#....####.#
#....##...#
#.....#...#
#.........#
#####l#####
locked : 2

3
3
#####d#####
#.......#.#
#.........#
#.........#
#.#..#....#
D.........#
#.........#
#.#..#....#
#.........#
#.........#
###########

7
3
###########
#.........#
#.........#
#.........#
#.........#
D.........#
#.........#
#.........#
#.........#
#.........#
###########

3
2
#####l#####
#.........#
#..#...#.##
#.........#
#....#....#
#.........D
#..#.#.#..#
#.........#
##.#.....##
#k........#
#####D#####
key : 2

1
3
#####D#####
#.........#
#.##......#
#..#.#....#
#...e.###.#
D..#.###..D
#.##...##.#
#.........#
#.........#
#.........#
#####d#####
boss
enemies 1

5
1
#####D#####
#.........#
#.........#
#.........#
#...p.....#
D......p..l
#.........#
#.........#
#.........#
#....k....#
###########
key : 1

4
1
###########
#.........#
#.........#
#.....#.#.#
#.....#.#.#
D..#..##..D
#.#.......#
###.......#
#####.....#
#.........#
#####D#####

1
2
###########
#......#..#
#...#.###.#
#......##.#
#...#####.#
#..#.##...D
#..#.#....#
#......#..#
#...#.....#
#.........#
#####D#####

7
2
#####d#####
#.........#
#.........#
#.........#
#.........#
#.........D
#.........#
#.........#
#.........#
#.........#
#####D#####

0
3
###########
#e.......e#
#.........#
#.........#
#.........#
#.........#
#.........#
#.........#
#.........#
#.........#
#####D#####
enemies 2

2
3
#####d#####
#.........#
#.........#
#.........#
#.........#
D.........#
#.........#
#.........#
#.........#
#.........#
#####d#####

1
4
###########
#........X#
#...#..##.#
#...###.#.#
#...##....#
D.........#
#.........#
#.........#
#.........#
#.........#
###########

6
2
#####D#####
#.........#
#...#.##..#
#..#.#.#..#
#......#..#
#..#.#....#
#...###...#
#......#..#
#.........#
#.........#
#####d#####

5
3
###########
#.........#
#..##.....#
#.####....#
#..##.#...#
D...#.....#
#.####....#
#.........#
#.........#
#.........#
###########

