2
3
#####l#####
#.........#
#.........#
#.........#
#.........#
D.........d
#.........#
#.........#
#.........#
#.........#
#####l#####
locked : 2

4
0
#####l#####
#.........#
#......#..#
#.......#.#
#.........#
#.........#
#.........#
#.........#
#.........#
#.........#
###########
locked : 0

3
3
#####l#####
#.........#
#.........#
#.........#
#.........#
D.........D
#.........#
#.........#
#.........#
#.........#
###########

2
0
#####D#####
#.........#
#.........#
#.........#
#.........#
#?...@....D
#.........#
#.........#
#.........#
#.........#
#####D#####
sign The dungeon remembers all who enter.

5
2
#####D#####
#.........#
#...#.#...#
#.....#...#
#.........#
#...#.....#
#.#.......#
#..#......#
#e?#......#
###e.....e#
###########
enemies 3
sign What you seek is close.

2
4
#####D#####
##.#......#
#..##.....#
#..##.....#
#.#.#.....#
d...#.....#
#.........#
#.........#
#.........#
#.........#
#####D#####

0
3
###########
#.........#
#..##.....#
#.........#
#.#.####..#
#....#.#..D
#.........#
#.....##..#
#.......###
#.........#
#####d#####

3
4
#####D#####
#.........#
#.........#
#.........#
#.........#
D.........#
#.........#
#.........#
#.........#
#........k#
###########
key : 3

1
1
###########
#........k#
#.#.....#.#
#.........#
#.........#
D....#....#
#.........#
#.........#
#.#.....#.#
#.........#
#####D#####
key : 0

1
4
#####D#####
#.........#
#.........#
#.........#
#.........#
d....e....#
#.........#
#........##
#.........#
#.........#
#####D#####
boss
enemies 1

3
2
#####D#####
#k........#
#.........#
#.........#
#.........#
D.........D
#.........#
#.........#
#.........#
#.........#
#####D#####
key : 1

2
1
#####D#####
#e.......e#
#.........#
#.........#
#.........#
D.........D
#.#.......#
#.##......#
#.#.......#
#e.......?#
#####d#####
enemies 3
sign The brave are rewarded.

1
3
#####d#####
#..#.....##
#.........#
#.........#
#..#..#...#
#.........d
#.........#
#..#..#..##
#.........#
#.........#
#####l#####
locked : 3

1
0
###########
#..#......#
#.........#
#.........#
#.........#
#.........D
#.........#
#.........#
#.........#
#.........#
#####D#####

2
2
###########
#..#......#
#.........#
#.........#
#..#......#
D.........D
#.........#
#..#..#...#
#.........#
#.........#
#####D#####

3
1
#####d#####
#.........#
#.........#
#.........#
#.........#
D.........D
#.........#
#.........#
#...p.....#
#........p#
###########

4
2
#####D#####
#.........#
#.#.....#.#
#.........#
#k#.#.#.#.#
#.........#
#.#.#.#...#
#.........#
#.#.#.#...#
#.........#
#####D#####
key : 2

0
4
###########
#........X#
#.........#
#.........#
#.........#
D.........#
#.........#
#.........#
#.........#
#.........#
#####D#####

3
0
#####D#####
#.........#
#..#......#
#.#.......#
#.........#
#.........D
#..#......#
#.#.......#
#..#......#
##.....#..#
#####l#####

