1
3
###########
##.#...#..#
#.........#
##.#.#.#.##
#.........#
#....#....d
#.........#
##.#...#..#
#.........#
#..#...#.##
#####l#####
locked : 3

3
0
#####.#####
#.........#
#..#......#
#.#.......#
#.....#...#
#..........
#.........#
#.#k#...#.#
#..#...#..#
#.......#.#
#####.#####
key : 0

2
3
#####l#####
#.........#
#.........#
#.........#
#.........#
...........
#.........#
#.#.......#
#..#......#
#.........#
#####.#####

3
5
###########
#..#....?##
#.........#
#.#.#.#...#
#.........#
...#.#.#..#
#.........#
#...#.#.#.#
#.........#
##.#...#.e#
###########
enemies 1
door 0 : 0 1
sign What you seek is close.

2
4
#####.#####
#.........#
#.........#
#.........#
#.........#
.........k#
#.........#
#.#.......#
#..#......#
#.........#
#####.#####
key : 3

4
0
#####.#####
#.........#
#.........#
#.....#.#.#
#.........#
#......#...
#......#..#
#.........#
#e........#
#es.......#
###########
enemies 2
switch 0 : 0 1

0
4
###########
#X........#
#.........#
#.........#
#.........#
#.........#
#.........#
#.........#
#.........#
#.........#
#####.#####

2
1
###########
#.........#
#.........#
#.........#
#...#.....#
...........
#.........#
#....#..#.#
#......#..#
##........#
#####d#####

3
3
#####.#####
#.........#
#......#..#
#.......#.#
#.........#
...........
#.........#
#.#.......#
#..#......#
#.........#
#####.#####

1
4
#####.#####
#.......###
##......#.#
#......##.#
#...#.##..#
d....e#...#
#.........#
#.........#
#.........#
#.........#
#####.#####
boss
enemies 1

4
2
#####.#####
#.........#
#.#.#.#.#.#
#.........#
#..#......#
...........
#.#.#.#.#.#
#.........#
#..#...#.##
#.........#
###########

4
4
#####d#####
##.....#..#
#.........#
#.........#
#...#..#..#
..........#
#.........#
##..#.....#
#.........#
#.........#
###########

3
4
#####.#####
#.......#.#
#.........#
#....###.##
#....#k##.#
.....#.....
#.......#.#
#....#...##
#..#......#
#.........#
#####d#####
key : 2

2
2
###########
#e#e.e....#
#.........#
#.........#
#.........#
...........
#.........#
#.........#
#.........#
#.........#
#####.#####
enemies 3

3
1
#####d#####
#.........#
#.#.#.....#
#.........#
#.........#
...........
#.........#
#.#.....#.#
#..#...#..#
#.........#
#####.#####

3
2
#####.#####
#.........#
#......#.##
#.......#.#
#.........#
...........
#.#.......#
#.......#.#
#......#..#
##........#
#####.#####

4
3
#####.#####
#.........#
#.........#
#.........#
#.........#
...........
#.........#
#.#.......#
#..#......#
#.........#
###########

4
1
#####.#####
#.........#
#.........#
#.........#
#.........#
.....#.....
#......##.#
#....#.k#.#
#......####
#.........#
###########
key : 1

2
0
###########
#?........#
#.........#
#..#......#
#.........#
#...#@.....
#.###.....#
#.#.......#
#####.....#
#.........#
#####.#####
sign Those who search shall find.

