1
3
#####.#####
#.#.....#.#
#.........#
#.........#
#.#..#..#.#
#..........
#.........#
#.#..#..#.#
#.........#
#.........#
#####d#####

6
0
#####.#####
#.........#
#..#......#
#.#.......#
#....#....#
#.........#
#.........#
#.........#
#.........#
#......#..#
###########

5
1
#####.#####
#.........#
#.........#
#.........#
#.........#
...........
#.........#
#.........#
#.........#
#....k....#
###########
key : 1

3
0
###########
#.........#
#......#..#
#.......#.#
#.........#
#.........#
#.........#
#.........#
#.........#
#.........#
#####.#####

5
0
#####l#####
#.........#
#.........#
#.........#
#.........#
#..........
#.........#
#.........#
#.........#
#.........#
#####.#####
locked : 0

4
1
###########
#..k......#
#..#......#
#.#.......#
#.........#
...........
#.........#
#.........#
#.........#
#.........#
#####.#####
key : 0

3
2
###########
#.........#
##.#.....##
#.........#
#...#.#.#.#
#..........
#....#....#
#.........#
#...#.....#
#.........#
#####.#####

2
3
#####d#####
#.........#
#.........#
#.....#...#
#....####.#
#....###..l
#....k###.#
#...##.##.#
#.........#
#.........#
#####.#####
key : 4

2
4
#####.#####
#.........#
#.........#
#.........#
#.........#
l.........l
#....#....#
#.........#
#.........#
#.........#
#####.#####
locked : 3

4
3
#####d#####
#.........#
#.........#
#...#.....#
#.........#
d..#......#
#.........#
#.......#.#
#......#..#
#.#.......#
###########

5
2
#####.#####
#.........#
#...#.....#
#...###...#
#....##...#
...##.....#
#.#.......#
#...#.....#
##.##.....#
#........k#
###########
key : 3

2
5
###########
#.........#
#.........#
#...####..#
#...##.#..#
l...#e.#..#
#.........#
#.........#
#.........#
#.........#
#####.#####
locked : 4
boss
enemies 1

4
2
#####.#####
#.#.......#
#.........#
#.#...#.#.#
#.........#
....#.#...d
#.........#
#.#...#...#
#.........#
#.........#
#####.#####

0
3
###########
#e.......e#
##..#.#...#
#e...#.#..#
#..#.#.##.#
#.........#
#...#..##.#
#.........#
#.........#
#.........#
#####.#####
enemies 3
door 0 : 0 1

1
4
###########
#......e#e#
#.......s.#
#.#.....#?#
#.........#
....#.....#
#.........#
#.#.#...#.#
#.........#
#.......#.#
#####.#####
enemies 2
switch 0 : 0 1
sign A locked path — look elsewhere first.

3
3
#####.#####
#.........#
#.........#
#..#..#..##
#.........#
..........d
#.....#...#
#.........#
#.........#
#..#.....##
#####d#####

3
4
#####.#####
#.........#
#.........#
#.........#
#.........#
d..........
#.........#
#.#.......#
#..#......#
#.........#
###########

3
5
#####.#####
#..#...#..#
##..#.#...#
#..##.#...#
#...##.#..#
..........#
#.........#
#.........#
#.........#
#........X#
###########

4
0
#####.#####
#.........#
#.........#
#.........#
#...@.....#
#....#.....
#......##.#
#....##.#.#
#.....#.###
#........##
#####l#####

