3
0
#####D#####
#.........#
#.##......#
#.?#......#
#.#.......#
#...#@#...D
#....#....#
#.###.....#
#.###.#..##
#..#......#
#####D#####
sign Those who search shall find.

2
0
###########
#k........#
#.........#
#.........#
#.........#
#.........D
#.........#
#.........#
#.........#
#.........#
#####D#####
key : 0

2
2
###########
#.........#
#.........#
#.........#
#.........#
D.........l
#.........#
#.##....#.#
#.##...#..#
#.........#
#####l#####
locked : 0

4
0
#####D#####
#.........#
#.#.#.#.#.#
#.........#
#..#.#.#..#
#.........#
#.#.#.#.#.#
#.........#
#..#......#
#.........#
###########

2
3
#####D#####
#.........#
#.........#
#..#......#
#.##e#....#
l..#.#....D
#...##....#
#....#....#
#.........#
#.........#
#####D#####
locked : 1
boss
enemies 1

3
1
#####D#####
#.........#
#.........#
#.........#
#.........#
D.........d
#......p..#
#.........#
#.......p.#
#.........#
###########

2
4
###########
#....?...s#
#........##
#.........#
#.........#
D.........D
#.........#
#.#.....#.#
#......#..#
#.........#
#####D#####
switch 1 : 2 3
sign A locked path — look elsewhere first.

1
1
###########
#.........#
#.........#
#.........#
#..##.##..#
#..##.....#
#..#..##..#
#..##.##..#
#..##.....#
#.........#
#####d#####

4
3
#####D#####
#.......#.#
#.........#
#.........#
#..#..#...#
D.........#
#.........#
#.#..#..#e#
#........?#
#.......ee#
###########
enemies 3
door 0 : 0 1
sign A useful tool lies just ahead.

6
2
#####D#####
##.......##
#.........#
#.#.#.#.#.#
#.........#
#..#.#.#..#
#.........#
#.#.#...#.#
#.........#
##k#...#.##
###########
key : 4

3
4
#####D#####
#......#..#
#..#..##..#
#...#.##..#
#...####..#
D...####..#
#.........#
#.........#
#.........#
#........e#
###########
enemies 1
door 1 : 2 3

4
2
#####D#####
#.........#
#..#......#
#k#.......#
#.........#
#.........D
#.........#
#.......#.#
#...#..#..#
#.........#
#####D#####
key : 1

0
3
###########
#X........#
#.........#
#.....#...#
#....###..#
#...####..#
#...##..#.#
#...##.#..#
#...#.....#
#.........#
#####D#####

3
2
#####l#####
#.........#
#.........#
#.........#
#.........#
d.........D
#.#..#....#
#.........#
#.........#
##.....#..#
#####D#####

1
3
#####D#####
##.....#..#
#.........#
#.........#
#k#..#....#
#.........#
#.........#
#...#.....#
#.........#
#.........#
#####D#####
key : 3

2
5
###########
#.........#
#.##......#
####......#
#.##......#
D.........#
#.........#
#.........#
#.........#
#.........#
###########

3
3
#####D#####
#e.......?#
#.........#
#.........#
#.........#
D.........D
#.........#
#.........#
#.........#
#e........#
#####D#####
enemies 2
sign A locked path — look elsewhere first.

2
1
#####d#####
#.........#
#.........#
##..#..#..#
#.........#
D.........D
#.#.......#
#.........#
#.........#
##.....#..#
#####D#####

5
2
#####D#####
#.........#
#.........#
#...#..#..#
#..####...#
#s.####...#
#..e###...#
#..#e###..#
#.........#
#.........#
#####D#####
enemies 2
switch 0 : 0 1

