3
2
#####D#####
#..#...#..#
#..#......#
#....###..#
#....##.#.#
D.....#...D
#...#####.#
#....#k##.#
#.........#
#.........#
###########
key : 2

4
0
#####D#####
#.........#
###.......#
###.#.....#
#.##......#
#..##.....D
#.#.......#
#.......p.#
#.........#
#k........#
###########
key : 0

1
4
#####D#####
#.........#
#.........#
#.........#
#.........#
d....e....#
#.........#
#.........#
#.........#
#.........#
#####D#####
boss
enemies 1

3
3
#####l#####
#..#...#.##
#.........#
#.#.#...#.#
#.........#
D..#.#.#..D
#.........#
#.#...#.#.#
#.........#
##.#...#..#
###########
locked : 2

5
1
#####l#####
#.........#
#.........#
#.........#
#..#..#...#
#.........#
#.........#
#........##
#.........#
#.........#
###########
locked : 0

2
3
#####D#####
#.........#
#..##.....#
####......#
#..##.....#
D...#.....D
#.#.......#
#.........#
#.........#
#.........#
#####l#####

2
2
#####D#####
##.....#..#
#.........#
#.........#
#...#..#..#
D.........D
#.........#
##..#..#..#
#.........#
#.........#
#####D#####

2
5
###########
#......####
#.....##.##
#.....#...#
#.....###.#
l.........#
#.........#
#.........#
#.........#
#.........#
###########
locked : 3

3
4
#####d#####
#.........#
#.........#
#.#.....#.#
#.........#
D.........#
#.#..#....#
#.........#
#.........#
#.#.....#.#
###########

0
4
###########
#X........#
#..#......#
#.........#
#.........#
#.........#
#...#.#...#
#...#.#...#
#.........#
#.........#
#####D#####

4
1
#####D#####
#k........#
##..#..#..#
#.........#
#.........#
D....#....#
#.........#
#.........#
##..#..#..#
#.........#
#####l#####
key : 1

1
1
#####d#####
#........p#
#.........#
#.........#
#.........#
#.........D
#.........#
#..##.....#
#.#.......#
#.........#
#####l#####
locked : 1

0
1
###########
#.........#
#..#......#
#.#.......#
#.........#
#.........#
#.........#
#.........#
#.........#
#.........#
#####d#####

3
0
###########
##........#
#.........#
#....#....#
#.........#
#....@....D
#.........#
#.........#
#.........#
#.........#
#####D#####

3
1
#####D#####
#.........#
#.........#
#.........#
#...#.....#
D..##.....D
#.#.#.....#
#.........#
#.........#
#.........#
#####D#####

2
4
#####D#####
#e........#
#..#..#...#
#.........#
#.........#
D......#..l
#.........#
#.........#
#........##
#........e#
#####d#####
enemies 2

1
2
###########
#.........#
#.........#
#..#..#...#
#.........#
D.........D
#..#......#
#.........#
#.........#
#..#......#
#####D#####

2
1
#####l#####
#.........#
#...#.##..#
#...##.#..#
#......##.#
#.....#...D
#...#.....#
#.........#
#.........#
#.........#
#####D#####

1
3
###########
#k#.....#.#
#.........#
#.#.#.....#
#.........#
D...#.....d
#.........#
#.#...#...#
#.........#
#.#.....#.#
#####D#####
key : 3

