2
0
#####.#####
#..#......#
##.##.....#
#..#####..#
#..#..##..#
#..##@.....
#.###.....#
#.........#
#.........#
#.........#
###########

3
2
#####.#####
#.........#
#.........#
#.........#
#.........#
..........l
#.........#
#.........#
#......#..#
#.........#
#####d#####

2
3
#####.#####
#.........#
#......#..#
#.......#.#
#.........#
...........
#.........#
#.........#
#.........#
#.........#
#####.#####

4
2
#####d#####
#.#.....#.#
#.........#
#..#.#...##
#.........#
....#.#...#
#.........#
#..#.#...##
#.........#
#.......#.#
###########

0
3
###########
#.........#
#.........#
#.........#
#.........#
....#......
#.........#
###.......#
##.##.....#
##........#
#####l#####
locked : 5

0
4
###########
#........X#
#.........#
#.....#...#
#.........#
..........#
#.........#
#.........#
#........##
#.........#
#####.#####

1
2
#####d#####
#k#.......#
#.........#
#...#.#.#.#
#.........#
....#.#...l
#.........#
#...#...#.#
#.........#
#.#.....#.#
#####.#####
key : 2

0
2
###########
#.........#
#..#......#
#.#.......#
#.........#
...........
#.........#
#.#.......#
#..#......#
#.........#
#####d#####

2
1
#####l#####
#........##
#.........#
#...#.#.#.#
#.........#
...#.#.#...
#.........#
#.#.......#
#.........#
#..#...#..#
#####.#####

3
1
#####.#####
#..#...#.##
#.........#
#..#.#.#.##
#.........#
#..#.#.#...
#.........#
##.#.#.#..#
#.........#
##.#...#.##
#####d#####

3
3
#####.#####
#.........#
#......#..#
#.......#.#
#.........#
l.........#
#.........#
#.........#
#.........#
#.........#
###########
locked : 1

1
0
###########
#k........#
#.........#
#..#......#
#.........#
#..........
#.....#...#
#.........#
#.........#
#..#......#
#####.#####
key : 0

1
3
#####l#####
#.........#
#.........#
#.........#
#.........#
l.........d
#...##....#
#.........#
##..#.....#
#.........#
#####.#####
locked : 2

2
4
#####.#####
#.........#
#.........#
#.....#..##
#.........#
..........#
#......#..#
#.........#
#.........#
#.......k##
###########
key : 5

1
1
#####.#####
#.........#
#..#......#
#..#......#
#..##.....#
...........
#.........#
#.........#
#.........#
#.........#
#####l#####
locked : 0

1
4
#####.#####
#.........#
#.........#
#..####...#
#.###.....#
d..####...#
#..#e#....#
#.#...#...#
#.........#
#.........#
#####.#####
boss
enemies 1

0
1
###########
#.........#
#..#..#..##
#.........#
#.........#
#...#..#...
#.........#
#.........#
#........##
#.........#
#####.#####

2
2
#####.#####
#k#.....#.#
#.........#
#....#.#.##
#.........#
...........
#.........#
#......#.##
#.........#
#.#.....#.#
#####.#####
key : 1

4
1
#####d#####
#.........#
#.........#
#.........#
#.........#
#..........
#.........#
#.........#
#.........#
#.........#
###########

