2
2
###########
##.#...#k##
#.........#
#.#.#.#.#.#
#.........#
.....#.#..#
#.........#
#.#.#.#.#.#
#.........#
##.#...#.##
###########
key : 1

1
0
#####.#####
#.........#
#..#......#
#.#.......#
#.........#
#..........
#.........#
#.#.....#.#
#..#...#..#
#.........#
#####.#####

5
2
#####.#####
#.........#
#.........#
#.........#
#.........#
...........
#.........#
#.........#
#.........#
#.........#
#####.#####

7
2
#####.#####
#.........#
#.........#
#.........#
#.........#
..........#
#.........#
#.#.....#.#
#..#...#..#
#.........#
###########
door 1 : 2

0
1
###########
#.#.....#.#
#.........#
#.........#
#.......#.#
d.........#
#.........#
#.#..#..#.#
#.........#
#.........#
#####.#####

6
1
#####l#####
#.........#
#.........#
#.........#
#.........#
#....e.....
#.........#
#.........#
#.........#
#.........#
#####.#####
locked : 1
boss
enemies 1

5
1
#####.#####
#.........#
#.........#
#...#.....#
#...#.....#
#...##.....
#e#####...#
###?##....#
#.........#
#.........#
#####l#####
enemies 1
sign Seek the matching key before you proceed.

4
1
#####.#####
#.#.....#.#
#.........#
#.#...#.#.#
#.........#
#.....#...d
#.........#
#.#.#.#.#.#
#.........#
#.........#
#####.#####

3
1
#####.#####
#.........#
#.....#.#.#
#.........#
#.#.#.#.#k#
..........#
#...#.....#
#.........#
#.#.#.#...#
#.........#
#####.#####
key : 2

8
1
#####.#####
#.........#
#.........#
#.........#
#.........#
#.........#
#.........#
#.........#
#.........#
#k........#
###########
key : 3

6
2
#####.#####
#.........#
#.........#
#.........#
#.........#
.......#..#
#.....##..#
#....#X#..#
#.........#
#.........#
#####.#####

0
0
###########
#.........#
#..#...#..#
#.........#
#..#...#..#
#.........d
#..#.#.#..#
#.........#
##........#
#.........#
#####.#####

2
0
#####.#####
#.........#
#.........#
#.........#
#.........#
#.........d
#.........#
#k#.......#
#..#......#
#.........#
#####.#####
key : 0

7
1
#####.#####
#e........#
#.........#
#.........#
#e.#......#
#e.........
#s........#
#.........#
#.........#
#?........#
#####.#####
enemies 3
switch 0 : 0 1
sign Only the prepared may pass.

1
1
#####.#####
####......#
#e##......#
#..##.#...#
#..##.....#
.........e#
#.........#
#.........#
#.........#
#e........#
#####.#####
enemies 3
door 0 : 0 1

4
2
###########
#.#.....#.#
#.........#
#..#.#.#.##
#.........#
d.........#
#.........#
#......#.##
#.........#
#.......#.#
#####.#####

2
1
#####.#####
#.........#
#.........#
#.........#
#.........#
d..........
#....#....#
#.........#
#.........#
#.........#
#####.#####

5
3
###########
#........e#
#.........#
#.....#..##
#.........#
..........#
#.....#...#
#.........#
#.........#
#..#.....s#
###########
enemies 1
switch 1 : 2

3
0
#####.#####
#.........#
#.........#
#.#...#...#
#...##....#
#....@#....
#....##...#
#.##..#...#
#.........#
#.........#
###########

