3
1
#####l#####
#.........#
#.........#
#.........#
#.........#
...........
#.........#
#.........#
#.........#
#.........#
#####.#####
locked : 0

0
1
###########
#.........#
#.........#
#.........#
#.........#
#.........#
#.........#
#.........#
#.........#
#.........#
#####d#####

5
1
#####.#####
#.........#
#..#......#
#.#.......#
#.........#
#.........#
#.........#
#.#.....#.#
#..#...#..#
#.........#
###########

6
3
#####.#####
##.#......#
##........#
#.##.##...#
#.###.#...#
#..##.....#
#..##.....#
#.........#
#........##
#......#.X#
###########

1
0
###########
#.........#
#.........#
#.........#
#.........#
#..........
#.........#
#.......###
#.#.#..#..#
#.........#
#####d#####

4
2
#####.#####
#.........#
#.........#
#.........#
#....##...#
d...##.....
#.###.#...#
#.#.#.....#
#...#.....#
#.........#
###########

2
1
#####.#####
#k........#
#.........#
#.........#
#.........#
...........
#.........#
#.........#
#.........#
#.........#
#####l#####
key : 0

3
5
###########
#........k#
#..#......#
#.#.......#
#.........#
..........#
#.........#
#.........#
#.........#
#.........#
###########
key : 4

4
1
#####.#####
#.........#
#.........#
#.........#
#.........#
#k........d
#.........#
#.........#
#.........#
#.........#
#####.#####
key : 1

4
3
#####l#####
#.........#
#.........#
#.........#
#.........#
.......#...
#.........#
#.#.....#.#
#..#...#..#
#......#..#
#####l#####
locked : 1

3
0
#####.#####
#.........#
##.#......#
###.......#
#..#@.##..#
#....#.#...
#.........#
#.........#
#.........#
#.........#
###########

4
4
#####.#####
#.........#
#..#......#
#.#.......#
#.........#
..........#
#.........#
#.#.....#.#
#..#...#..#
#........k#
###########
key : 5

5
3
#####l#####
#.........#
#.........#
#.........#
#.#.##....#
#..#.e....#
#.####....#
#..##.....#
###.#.....#
#.........#
#####.#####
locked : 5
boss
enemies 1

2
0
#####d#####
##.....#..#
#.........#
#.........#
#...#..#..#
#..........
#.........#
##..#..#..#
#.........#
#.........#
#####.#####

3
3
###########
#.........#
#.........#
#.......#.#
#.........#
d..........
#.........#
#.........#
#.........#
#.........#
#####l#####

1
1
#####d#####
#.........#
#.........#
#..#..#..##
#.........#
..........#
#..#......#
#.........#
#.........#
#..#.....##
#####.#####

3
4
###########
#.........#
#..#...#..#
#.#.....#.#
#.........#
.......#...
#.........#
#.........#
#.........#
#.........#
#####.#####

2
2
###########
#.........#
#..#......#
#.#.......#
#.........#
..........#
#.........#
#.#.......#
#..#......#
#.........#
#####.#####

3
2
#####.#####
#.......#.#
#.........#
#.........#
#.....#.#.#
.....##...d
#....####.#
#....#.##.#
#......#..#
#.#.......#
#####.#####

