2
1
#####l#####
#k........#
##.##.....#
######....#
#.#.......#
....#......
#.........#
#.........#
#.........#
#.........#
#####.#####
key : 0

2
2
#####d#####
#.........#
#.........#
#.........#
#...##....#
...#.#....#
#..#..#...#
#...#.#...#
#...#.#...#
#.........#
#####.#####

1
2
#####.#####
#.........#
#......#..#
##....##..#
#....#.#..#
.....#.....
#.........#
#.........#
#.........#
#.........#
#####d#####

1
4
###########
#........X#
#.###.....#
#.#.......#
#.#.......#
...#......#
#.##......#
#.........#
#.........#
#.........#
#####.#####

4
2
#####.#####
##........#
#.........#
#.#.#.#.#.#
#.........#
...#...#...
#.........#
#.#.....#.#
#.........#
##k#...#.##
###########
key : 3

4
1
#####.#####
#e........#
##.#...#.##
#.........#
#..#.#.#..#
#..........
#..#.#....#
#.........#
##.#...#.##
#s........#
#####.#####
enemies 1
switch 0 : 0

1
0
###########
#e##...##.#
#.###...#.#
#..#.##...#
#....#.##.#
#..........
#.........#
#.........#
#.........#
#.........#
#####.#####
enemies 1

2
0
#####.#####
#.........#
#.........#
#.........#
#.........#
#...#@##...
#...####..#
#.....##..#
#......##.#
#?......#.#
###########
sign The torches flicker in a sourceless wind.

3
3
###########
#.....k#..#
#..#......#
#.#.......#
#.........#
..........d
#.........#
#.......#.#
#......#..#
#.........#
#####.#####
key : 2

3
2
#####.#####
#.........#
##.#.....##
#.........#
#.#...#.#.#
...........
#......#..#
#.........#
#.#.#.#.#.#
#.........#
#####.#####

0
2
###########
#k........#
#......#..#
#.......#.#
#....#....#
#.........#
#.........#
#.......#.#
#......#..#
#.........#
#####.#####
key : 1

3
5
###########
#.........#
#.........#
#.........#
#.........#
d.........#
#.........#
#.#.....#.#
#..#...#..#
#.........#
###########

1
1
###########
#.........#
#.........#
#.......#.#
#.........#
...........
#......#..#
#.#.......#
#..#......#
#.#.......#
#####l#####
locked : 0

1
3
###########
#....ee#..#
#.........#
#.......#.#
#.........#
...........
#.........#
#.........#
#.........#
#....e....#
###########
enemies 3

2
4
#####.#####
#.........#
#.........#
#.........#
#.........#
#....e....#
#.........#
#.........#
#.........#
#.........#
#####d#####
boss
enemies 1

5
1
#####.#####
#.........#
#.........#
#.........#
#.#.......#
#..##.....#
#.........#
#.........#
#e........#
#e.......e#
###########
enemies 3
door 0 : 0

3
4
#####d#####
##.....#.##
#.........#
##.....#.##
#.........#
d..#.#.#..d
#.........#
##.#.#.#.##
#.........#
##.#...#.##
###########

4
3
#####.#####
#.........#
#..#......#
#.#.......#
#.........#
..........#
#.........#
#.#.......#
#..#......#
#.........#
###########

3
1
#####.#####
#.......#.#
#.........#
#.........#
#..#..#...#
#..........
#.........#
#.......#.#
#.........#
#.........#
#####.#####

