3
2
#####l#####
#.........#
#.........#
#.........#
#.........#
#..........
#.........#
#.........#
#.........#
#.........#
#####l#####
locked : 0

1
4
#####.#####
#.#.....#.#
#.........#
#.#.#.#.#.#
#.........#
....#.#...d
#.........#
#.#...#...#
#.........#
#.#.......#
#####l#####

2
3
#####.#####
#.........#
#.###.....#
#..#......#
#.........#
...##......
#..#...#..#
##..#.....#
#..##.....#
##.#......#
#####.#####

2
5
#####.#####
#.........#
#.#.#.#.#.#
#.........#
#..#...#..#
...........
#.#.#.#.#.#
#.........#
#..#.....##
#.........#
#####d#####

1
0
###########
#?.......##
#.........#
#.........#
#.........#
#....@.....
#.........#
#.........#
#.........#
#.........#
###########
sign Beware what lurks ahead.

0
1
###########
#k........#
#..#......#
#.#.......#
#.........#
#.........#
#.........#
#.#.......#
#..#......#
#.........#
#####.#####
key : 0

2
6
###########
#.....?..e#
##....#...#
#.#.......#
#..##.#e#.#
....#.##..#
#.........#
#.........#
#.........#
#........e#
###########
enemies 3
sign The dungeon remembers all who enter.

3
3
#####.#####
#.........#
#..#...#..#
#.#.....#.#
#.........#
..........#
#.........#
#.........#
#.........#
#........k#
###########
key : 2

2
2
#####d#####
#.........#
##.....#.##
#.........#
#..#.#.#..#
#..........
#..#.#.#..#
#.........#
##.#...#.##
#.........#
#####l#####

1
3
#####.#####
#.#......##
#...#.....#
#..##.....#
#.##..#...#
d..###.....
#.........#
#.........#
#.........#
#.........#
#####.#####

3
5
#####d#####
#.........#
#.........#
#.........#
#.#.##....#
#..#e#....#
#..#......#
#...##....#
####......#
#.........#
#####.#####
boss
enemies 1

2
4
#####l#####
#.........#
#......#..#
#.......#.#
#.........#
......#....
#.........#
#..#......#
#.........#
#..#......#
###########
locked : 3

1
1
#####.#####
#.........#
#.........#
#.........#
#.........#
...........
#.........#
#.......#.#
#......#..#
#.........#
###########

4
2
#####l#####
#.........#
#..#......#
#.#.......#
#.........#
#.........#
#.........#
#.......#.#
#......#..#
#.........#
###########
locked : 2

1
2
###########
#.........#
##.#...#.##
#.........#
#.#.#.#.#.#
..........d
#..#......#
#.........#
#.#.#.#.#.#
#.........#
#####d#####

4
5
#####.#####
#.........#
#.........#
#.........#
#.........#
#.........#
#.........#
#.........#
#.........#
#X........#
###########

0
4
###########
#........k#
#.........#
#.........#
#.........#
..........#
#.........#
#.#.......#
#..#......#
#.........#
#####.#####
key : 3

1
5
###########
#.........#
#..#..##..#
#..#...#..#
#....###..#
d..#.###..#
#...#.....#
#....#....#
#...#.....#
#.........#
#####.#####

0
3
###########
#k........#
#.........#
#.........#
#.........#
#..........
#.........#
#.........#
#.........#
#.........#
#####.#####
key : 1

