2
2
#####.#####
#k........#
#..#...#..#
#.#....##.#
#.........#
...........
#.........#
#.........#
#.........#
#.........#
#####.#####
key : 4

6
2
#####.#####
#.........#
#.....#...#
#.........#
#.........#
#...#..#..#
#.........#
#.........#
#..#..#..##
#........e#
###########
enemies 1
door 0 : 0 1

3
2
#####.#####
#........e#
#..#.....##
#.........#
#..#.#....#
..........#
#..#.#.#..#
#.........#
##.#...#.##
#e.......?#
#####.#####
enemies 2
sign What you seek is close.

2
1
#####d#####
#.#.....#.#
#.........#
#.#.#.#.#.#
#.........#
....#......
#.........#
#.#.#.....#
#.........#
#.#.......#
#####l#####
locked : 1

3
1
#####l#####
#......####
#......####
#.....#...#
#.....#...#
.....#k#...
#.........#
#.........#
#.........#
#.........#
#####.#####
key : 1

0
1
###########
#.........#
#.........#
#.........#
#...#..#..#
#.........d
#.........#
#...#..#..#
#.........#
#.........#
#####d#####

4
1
#####.#####
#.........#
#.........#
#.........#
#...##..#.#
....####...
#.....###.#
#.......#.#
#.....###.#
#.........#
#####d#####

4
2
#####.#####
#.#.....#.#
#.........#
#.....#.#.#
#.........#
....#.#...#
#.........#
#...#.#...#
#.........#
#.......#.#
#####.#####

5
2
#####.#####
#e.......?#
#.........#
#.........#
#.........#
...........
#.........#
#.........#
#.........#
#s........#
#####.#####
enemies 1
switch 0 : 0 1
sign Beware what lurks ahead.

4
0
#####.#####
#.........#
#.........#
#.........#
#.........#
#..........
#.........#
#k#.......#
##.#......#
#.........#
#####.#####
key : 0

3
0
#####.#####
#.........#
#.........#
#.#####...#
#..##.#...#
#..##@#....
#...#.#...#
#.........#
#.........#
#.........#
#####.#####

5
0
#####.#####
#.........#
#..#......#
#.#.......#
#.........#
#..........
#.........#
#.........#
#.........#
#k........#
###########
key : 2

1
1
#####d#####
#.........#
#.........#
#.........#
#.........#
#..........
#.........#
#.........#
#.........#
#.........#
#####d#####

2
0
###########
#e........#
#...#...#.#
#.........#
#?#.#.#.#.#
#..........
#.#.#.#.#.#
#.........#
#.....#.#.#
#.........#
#####.#####
enemies 1
sign This door will not yield without a key.

5
1
#####d#####
#.........#
#......#..#
#.......#.#
#.........#
...........
#.........#
#.......#.#
#......#..#
#.........#
###########

1
2
#####.#####
#.........#
#.........#
#.........#
#.........#
.....#X...#
#...###...#
#....##...#
#.........#
#.........#
#####.#####

2
3
###########
#......#..#
#..#......#
#.#.....#.#
#.........#
..........#
#...#.....#
#.........#
#.........#
#.........#
###########

0
2
###########
#.........#
#.....##..#
#.#.##....#
#.#.#.....#
d....e....#
#...#.....#
#...#.....#
#.........#
#.........#
#####.#####
boss
enemies 1

5
3
###########
#......##.#
#.....##..#
#.........#
#.........#
..........#
#.........#
#.........#
#.........#
#.........#
###########

