3
5
###########
#.........#
#......#..#
#.......#.#
#.........#
d.........#
#.........#
#.#.....#.#
#..#...#..#
#.........#
###########

2
2
#####.#####
#.........#
#.........#
#..#......#
#.........#
...........
#..#..#...#
#.........#
#.........#
#..#.....##
#####l#####
locked : 2

4
0
#####.#####
#.........#
#...#.....#
#.###.....#
#.##......#
#..........
#.........#
#.........#
#.........#
#k........#
###########
key : 0

2
3
###########
#.........#
#......#..#
#.......#.#
#.........#
...........
#.........#
#.........#
#.........#
#.........#
#####d#####

4
1
#####.#####
#.........#
#..#......#
#.#.......#
#.........#
..........#
#.........#
#.......#.#
#......#..#
#........k#
###########
key : 5

1
2
#####d#####
#.........#
#.#.#...#.#
#.........#
#..#.#....#
..........#
#.....#.#.#
#.........#
#..#...#..#
#.........#
#####.#####

3
0
###########
#?........#
#.........#
#..#.##...#
#..####...#
#..#@##....
#..#......#
#.........#
#.........#
#........##
#####.#####
sign Something glints behind that door…

2
1
#####.#####
#k........#
##..#..#..#
#.........#
#.........#
#...#..#...
#.........#
#.........#
#.........#
#.........#
#####.#####
key : 1

3
3
#####d#####
#k........#
##.#...#.##
#.........#
#.#.....#.#
...........
#..#.#....#
#.........#
#.#.#...#.#
#.........#
#####.#####
key : 2

5
4
#####l#####
#.........#
#.........#
#.....#...#
#.........#
#....e....#
#.........#
#.........#
#.....#...#
#.........#
#####.#####
locked : 5
boss
enemies 1

0
2
###########
#.........#
#.........#
#.#..#..#.#
#.........#
#.........#
#..#..#...#
#.........#
#.........#
#.#.....#.#
#####d#####

4
4
#####d#####
#.........#
#......#..#
#.......#.#
#.........#
..........#
#.........#
#.........#
#.........#
#.#.......#
#####l#####

6
4
#####.#####
#.........#
#.........#
#.........#
#.........#
#....#....#
#.##......#
#..###....#
#####.....#
##X.......#
###########

2
4
###########
#.........#
#..#...#..#
#.#.....#.#
#.........#
..........#
#.........#
#.#.......#
#..#......#
#.........#
#####l#####
locked : 1

3
2
#####l#####
#.........#
#.........#
#.........#
#....#.#..#
l......#...
#.#..###..#
##.#......#
#..#......#
#.........#
###########
locked : 0

3
4
#####l#####
#.........#
#.........#
#.........#
#.....#...#
.....###..d
#.........#
#....#....#
#.....#.#.#
#.........#
#####d#####

4
3
#####.#####
#.........#
#.........#
#.........#
#..###....#
#..###.#...
#......#..#
#..###.#..#
#...#..#..#
#.........#
###########

3
1
#####.#####
#......#..#
#.....#...#
#.....#e#.#
#......#..#
.......#..l
#....#.##.#
#....#.e#.#
#......#?##
#........##
#####.#####
enemies 2
sign Seek the matching key before you proceed.

1
1
###########
#.#.....#.#
#.........#
#..#.#.#.##
#.........#
#...#......
#.........#
#..#.#.#.##
#.........#
#.......#.#
#####.#####

