3
0
#####.#####
#..#......#
#..#..#...#
#..?###...#
#..##.##..#
#....@#....
#....##...#
#.........#
#.........#
#.........#
#####.#####
sign Something glints behind that door…

2
2
#####.#####
#?........#
#.........#
#.........#
#.........#
.....#...e#
#.........#
#.........#
#.........#
#.........#
#####.#####
enemies 1
sign Many have walked this path.

2
0
###########
#k........#
#.........#
#.........#
#.........#
#.........d
#.........#
#.........#
#.........#
#.........#
#####.#####
key : 0

4
1
#####.#####
#.........#
#.........#
#.........#
#.....#...#
......##..l
#....#.##.#
#....#.#..#
#......##.#
#.........#
#####.#####

3
2
#####.#####
#.........#
#..#......#
#.#.......#
#.........#
......#...#
#.........#
#.........#
#.........#
#.........#
#####.#####

1
3
###########
#.........#
#......#..#
#......##.#
#.........#
l.........d
#.........#
#......#..#
#.........#
#.#.......#
###########
locked : 7

3
1
#####.#####
#.........#
#..#......#
#.#.......#
#.........#
...........
#.........#
#.........#
#.........#
#..#......#
#####.#####

1
4
###########
#.........#
#..##.#...#
#.##.#..#.#
#.#..##...#
d....e##..#
#.#.##....#
#.........#
#.........#
#.........#
#####.#####
boss
enemies 1

6
1
#####d#####
#.........#
#.........#
#.........#
#.........#
#.........#
#.........#
#.........#
#.........#
#.........#
#####.#####

4
2
#####.#####
#.........#
#.........#
#..#..#..##
#.........#
l.........d
#...#..#..#
#.........#
#.........#
#..#......#
#####.#####
locked : 0

4
3
###########
#.........#
#.........#
#.........#
#.........#
d....###..#
#....##...#
#.....#####
#......#..#
#.........#
###########

2
1
###########
#.........#
#......#..#
#.......#.#
#.........#
d....#.....
#.........#
#.......#.#
#......#..#
#........##
#####.#####

0
2
###########
#.........#
#.........#
#.........#
#.........#
#.........#
#.........#
#.......#.#
#......#..#
#.........#
#####.#####

5
2
#####.#####
#.........#
#.........#
#.........#
#..#.#.##.#
....##.#..#
#...#.....#
#...#.#.#.#
#......##.#
#......#k.#
###########
key : 7

2
4
#####.#####
#......##.#
#.........#
#.....##..#
#.........#
#.........#
#.........#
#.........#
#.........#
#X........#
###########

7
1
#####.#####
#.........#
#..#......#
#.........#
#.........#
#.........#
#.........#
#.........#
#.........#
#.........#
###########

5
1
#####.#####
#.........#
#.........#
#.........#
#.........#
#k.........
#.........#
#.........#
#.........#
#.........#
#####d#####
key : 4

4
0
#####.#####
#.........#
#..#......#
#.#.......#
#.........#
#..........
#.........#
#.........#
#.........#
#k........#
###########
key : 1

1
2
#####.#####
##.#...#.##
#e........#
##.#.#.#.##
#.........#
#..#.#.#..l
#.........#
##.....#.##
#?........#
##.....#.##
#####.#####
enemies 1
sign Seek the matching key before you proceed.

