4
3
###########
#.........#
#..#......#
#.........#
#.........#
d.........#
#.........#
#.........#
#.........#
#.........#
#####D#####

5
2
#####D#####
#.........#
#..##.###.#
#.#k###.#.#
#...##..#.#
#..###.#..D
#....#....#
#.........#
#.........#
#.........#
#####l#####
key : 1

5
4
###########
#.......ee#
#.........#
#.........#
#.........#
D.........#
#.........#
#.........#
#.........#
#........e#
###########
enemies 3
door 0 : 0

4
1
#####l#####
##.....#..#
#.........#
#.........#
#.#..#..#.#
#.........D
#.........#
##.....#..#
#.........#
#.........#
###########
locked : 0

3
1
#####d#####
#.........#
#......#..#
#.......#.#
#.........#
D.........D
#.........#
#.#.....#.#
#..#...#..#
#.........#
#####l#####

3
2
#####D#####
##.#...#.##
#........k#
#..#.#.#.##
#.........#
D..#.#....#
#.........#
##.#.#.#.##
#.........#
##.#...#.##
#####D#####
key : 0

3
0
#####D#####
#.........#
#.........#
#.........#
#.........#
#..#......D
#.###.....#
#?###.....#
#e.##.....#
##e#e.....#
###########
enemies 3
sign Many have walked this path.

4
2
#####D#####
#.........#
#..#...#..#
#.#.....#.#
#.........#
D.........d
#.........#
#.......#.#
#......#..#
#.........#
#####D#####

7
3
#####D#####
#..#......#
#..#..#...#
#....##...#
#....#....#
#.........#
#.........#
#.........#
#.........#
#X........#
###########

1
3
###########
#.........#
#.........#
#.........#
#.........#
D.........#
#.........#
#.........#
#.........#
#.........#
#####D#####

2
2
#####d#####
#.........#
#......#..#
#.......#.#
#.........#
D.........D
#.........#
#.........#
#.........#
#.........#
#####D#####

2
3
#####D#####
##.#......#
#..##.....#
#.........#
#.#.......#
D.........#
#.........#
#.........#
#.........#
#........k#
###########
key : 2

2
0
###########
#?........#
##p#......#
####......#
#.##@#..#.#
#....#....D
#....###..#
#.....p#..#
#.........#
#.........#
#####D#####
sign Many have walked this path.

6
3
#####d#####
#.........#
#.........#
#.........#
#...e##...#
D....##...#
#..#.#..#.#
#..########
#.#.#..#.##
#.........#
#####D#####
boss
enemies 1

2
1
###########
#.........#
#.........#
#.........#
#.#..#..#.#
D.........D
#.........#
##..#..#..#
#.........#
#.........#
#####d#####

1
2
#####D#####
#.........#
#.........#
#.........#
#.........#
#..##.....D
#...#.....#
#...#..#..#
#..#...#..#
#..#......#
#####d#####

5
3
#####D#####
#k........#
#.........#
#..#..#..##
#.........#
D.........D
#..#..#...#
#.........#
#.........#
#........##
#####d#####
key : 3

0
2
###########
#e.......e#
#.........#
#?....#...#
#s##.###..#
#...##....#
#..#..##..#
#..#..###.#
#..#..#...#
#.........#
#####D#####
enemies 2
switch 0 : 0
sign The dungeon remembers all who enter.

6
2
#####l#####
#.........#
#.........#
#.........#
#.........#
#....#....D
#.....#...#
#......#..#
#.........#
#.........#
###########
locked : 2

