4
1
#####.#####
#.#.....#.#
#.........#
#.#...#.#.#
#.........#
#...#.#...#
#.........#
#.#.#.#...#
#.........#
#.#.....#.#
###########

1
0
###########
#.......#.#
#.........#
#.........#
#.........#
#....@.....
#.........#
#...#.....#
#.........#
#.........#
#####.#####

2
0
#####.#####
##s#...#.##
#.........#
#e#.#.#.#.#
#.........#
#..#.#.....
#.........#
#e#.#.#...#
#.........#
##.......##
#####.#####
enemies 2
switch 0 : 0 1

2
3
#####.#####
##.#.....##
#.........#
#.#.#.#.#.#
#.........#
l..#.#.#..l
#.........#
#...#.#.#.#
#.........#
##.#.....##
#####d#####
locked : 0

4
3
#####.#####
#.........#
#.........#
#.###.....#
#...#.....#
#..#......#
#...#.....#
#.........#
#.........#
#e........#
###########
enemies 1
door 0 : 0 1

3
5
###########
#........e#
#.........#
#.........#
#.........#
..........#
#.........#
#.........#
#.........#
#........e#
###########
enemies 2
door 1 : 2 3

1
4
###########
#........X#
#......#..#
#.##.####.#
#.#.#.###.#
....#..#..#
#..##.#...#
#.###.#...#
#.........#
#........##
#####.#####

3
0
#####.#####
#.........#
#...#.#...#
#...#.#...#
#.........#
#..........
#.........#
#....#....#
#...#.....#
#.........#
###########

1
3
###########
#.........#
#..#....#.#
#.#k#.....#
#.........#
...........
#.........#
#.......#.#
#......#..#
#.........#
#####.#####
key : 4

1
1
###########
#..k......#
#..#......#
#.#.......#
#.........#
...........
#.........#
#.........#
#.........#
#.........#
#####.#####
key : 0

3
1
#####d#####
#.........#
#.........#
#.........#
#.........#
...........
#..##.....#
#...##....#
#..#......#
#.........#
#####.#####

3
3
#####d#####
#.........#
#.........#
#.........#
#.........#
...........
#.........#
#.........#
#.........#
#.........#
#####.#####

2
4
#####.#####
#.........#
#.........#
##.###....#
#..###....#
l...#e....#
#.##......#
##.##.....#
#.........#
#.........#
#####.#####
locked : 1
boss
enemies 1

2
1
#####.#####
#k#.....#.#
#.........#
#.#.#.#.#.#
#.........#
....#.#....
#.........#
#.#.#...#.#
#.........#
#.........#
#####d#####
key : 1

3
2
#####.#####
#.........#
#.........#
#.........#
#.........#
...........
#.........#
#.........#
#.#.......#
#.........#
###########

3
4
#####.#####
#e........#
##s#......#
#.##......#
#.#.......#
......#....
#.........#
#.....#...#
#.........#
#.........#
###########
enemies 1
switch 1 : 2 3

2
2
#####d#####
#.........#
#.........#
##...#....#
#.#k#.....#
...###....l
#.#...##..#
#.#.###...#
#.........#
#.........#
#####.#####
key : 2

1
2
#####.#####
#.........#
#.........#
#.........#
#.........#
...#.#.....
#..#...#..#
#..####.#.#
#.#.....#.#
##........#
#####d#####

0
2
###########
#.........#
#..#......#
#.#.......#
#.........#
#.........#
#.........#
#.........#
#.........#
#.........#
#####.#####

