3
3
#####l#####
#.........#
#.........#
#.........#
#.........#
d.........D
#.........#
#.........#
#.........#
#.........#
#####D#####

4
4
#####D#####
#.........#
#......#..#
#.........#
#.........#
D...#.....#
#.........#
#.........#
##.....#..#
#.........#
###########

4
2
#####D#####
#.........#
#.........#
#........##
#.........#
D.........D
#.....#...#
#.#.....#.#
#..#...#..#
#..k......#
###########
key : 1

2
3
#####d#####
#.........#
#.........#
#.........#
#.........#
D.........#
#.........#
#.......#.#
#......#..#
#.........#
#####l#####
locked : 0

4
1
#####D#####
#k#.....#.#
#.........#
#.........#
#..#......#
D.........D
#.........#
#.#..#..#.#
#.........#
#.........#
###########
key : 0

2
2
#####D#####
#e#.......#
#.........#
#.#.#...#.#
#.........#
D.....#...D
#.........#
#.#.#.#.#.#
#.........#
#?#.....#.#
#####D#####
enemies 1
sign Seek the matching key before you proceed.

3
0
#####D#####
#.........#
#.........#
#.........#
#.........#
#?...@....d
#.........#
#.........#
#.........#
#.........#
#####D#####
sign Beware what lurks ahead.

3
1
#####D#####
#.........#
#.........#
#.........#
#.........#
d.........D
#.........#
#.#.......#
#..#......#
#.........#
#####D#####

4
0
#####D#####
#.##......#
#.###.....#
#.#.#.....#
#.#.#.....#
#.........D
#.........#
#.......#.#
#.....###.#
#.........#
###########

2
1
#####D#####
#.........#
#.........#
#.........#
#.........#
D.........D
#.........#
#.#.......#
#..#......#
#.........#
#####D#####

1
3
#####D#####
#.........#
#.........#
#.........#
#.........#
D....e....#
#.......#.#
#.........#
#.........#
#.........#
#####d#####
boss
enemies 1

5
3
#####D#####
#.........#
#.........#
#.........#
#.#..#..#.#
#.........#
#.........#
#...#..#..#
#.........#
#k........#
###########
key : 4

4
3
#####D#####
#..#......#
#.##..#...#
#...##....#
#.##.##...#
D....##...D
#.........#
#.........#
#.........#
#.........#
#####D#####

0
3
###########
#X.....#..#
#.....##..#
#....####.#
#.....##..#
#.....##..#
#.........#
#.........#
#.........#
#.........#
#####D#####

2
0
###########
#.........#
#.........#
#.........#
#.........#
#.........D
#.........#
#.........#
#.........#
#.........#
#####D#####

3
2
#####D#####
#.........#
#..#......#
#.#.......#
#.........#
D......#..d
#.........#
#.........#
#.........#
#.........#
#####D#####

1
1
###########
#.........#
#..#......#
#.#.......#
#.........#
#.........d
#.........#
#.........#
#.........#
#.........#
#####D#####

1
2
###########
#.........#
#.........#
#.........#
#.........#
d.........D
#.........#
#.........#
#.........#
#.........#
#####D#####

3
4
###########
#........k#
#.........#
#.........#
#.........#
D.........#
#..##.#...#
#..####...#
#.....#...#
#.........#
#####D#####
key : 3

