4
1
#####d#####
#.........#
#.#.#.#.#.#
#.........#
#..#...#..#
..........#
#.#...#...#
#.........#
#..#...#.##
#.........#
#####.#####

2
2
#####.#####
#.......#k#
#.........#
#.........#
#.....#...#
..........d
#.........#
#.#.....#.#
#.........#
#.........#
#####.#####
key : 2

3
2
#####.#####
##.....#.##
#.........#
#.#.#.#.#.#
#.........#
.....#.#..#
#.........#
#.#...#.#.#
#.........#
#..#...#.##
###########

0
1
###########
#.........#
#.........#
##..#..#..#
#.........#
#..........
#...#..#..#
#.........#
#.........#
##.....#..#
#####l#####
locked : 0

0
2
###########
#e...e....#
#.........#
#.........#
#.........#
...........
#.........#
#.........#
#.........#
#.........#
#####.#####
enemies 2

3
1
#####.#####
#k........#
##.......##
#.........#
#.#.#.#.#.#
...........
#..#.#.#..#
#.........#
#.#.#.#...#
#.........#
#####d#####
key : 1

3
0
#####.#####
#.........#
#...#.....#
#...##....#
#..#......#
#..##......
#.###.....#
#.........#
#.........#
#.........#
#####l#####

1
4
###########
#........X#
#.........#
#.........#
#.........#
..........#
#.........#
#.........#
#.........#
#.........#
###########

1
0
###########
#e........#
#...#.#...#
#...##....#
#...#.....#
#..........
#.........#
#.........#
#.........#
#.........#
#####.#####
enemies 1

5
0
#####d#####
#.........#
#...#.#...#
#..#......#
#......#..#
#..#.......
#.........#
#.........#
#.........#
#.........#
###########

1
1
#####l#####
#k........#
#..#......#
#.#.......#
#.........#
...........
#.........#
#.......#.#
#......#..#
#.........#
#####.#####
key : 0

4
0
#####l#####
#.........#
#.........#
#.........#
#.........#
#..##......
#.........#
#.#.....#.#
#..##..#..#
#.........#
#####d#####
locked : 1

5
1
#####.#####
#.#.....#.#
#.........#
#.#...#.#.#
#.........#
....#.....#
#.........#
#.#.#.....#
#.........#
#.......#.#
###########

1
2
#####.#####
#e#......?#
#.........#
#.........#
#.........#
..........d
#.........#
#.#..#..#.#
#.........#
#e........#
#####.#####
enemies 2
sign Something glints behind that door…

2
3
#####.#####
#..#.....##
#.........#
#.........#
#.....#...#
d.........#
#.........#
#..#..#..##
#.........#
#.........#
###########

1
3
#####.#####
#.........#
##.#...#..#
##.###....#
#.####....#
d...e#.....
#..###....#
#.####...##
#.........#
#.........#
#####.#####
boss
enemies 1

0
3
###########
#........k#
##.#.....##
#.........#
#.#.#...#.#
..........#
#..#.#.#..#
#.........#
#.#.#.#.#.#
#.........#
#####.#####
key : 5

2
0
#####.#####
#.........#
#.........#
#.........#
#.........#
#?...@.....
#.........#
#.........#
#.........#
#.........#
#####.#####
sign Many have walked this path.

2
1
#####.#####
#.........#
#.........#
#.........#
#.........#
...........
#.........#
#.........#
#.........#
#.........#
#####.#####

