5
0
#####.#####
#.........#
#..#......#
#.#.......#
#.........#
#.........#
#.........#
#.......#.#
#......#..#
#k........#
###########
key : 3

1
2
#####.#####
#.........#
##.#...#.##
#.........#
#..#.#....#
...........
#..#......#
#.........#
##.#.....##
#.........#
#####d#####

3
2
#####d#####
#.........#
#.........#
##........#
#.........#
.....###...
#.......#.#
#....#.#..#
#.....#.#.#
#.........#
###########

2
3
#####.#####
#.........#
#.....##..#
#...###.#.#
#...#.#.#.#
d...#.....l
#.........#
#.........#
#.........#
#.........#
#####.#####

3
0
#####.#####
#.#.......#
#.........#
#.........#
#...#.....#
#..........
#.........#
#.#.......#
#..#......#
#.........#
#####.#####

2
1
#####l#####
#.........#
#......#..#
#.......#.#
#.........#
l..........
#.........#
#.......#.#
#......#..#
#.........#
#####.#####
locked : 0

3
1
#####.#####
#.........#
#..#...#.##
#.#...#.#.#
#.........#
...........
#.........#
#.#.......#
#..#......#
#......#..#
#####.#####

2
0
#####.#####
#.........#
#.........#
#..####...#
#..#?##...#
#..#.@#...l
#.........#
#.........#
#.........#
#.........#
#####.#####
sign This door will not yield without a key.

2
4
#####d#####
#.........#
#..#......#
#.#.......#
#.........#
l.........#
#.........#
#.#.....#.#
#..#...#..#
#.........#
###########
locked : 3

1
3
###########
#e...e....#
#.........#
#.........#
#.........#
...........
#..###....#
#....#....#
#.........#
#e........#
#####.#####
enemies 3

0
2
###########
#k.#......#
#......#..#
#.......#.#
#.........#
#.........#
#.........#
#.........#
#......#..#
#........##
#####.#####
key : 4

1
4
#####.#####
####......#
##.##.....#
##.###....#
#..#......#
...#.e#...#
#.....#...#
#..###....#
#.##..#...#
#.........#
#####d#####
boss
enemies 1

0
4
###########
#X........#
#.........#
#.###.....#
#.###.....#
#...#.....#
#.#.......#
#..#......#
#.........#
#.........#
#####.#####

4
0
#####.#####
#.........#
#.........#
#.........#
#.........#
#..........
#....###..#
#....##k..#
#.....##..#
#.........#
#####.#####
key : 1

4
1
#####.#####
#.........#
#.........#
#.........#
#.........#
..........#
#.........#
#.........#
#.........#
#.........#
###########

3
3
#####.#####
#......#..#
#......#..#
#....####.#
#..######.#
.....###..#
#.........#
#.........#
#.........#
#.........#
###########

2
2
#####d#####
#.........#
#.........#
#.........#
#.........#
..........d
#.........#
#.........#
#.........#
#.........#
#####d#####

1
0
###########
#k........#
##.#...#.##
#.........#
#..#.#.#..#
#..........
#..#.#.#..#
#.........#
##.#...#.##
#.........#
#####.#####
key : 0

1
1
###########
#.........#
#.........#
#.........#
#.........#
...........
#.........#
#.........#
#.........#
#.........#
#####l#####
locked : 1

