5
4
#####.#####
#.........#
#.........#
#.........#
#.........#
d....e....#
#.........#
#.........#
#.........#
#.........#
#####.#####
boss
enemies 1

4
2
#####.#####
#.........#
#.........#
#.........#
#.........#
l..........
#.........#
#.#.......#
#..#......#
#.........#
#####.#####
locked : 0

3
1
###########
#e##es....#
#..#......#
##....#...#
#.........#
...##......
#.#e#.....#
#.#.......#
#.##......#
#.........#
#####.#####
enemies 3
switch 0 : 0 1

5
3
#####l#####
##.#.....##
#.........#
#.#.#...#.#
#.........#
...#.#.#..d
#.........#
#.#.#.#.#.#
#.........#
##.#...#.##
#####.#####
locked : 2

4
3
#####.#####
#.........#
#.........#
#.........#
#.........#
...#..#...d
#..##.##..#
#.....#...#
#...#..#..#
#..#...#..#
#####l#####

3
4
###########
#.......ee#
#.......#.#
#.........#
#.........#
..........#
#.........#
#.........#
#.#.....#.#
#.........#
#####.#####
enemies 2

0
0
###########
#.........#
#.........#
#####.....#
#.##......#
#..###....#
#.##.#....#
#..#......#
#.........#
#.........#
#####d#####

6
4
#####.#####
#.........#
#.........#
#.........#
#.........#
..........#
#.........#
#..#......#
#.........#
#........X#
###########

4
0
#####.#####
#.........#
#.........#
#.........#
#.........#
#....@.....
#.........#
#.........#
#.........#
#.........#
###########

2
0
#####d#####
#.........#
#......#..#
#.......#.#
#.........#
#.........#
#.........#
#.......#.#
#......#..#
#.........#
#####.#####

3
2
###########
#......#..#
#.......#.#
#.....##..#
#....####.#
...........
#.........#
#.........#
#.........#
#.........#
#####.#####

3
0
#####.#####
##........#
#.........#
#.........#
#......#..#
#..........
#.........#
#...#..#..#
#.........#
#.........#
#####.#####

6
3
#####.#####
#.........#
#.........#
#.#..#....#
#.........#
#..........
#..#..#...#
#.........#
#.........#
#k#.......#
###########
key : 5

1
0
#####d#####
#......#..#
#..#......#
#...#..#..#
#..##.....#
#.........#
#..##.....#
#.........#
#.........#
#.........#
#####d#####

4
1
#####.#####
#.........#
#..#......#
#.#.......#
#.........#
..........l
#.........#
#.#.......#
#..#......#
#..k......#
###########
key : 0

4
4
#####.#####
#.........#
##..#..#..#
#.........#
#.........#
d...#.....#
#.........#
#.........#
##........#
#.........#
#####.#####

3
3
#####.#####
#k........#
#.........#
#.........#
#.........#
...........
#.........#
#.........#
#.........#
#.........#
#####.#####
key : 4

5
2
#####.#####
#.........#
#..#.....##
#.........#
#.........#
#.....#....
#.........#
#.........#
#........##
#k........#
###########
key : 2

2
3
###########
#e.......e#
#?........#
#.........#
#.........#
#.........#
#.........#
#.........#
#.........#
#.........#
#####.#####
enemies 2
door 0 : 0 1
sign Something glints behind that door…

