4
3
#####.#####
#.......###
#.......###
#....##.#.#
#...##.#..#
#..#.#....#
#......#..#
#..#.###..#
#..##.....#
#.........#
###########

4
0
#####.#####
#.........#
#.........#
#.........#
#.........#
#?...@.....
#.........#
#.........#
#.........#
#.........#
#####d#####
sign The brave are rewarded.

2
1
#####d#####
#.......#.#
#......#..#
#.........#
#.........#
#..........
#.........#
#.#.......#
#..#......#
#......#..#
#####.#####

1
1
###########
#.........#
#.........#
#..#.....##
#.........#
#..........
#..#..#...#
#.........#
#.........#
#..#.....##
#####d#####

1
3
###########
#.........#
##.#...#..#
#.........#
#.#.#.#...#
d.........#
#..#.#.#..#
#.........#
#...#.#.#.#
#.........#
#####.#####

2
2
#####.#####
#k........#
#.........#
#.........#
#.........#
...........
#.........#
#.........#
#.......#.#
#.........#
#####.#####
key : 4

6
0
#####.#####
#.........#
#...#..#..#
#.........#
#.........#
#....#....#
#.........#
#.........#
#...#..#..#
#.........#
###########

3
3
#####l#####
#.........#
#.........#
#....#....#
#..#.#....#
l..#.......
#.###.....#
#####.....#
##........#
#..#......#
#####.#####
locked : 4

4
1
#####l#####
#......#..#
#.#.......#
#.........#
#.........#
..........#
#.........#
#.........#
#.........#
#.........#
#####.#####

3
2
#####.#####
#.........#
#.....##..#
#.......#.#
#.........#
..........l
#...#.....#
#.........#
#.........#
#....k....#
###########
key : 3

1
2
#####.#####
#e........#
#.........#
#...#e#.#.#
#...###...#
...####...d
#...e#....#
#.###....##
#.........#
#.........#
#####.#####
enemies 3

5
1
#####.#####
#.........#
#..#......#
#.#.......#
#.........#
..........#
#.........#
#......#..#
#......#..#
#........k#
###########
key : 1

0
2
###########
#.........#
#.........#
#.........#
#.........#
#.........#
#.#.......#
#.##......#
#.##......#
#.........#
#####.#####

2
4
###########
#.........#
#.........#
#.........#
#.........#
d...#e#...#
#.........#
#...#.....#
#.........#
#.........#
#####.#####
boss
enemies 1

3
0
###########
#k........#
#.........#
#.........#
#.........#
#..........
#.........#
#.........#
#.........#
#.........#
#####.#####
key : 0

5
0
#####d#####
#.........#
#.........#
#.........#
#.........#
#..........
#.........#
#.........#
#.........#
#.........#
#####.#####

2
3
#####.#####
#..#......#
##........#
#.###.....#
#...##..#.#
......#...d
#.........#
#.........#
#.........#
#.........#
#####l#####
locked : 3

3
1
#####.#####
#.........#
#.........#
#.........#
#.........#
....#......
#...#.....#
#...#.....#
#.........#
#.........#
#####l#####
locked : 0

3
4
#####.#####
#.........#
#.....#.#.#
#.......###
#..#.#..#.#
.....#.#..#
#....###..#
#.........#
#.........#
#........X#
###########

