0
0
###########
#.........#
#.........#
#.........#
#.........#
#.........#
#.........#
#.........#
#.........#
#.........#
#####.#####

4
2
#####d#####
#.........#
#..#....#.#
#.#.......#
#.........#
#..........
#.........#
#.........#
#.........#
#.........#
#####l#####

6
2
#####.#####
#..#......#
#.........#
#.........#
#.....#...#
#.........#
#.........#
#..#..#..##
#.........#
#k........#
###########
key : 2

4
4
#####.#####
#.........#
#.........#
#...#..#..#
#.........#
..........#
#.#..#..#.#
#.........#
#.........#
#......#.k#
###########
key : 4

1
4
###########
#X........#
#.........#
#.........#
#.........#
#.........#
#.#.......#
#.........#
#.........#
#.........#
#####.#####

2
1
#####.#####
#.........#
#.........#
#.........#
#.........#
...........
#.........#
#.........#
##........#
#.........#
###########

2
3
###########
#.........#
#.........#
#.........#
#....#....#
....##.....
#....##...#
#.........#
#.........#
#.........#
#####.#####

1
1
###########
#.........#
#.........#
#..#...#.##
#.........#
....#.....d
#.........#
#....#.#.##
#.........#
#e#.....#e#
#####.#####
enemies 2

1
2
###########
#.........#
#.........#
#...#..##.#
#...#..##.#
d.........#
#...##.##.#
#....#.##.#
#.........#
#.........#
#####.#####

3
2
#####.#####
#.........#
#.........#
#.........#
#.........#
#.........d
#.........#
#.........#
#.........#
#.........#
#####d#####

5
2
#####l#####
#.......#.#
#.........#
#..#.#.#..#
#.........#
#...#.....#
#.........#
#..#.#.#.##
#.........#
#.#.......#
#####.#####
locked : 0

2
2
#####.#####
##.....#..#
#.........#
#.........#
#.#..#..#.#
...........
#.........#
#...#..#..#
#.........#
#.........#
#####.#####

3
5
###########
#.........#
##.#...#.##
#.........#
#.#.#...#.#
..........#
#..#.#.#..#
#.........#
#.#.#.#.#.#
#.........#
###########

2
0
#####.#####
#.#.......#
#.........#
#..#......#
#.........#
#..........
#.........#
#.........#
#...#.....#
#k........#
###########
key : 0

3
3
#####.#####
#.........#
#.........#
#.........#
#.........#
d.........l
#.........#
#.........#
#.........#
#.........#
#####.#####

4
3
#####.#####
#.........#
#......#..#
#.......#.#
#.........#
...........
#.........#
#.........#
#.........#
#....k....#
###########
key : 1

2
4
#####.#####
#.........#
#.....#.#.#
#.......#.#
#.......#.#
.....e....#
#.........#
#.........#
#.........#
#.........#
#####l#####
locked : 4
boss
enemies 1

1
0
#####.#####
#.......#?#
#.........#
#.........#
#....##...#
#....@.....
#.........#
#.........#
#.........#
#.........#
#####.#####
sign Something glints behind that door…

3
4
#####l#####
#.........#
#......#..#
#.......#.#
#.........#
l..........
#.........#
#.........#
#.........#
#.........#
#####.#####
locked : 1

