0
3
###########
#........e#
#.........#
#.........#
#.........#
D.........#
#.........#
#.........#
#.........#
#........?#
###########
enemies 1
sign The dungeon remembers all who enter.

2
1
#####l#####
#..#...#.##
#.........#
##.#...#.##
#.........#
D..#.#.#..D
#.........#
##.#.#...##
#.........#
#..#.....##
#####D#####

3
2
#####D#####
#.........#
#...#.#...#
#.........#
#.#e##....#
D..#e##..?#
#.....#...#
#.........#
#.........#
#.........#
#####D#####
enemies 2
sign Turn back; you are not yet ready.

2
2
#####D#####
#.........#
#.........#
#.........#
#.........#
D.........#
#.........#
#.#...#k#.#
#..#...#..#
#.........#
#####D#####
key : 1

1
2
#####d#####
#.........#
#..##.##..#
#..#..#...#
#.#.#.##..#
D....###..#
#..###.#..#
#.#k#.....#
#...#.....#
#.........#
#####D#####
key : 3

5
2
#####D#####
#.........#
#...#.#...#
#.........#
#.#...#.#.#
d.........D
#.#...#...#
#.........#
#.#.#.#.#.#
#.........#
###########

0
2
###########
#.........#
#...#..#..#
#.........#
#.........#
#....#....D
#.........#
#.........#
##..#..#..#
#.........#
#####d#####

6
0
#####l#####
#.........#
#.#...#.#.#
#.........#
#.#.#...#.#
#.........#
#.#.#.#.#.#
#.........#
#.#.#.#.#.#
#.........#
###########
locked : 3

1
1
###########
#.........#
#..#...#..#
#.#.....#.#
#.........#
#.........D
#.........#
#.#.......#
#..#......#
#.........#
#####l#####
locked : 1

3
0
#####D#####
#..#......#
#.........#
#.........#
#..#..#...#
#.........D
#.........#
#..#..#..##
#.........#
#.........#
#####l#####

3
1
#####D#####
#k........#
#...#...#.#
#.........#
#.#.#.....#
D.........D
#.#...#.#.#
#.........#
#...#.#.#.#
#.........#
#####D#####
key : 0

2
0
###########
#?........#
#.........#
#.....#...#
#.####....#
#..####...D
#.#.@##...#
#..#..#...#
#.........#
#.........#
#####D#####
sign Beware what lurks ahead.

5
0
#####D#####
#.........#
#..#...#..#
#.#.....#.#
#.........#
#.........D
#.........#
#.........#
#.........#
#.........#
#####l#####

5
1
#####D#####
#.........#
#.........#
#.........#
#.........#
D.........d
#.........#
#.........#
#.........#
#.........#
###########

4
2
#####D#####
#......#..#
#.........#
#.........#
#.#..#..#.#
l.........d
#.........#
##..#.....#
#.........#
#.........#
#####D#####
locked : 2

4
0
#####l#####
##.#...#.##
#.........#
#..#.#.#.##
#.........#
#..#.#.#..D
#.........#
#..#.....##
#.........#
#..#...#.##
#####D#####
locked : 0

4
3
###########
##........#
#.##......#
#.#..#....#
#.##.#....#
d....e....#
#.........#
#.........#
#.........#
#.........#
#####D#####
boss
enemies 1

4
1
#####D#####
#k........#
#.........#
#....#....#
#.........#
D.........l
#.........#
#.#.....#.#
#..#...#..#
#.........#
#####D#####
key : 2

5
3
#####D#####
#.........#
#...#.....#
#..#.##...#
#....###..#
D.....##..#
#.........#
#.........#
#.........#
#........X#
###########

