3
1
#####D#####
##.#...#.##
#.........#
#.#.#.#...#
#.........#
l..#......d
#.........#
#.#.#...#.#
#.........#
#..#.....##
###########
locked : 3

3
0
#####D#####
#.........#
#..#......#
#k#.......#
#.........#
#...#.#...l
#.........#
#.#.......#
#.........#
#.........#
#####D#####
key : 1

7
3
###########
#.........#
#.........#
#.........#
#.........#
d.........#
#.........#
#..p......#
#.........#
#.......p.#
###########

7
1
###########
#.#.....#.#
#.........#
#.#.#.#.#.#
#.........#
D...#.#...D
#.........#
#.#...#.#.#
#.........#
#.#.....#.#
#####d#####

7
2
#####D#####
##........#
#.........#
#.........#
#......#..#
D.........d
#.........#
##..#..#..#
#.........#
#k........#
#####d#####
key : 4

0
1
###########
#X........#
#.#.#.....#
#.##......#
#.##......#
#...#.#...#
#..###....#
#.#..##...#
#.#.#.#...#
#.........#
#####D#####

2
1
#####l#####
#.........#
#.#.#...#.#
#.........#
#...#.#.#e#
D.....e...#
#.#...#...#
#.........#
#.#.#.#.#.#
#.........#
#####D#####
enemies 2

5
1
###########
#.........#
#..#......#
#.#.......#
#.........#
D.........D
#.........#
#.#.......#
#..#......#
#.........#
###########

4
0
#####D#####
#.........#
#.........#
#.........#
#.........#
#.........#
#.........#
#.........#
#.........#
#.........#
#####D#####

2
0
###########
#k........#
#..#...#..#
#.#.....#.#
#.........#
#.........D
#.........#
#.........#
#.........#
#.........#
#####D#####
key : 3

6
0
#####D#####
#.........#
#..#......#
#.#.......#
#.........#
#.........#
#.........#
#.........#
#.........#
#.........#
#####D#####

6
2
#####D#####
#.........#
#.........#
#.........#
#...###...#
#...#k#...#
#...#.....#
#.........#
#.........#
#.........#
#####D#####
key : 5

7
0
#####D#####
###.......#
##........#
#.........#
#.........#
#.........D
#.........#
#.........#
#.........#
#.........#
###########

5
0
#####D#####
#.........#
#.........#
#.........#
#.........#
#....@....D
#.........#
#.........#
#.........#
#.........#
#####D#####

1
1
#####D#####
#.........#
#.........#
#.........#
#...e.....#
#..#.#....#
#...#.....#
#...#.....#
#..#...#..#
#........##
#####l#####
locked : 5
boss
enemies 1

5
2
###########
#.........#
#.........#
#.........#
#.........#
D.........#
#.........#
#.........#
#.........#
#.........#
#####D#####

8
2
#####d#####
#.........#
#.........#
#..#......#
#.........#
D.........#
#....#....#
#.#.......#
#..#..#...#
#.........#
###########

3
2
###########
#.........#
#..#...#..#
#.#.#...#.#
#.........#
d.........#
#.#.......#
#.#.......#
#..#......#
#.........#
###########

8
1
#####d#####
#.........#
#.........#
#.........#
#.........#
#.........D
#.........#
#.........#
#.........#
#.........#
###########

