2
5
###########
#.........#
#.........#
#.........#
#.........#
d...#e.#..#
#...##..#.#
#.......#.#
#...#..#..#
#.........#
#####D#####
boss
enemies 1

4
3
#####D#####
#.........#
#.........#
#.........#
#.........#
#.........#
#.........#
#.........#
#.........#
#k........#
###########
key : 2

3
1
#####D#####
#e.......e#
##.#...#.##
#.........#
#.#.#.#.#s#
D.........#
#..#.#.#..#
#.........#
#.....#.#.#
#.........#
#####D#####
enemies 2
switch 0 : 0

3
5
#####D#####
##........#
####......#
###..#....#
#.###.....#
#....#....#
#.........#
#.........#
#.........#
#X........#
###########

2
1
#####D#####
#k#.....#.#
#.........#
#...#.#...#
#.........#
D...#.#...d
#.........#
#.#...#.#.#
#.........#
#.#.....#.#
#####D#####
key : 1

2
2
###########
#.......#.#
#.........#
#..#.#.#.##
#.........#
d.....#...D
#.........#
#..#.#.#..#
#.........#
#.#.....#.#
###########

1
4
###########
#........k#
#.........#
#.........#
#.........#
D.........#
#.........#
#.#.......#
#..#......#
#.........#
#####D#####
key : 3

1
3
###########
#.........#
#.........#
##..#..#..#
#.........#
#.........D
#...#..#..#
#.........#
#.........#
##.....#..#
#####D#####

2
3
#####D#####
#.........#
#.......#.#
#....#e#?##
#....###..#
D......#..l
#.........#
#.........#
#.........#
#.........#
#####d#####
enemies 1
sign Seek the matching key before you proceed.

3
3
#####d#####
#.........#
#.........#
#.........#
#.........#
#.........#
#.........#
#.........#
#.........#
#.........#
#####D#####

2
0
#####D#####
#.........#
#......#..#
#.......#.#
#.........#
#k........D
#.........#
#.........#
#.........#
#.........#
#####d#####
key : 0

2
4
#####D#####
#.........#
#.......#.#
#.........#
#.........#
l..#..#...d
#.........#
#.........#
#.#.......#
#.........#
###########
locked : 1

1
1
#####D#####
#.........#
#.........#
#......#..#
#.....#...#
D.....#...#
#....#....#
#.....#...#
#.........#
#.........#
#####D#####

3
0
#####d#####
##........#
#.........#
#.........#
#.#..#..#.#
#.........D
#.........#
#...#..#..#
#.........#
#.........#
###########

1
0
###########
#?........#
###.#.....#
##.##.....#
#...@#....#
#....#....D
#.##......#
#.........#
#.........#
#.........#
#####D#####
sign The brave are rewarded.

0
1
###########
#.........#
#..##.....#
#........##
#...###.#.#
#...#.##..#
#.###..##.#
#...#...#.#
#.....#...#
#.........#
#####D#####

4
1
#####D#####
#.........#
#.........#
#.........#
#.........#
#.........#
#.........#
#.........#
#.........#
#.........#
#####D#####

5
1
#####D#####
#e........#
##........#
#..###....#
#e####....#
#.e#...p..#
#....#...?#
#........p#
#.........#
#.........#
#####D#####
enemies 3
sign Many have walked this path.

6
1
#####D#####
#.........#
#.........#
#.........#
#...#.##..#
#...####..#
#....###..#
#.....#.#.#
#...#.#.#.#
#e........#
###########
enemies 1
door 0 : 0

