1
2
#####.#####
#.##......#
#...#.##..#
#...#...#.#
#...e.#.#.#
.....#.#..#
#.......#.#
#.........#
#.........#
#.........#
#####l#####
locked : 1
boss
enemies 1

6
2
#####.#####
#........##
#..#......#
#.#.......#
#.........#
...........
#.........#
#.........#
#.........#
#.........#
#####.#####

4
0
###########
#.........#
#..##.....#
##........#
#.###.....#
#..##......
#.##......#
#.........#
#.........#
#.........#
#####.#####

5
1
#####.#####
#e.......e#
#.........#
#.........#
#.........#
...........
#.........#
#.........#
#.........#
#e.......?#
#####d#####
enemies 3
sign The dungeon remembers all who enter.

5
2
#####.#####
#.........#
#......#..#
#.........#
#.........#
..........#
#.........#
#.......#.#
#......#..#
#.........#
#####.#####

3
1
#####d#####
#.........#
#.........#
#..#..#..##
#.........#
#k.........
#...#.....#
#.........#
#.........#
#..#.....##
#####.#####
key : 1

2
1
#####.#####
#.........#
#..#......#
#.#.......#
#.........#
#.........d
#.........#
#.#.......#
#..#......#
#.........#
#####d#####

1
1
###########
#e........#
#e........#
#.........#
#.........#
#..###.....
#e###.....#
######....#
#.###.....#
#.........#
#####.#####
enemies 3

3
2
#####.#####
#.........#
#.........#
#.........#
#.....##..#
...###k#..#
#......#..#
#.......###
#.....#..##
#.........#
#####.#####
key : 3

4
2
#####.#####
#.#.......#
#.##..#...#
#.#####...#
#..#.##...#
d..#.##...#
#.........#
#.........#
#.........#
#.........#
#####.#####

7
1
#####.#####
#.........#
#.........#
#.........#
#.........#
#..........
#.........#
#.......#.#
#......#..#
#.........#
###########

0
2
###########
#X........#
#.........#
#.........#
#.........#
#..#.#....#
#...#.....#
####......#
#.........#
####......#
#####.#####

4
1
#####.#####
#e.......e#
#.#.....#.#
#.........#
#.#.#.#.#.#
..........d
#.....#.#.#
#.........#
#.#...#...#
#e........#
#####.#####
enemies 3

7
2
#####.#####
#.........#
#..#......#
#.#.......#
#.#.......#
..........#
#.........#
#.#.......#
#..#......#
#........k#
###########
key : 5

6
3
###########
##.#...#..#
#.........#
#..#.#.#.##
#.........#
...#.#.#..#
#.........#
#..#.#.#.##
#.........#
##.#...#k##
###########
key : 4

6
0
#####.#####
#.........#
#.....#...#
#...##....#
#...#.....#
#....@.....
#.........#
#.....#...#
#.........#
#?........#
###########
sign Beware what lurks ahead.

6
1
#####d#####
#.........#
#.........#
#.........#
#.........#
...........
#.........#
#.........#
#.........#
#.........#
#####.#####

5
0
#####.#####
#.........#
#...#...#.#
#...e#....#
#...##..#.#
#....e#....
#....##.#.#
#.........#
#.........#
#.........#
#####.#####
enemies 2

2
2
#####l#####
#.........#
#.........#
#.........#
#.........#
d.........#
#.........#
#.........#
#.........#
#.........#
#####.#####

