2
0
#####d#####
#.........#
#......#..#
#.......#k#
#.........#
#.........#
#.........#
#.........#
#.......#.#
#.........#
#####D#####
key : 2

4
3
###########
#.........#
#.........#
#.........#
#.........#
D.........#
#.#.......#
#.........#
#.........#
#.........#
#####d#####

5
2
#####D#####
#.........#
#.........#
#...#..#..#
#.........#
D.........d
#.#..#....#
#.........#
#.........#
##.....#..#
#####d#####

4
2
#####D#####
#.........#
#.........#
#.........#
#.........#
D.........D
#.........#
#.........#
#.........#
#.........#
#####D#####

0
0
###########
#e.......?#
#.#.....#.#
#.........#
#.........#
#..#..#...#
#.........#
#.........#
#.#.....#.#
#.........#
#####D#####
enemies 1
sign Beware what lurks ahead.

6
3
#####l#####
#.........#
#..#..#..##
#.........#
#.........#
D......#..l
#.........#
#.........#
#........##
#.........#
###########
locked : 1

5
1
#####D#####
##.....#?##
#.........#
#.#.#.#.#.#
#.........#
D....#....D
#.........#
#.#.#.#.#.#
#.........#
##e#...#.##
#####D#####
enemies 1
sign What you seek is close.

6
1
#####D#####
#k........#
##.....#..#
#.........#
#.........#
D...#.....D
#.........#
#.........#
##..#..#..#
#.........#
###########
key : 1

4
1
###########
#.........#
#.........#
#.#..#....#
#.........#
D.........D
#....#..#.#
#.........#
#.........#
#.#.....#.#
#####D#####

3
0
#####D#####
#..p......#
#.........#
#...#.#...#
#...#.#...#
#..##.##..#
#..##.##..#
#..#####..#
#.........#
#.........#
#####D#####

6
0
#####D#####
#.........#
#.........#
#.........#
#.........#
#.........D
#.........#
#.#.....#.#
#..#...#..#
#k........#
###########
key : 0

5
0
#####l#####
#.#.......#
#.###.....#
#..#......#
#..###....#
#..#@#....D
#.........#
#.........#
#.........#
#.........#
#####D#####

5
3
#####d#####
#.#.....#.#
#.........#
#....#.#..#
#.........#
d...#.#...#
#.........#
#..#.#.#.##
#.........#
#.#.....#.#
#####l#####

3
2
###########
#k........#
#..#......#
#.........#
#.........#
#......#..#
#.........#
#.........#
#..#..#..##
#.........#
#####D#####
key : 3

4
0
#####D#####
#.........#
#.........#
#.#.....#.#
#.........#
#.........D
#..#..#...#
#.........#
#.........#
#.#.....#.#
#####l#####
locked : 0

7
4
#####D#####
#.........#
#..##.#...#
#.#.#.....#
#.#.......#
#..##.#...#
#.........#
#.........#
#.........#
#X........#
###########

6
4
###########
#........p#
#.........#
#....###..#
#...e.#...#
l....p....#
#.........#
#.........#
#.........#
#.........#
#####D#####
locked : 3
boss
enemies 1

6
2
#####d#####
####......#
##........#
#.####....#
#.#.......#
D....#....D
#.........#
#.........#
#.........#
#.........#
###########

1
0
#####D#####
##.....#..#
#.........#
#.........#
#...#.....#
#.........#
#.........#
##..#..#..#
#.........#
#.........#
#####d#####

