4
3
#####.#####
#.........#
#.........#
#.........#
#.........#
....#.....l
#.###.....#
#k#.......#
###.......#
###.......#
#####.#####
key : 4

5
1
#####.#####
#........##
#.........#
#.........#
#.........#
...........
#.........#
#.......#.#
#......#..#
#.........#
###########

5
0
#####.#####
#.........#
#..#......#
#k#.......#
#.........#
#..........
#.........#
#.#.......#
#..#......#
#.........#
#####.#####
key : 1

2
5
###########
#.........#
#.........#
#.........#
#.........#
d.........#
#.........#
#.........#
#.........#
#.........#
#####.#####

4
2
#####d#####
#k........#
#.........#
#........##
#.........#
...........
#......#..#
#.........#
#.........#
#..#.....##
#####.#####
key : 2

3
5
#####.#####
#.........#
##.#...#.##
#.........#
#.....#.#.#
..........#
#..#...#..#
#.........#
#.#.#.....#
#.........#
###########

3
3
###########
#.....e..?#
#..#..#..##
#.........#
#.........#
....#..#...
#.........#
#.........#
#..#..#...#
#.........#
#####.#####
enemies 1
sign The brave are rewarded.

5
3
#####.#####
#.........#
#.........#
#.........#
#.........#
..........#
#.........#
#.........#
#........e#
#......?ee#
###########
enemies 3
sign The brave are rewarded.

2
4
#####l#####
##.....#..#
#.........#
#.........#
#.#..#..#.#
#.........d
#.........#
##..#..#..#
#.........#
#.........#
#####d#####

6
0
#####.#####
#.........#
#.#.#.#...#
#.........#
#..#.#....#
#.........#
#...#.#.#.#
#.........#
#..#...#.##
#.........#
###########

3
1
###########
#.........#
##.....#.##
#.........#
#.#.#...#.#
#..........
#..#.#.#..#
#.........#
#...#.#.#.#
#.........#
#####d#####

0
4
###########
#.......#X#
#.....##..#
#.....###.#
#...#..##.#
#..#.#....#
#......#..#
#.........#
#.........#
#.........#
#####.#####

3
4
#####d#####
###....#.##
#e###..#..#
#.####.#..#
#..##.#...#
....#......
#.........#
#.........#
#.........#
#.........#
#####.#####
enemies 1

4
1
#####d#####
#k........#
#..##.....#
#.........#
#......#..#
...........
#.........#
#.......#.#
#......#..#
#.........#
#####.#####
key : 0

4
0
###########
#?.#......#
##.#......#
##.#......#
#.........#
#..##@.....
#...#.....#
##.##.....#
##..#.....#
#.........#
#####.#####
sign The brave are rewarded.

5
2
#####.#####
#.........#
#.........#
#....##...#
#...##....#
....##.....
#...#.....#
#....#....#
#.........#
#.........#
###########

1
4
#####.#####
#.#.......#
#...#...#.#
#.#####..##
#.#...###.#
#....e....#
#.........#
#.........#
#.........#
#.........#
#####l#####
locked : 1
boss
enemies 1

4
4
#####.#####
##.#......#
#..##.#...#
##.###....#
#.........#
l..##.....#
#.........#
#.........#
#.........#
#.........#
###########
locked : 4

3
2
###########
#.........#
#.........#
#.........#
#.........#
...........
#.........#
#......##.#
#......#..#
#.........#
#####d#####

