3
1
###########
#.........#
#.........#
#.........#
#.........#
#...#.....D
#.###.....#
#.#.......#
###.......#
###.......#
#####d#####

6
0
#####D#####
#........##
#.........#
#.........#
#.........#
#.........#
#.........#
#.......#.#
#......#..#
#.........#
###########

5
0
#####D#####
#.........#
#..#......#
#k#.......#
#.........#
#.........D
#.........#
#.#.......#
#..#......#
#.........#
#####D#####
key : 1

3
5
#####D#####
#.........#
#.........#
#.........#
#.........#
D.........#
#.........#
#.........#
#.........#
#.........#
###########

2
5
###########
#.........#
#.........#
#........##
#.........#
d.........#
#......#..#
#.........#
#.........#
#..#.....##
#####D#####

4
4
#####D#####
#.........#
##.#...#.##
#.........#
#.....#.#.#
l.........#
#..#...#..#
#.........#
#.#.#.....#
#.........#
###########
locked : 4

3
3
###########
#.....e..?#
#..#..#..##
#.........#
#.........#
D...#..#..D
#.........#
#.........#
#..#..#...#
#.........#
#####D#####
enemies 1
sign The brave are rewarded.

3
2
###########
#.........#
#.........#
#.........#
#.........#
D.........D
#.........#
#.........#
#.........#
#.........#
#####d#####

4
2
#####d#####
##.....#..#
#.........#
#.........#
#.#..#..#.#
D.........D
#.........#
##..#..#..#
#.........#
#k........#
#####D#####
key : 2

4
3
#####D#####
#.........#
#.#.#.#...#
#.........#
#..#.#....#
D.........l
#...#.#.#.#
#.........#
#..#...#.##
#........k#
#####D#####
key : 4

0
4
###########
#X........#
#.....#...#
#.........#
#....##...#
#.........#
#.........#
#.........#
#.........#
#.........#
#####D#####

3
4
#####d#####
#.........#
#.#.#.#.#.#
#.........#
#..#.#.#..#
D.........D
#...#...#.#
#.........#
#..#...#.##
#........e#
#####D#####
enemies 1

2
4
#####l#####
#.........#
#......#..#
#.......#.#
#.........#
#.........d
#.........#
#.#.......#
#..#......#
#.........#
#####d#####

5
2
#####D#####
#.........#
#.........#
#.........#
#.........#
D.........D
#.........#
#.......#.#
#......#..#
#.........#
###########

4
1
#####d#####
#k........#
#.........#
#..#..#..##
#.........#
D.........D
#..#......#
#.........#
#.........#
#..#.....##
#####D#####
key : 0

5
1
#####D#####
#.........#
#.........#
#.........#
#.........#
D.........D
#.........#
#.........#
#.........#
#.........#
###########

5
3
#####D#####
#.#.....#.#
#.........#
#..#.#...##
#.........#
D.....#...#
#........?#
#..#.....##
#........e#
#.#....e#e#
###########
enemies 3
sign The brave are rewarded.

4
0
###########
#.........#
#?#p#.....#
##.##.....#
#..##p....#
#....@.#..D
#.###..#..#
#....###..#
#.........#
#.........#
#####D#####
sign The brave are rewarded.

1
4
#####D#####
#.........#
#.........#
#.........#
#.#####...#
#..###....#
#...e#.#..#
##...#....#
#.........#
#.........#
#####l#####
locked : 1
boss
enemies 1

