5
3
#####D#####
#.........#
#.........#
#.........#
#.....p...#
#.........#
#.........#
#.........#
#.........#
#X........#
###########

5
0
#####D#####
#.........#
#..#......#
##.##.#...#
#.#####...#
#.....#...D
#.........#
#.........#
#.........#
#.........#
#####D#####

3
1
#####D#####
#.........#
##..#.....#
#.........#
#.........#
l....#....d
#.........#
#.........#
#...#..#..#
#.........#
#####D#####
locked : 0

2
0
#####D#####
##........#
##.#......#
#e........#
#.........#
#s........d
#.........#
#.........#
#.........#
#.........#
#####D#####
enemies 1
switch 0 : 0

3
2
#####D#####
#.........#
#.........#
#.........#
#.........#
d.........#
#.........#
#.......#.#
#......#..#
#.........#
#####l#####

1
2
###########
#.........#
##..#..#..#
#.........#
#.........#
d...#.....D
#.........#
#.........#
##..#..#..#
#.........#
#####D#####

4
3
###########
#.........#
#.........#
#.........#
#.........#
d....e....#
#.........#
#.........#
#.........#
#.........#
#####D#####
boss
enemies 1

1
0
###########
#e........#
#.........#
#.........#
#.........#
#.........D
#.........#
#.........#
#.........#
#.........#
#####D#####
enemies 1
door 0 : 0

0
1
###########
#k........#
#......#..#
#.....#.#.#
#.........#
#.........#
#.........#
#.#.......#
#..#......#
#.........#
#####D#####
key : 4

1
1
#####D#####
#.........#
#.........#
#.........#
#.........#
D.....##..d
#......#..#
#....##...#
#.........#
#.........#
#####D#####

1
3
###########
#........k#
##.....#.##
#.........#
#..#.#....#
D.........#
#..#...#..#
#.........#
##.....#.##
#.........#
###########
key : 6

3
0
#####D#####
#.........#
#.........#
#.........#
#.........#
#....##...l
#....###..#
#....####.#
#.......k##
#......####
#####D#####
key : 0

4
2
#####l#####
#.#.......#
#.........#
#..#.#...##
#.........#
D...#.....d
#.........#
#..#.#...##
#.........#
#.#.....#.#
###########
locked : 1

2
1
#####D#####
#.........#
#.........#
#.........#
#...#.#.#.#
d.....##..D
#.....#...#
#.........#
#.........#
#.........#
#####D#####

5
1
#####D#####
#.........#
#..#..#..##
#.........#
#.........#
D..#..#...#
#.........#
#.........#
#..#..#..##
#........e#
###########
enemies 1

4
1
#####D#####
#.##...p..#
#.....#...#
#.#.##....#
#..#.#....#
D..#......D
#..##.##..#
#..#.#....#
#..#..##..#
#.........#
#####D#####

4
0
#####D#####
#.........#
#.........#
#...#.....#
#.........#
#?...@....D
#.........#
#.........#
#.........#
#.........#
#####D#####
sign A useful tool lies just ahead.

2
2
#####D#####
#k........#
##........#
#.........#
#.#...#...#
D.........#
#....#....#
#.........#
#.#.#.#.#.#
#.........#
#####D#####
key : 1

6
0
#####D#####
#.........#
#.........#
#.........#
#.........#
#.........#
#.........#
#..p......#
#.........#
#.p.......#
###########

