2
0
#####D#####
#.........#
##..#..#..#
#.........#
#.........#
#....#....D
#.........#
#.........#
##..#..#..#
#.........#
#####l#####

0
2
###########
#.#....e#e#
#.......e.#
#.#.#.#.#s#
#.........#
D...#.#...#
#.........#
#.#.#.#.#.#
#.........#
#.......#.#
#####D#####
enemies 3
switch 0 : 0

0
0
###########
#k........#
##.#.....##
#.........#
#.#.#.#...#
#.........D
#..#.#.#..#
#.........#
#.#...#...#
#.........#
#####D#####
key : 0

0
1
###########
#......k..#
#......#..#
#.......#.#
#.........#
D.........D
#.........#
#.#.......#
#..#......#
#.........#
#####D#####
key : 1

4
1
#####d#####
#.........#
#.........#
#.........#
#.........#
D.........D
#.........#
#.......#.#
#......#..#
#.........#
#####d#####

3
2
#####D#####
#.........#
#..##..#..#
#.#.#...#.#
#.........#
D.........D
#.........#
#.........#
#.........#
#.........#
#####D#####

3
0
#####l#####
#.........#
#..#......#
#.#.......#
#.....#...#
#...#.....l
#.........#
#.#.....#.#
#..#...#..#
##........#
#####d#####
locked : 0

2
2
#####D#####
#.........#
#.........#
#...#.#...#
#...#.....#
l...e##...#
#.........#
#.........#
#.........#
#.........#
#####D#####
locked : 2
boss
enemies 1

1
1
#####D#####
#.#.....#.#
#.........#
#.#...#.#.#
#.........#
D...#.#...D
#.........#
#.#...#.#.#
#.........#
#.......#.#
#####D#####

4
0
#####d#####
#.........#
#...#.....#
#...###...#
#....#.#..#
#......#..D
#..#.##...#
#.........#
#.........#
#.........#
#####d#####

4
2
#####D#####
#.........#
#.........#
#.........#
#.........#
D.........D
#.........#
#........##
#......#..#
#......k..#
###########
key : 2

3
3
###########
#......?ee#
#........e#
#....p....#
#.........#
D.........#
#.........#
#.........#
#.........#
#.........#
#####D#####
enemies 3
door 0 : 0
sign Something glints behind that door…

4
3
#####D#####
#.........#
#.........#
#.........#
#.........#
D.........#
#.........#
#.#.......#
#..#......#
#........k#
###########
key : 3

1
2
#####D#####
#.........#
#.......p.#
#...#####.#
#...####..#
D....##X..#
#.....###.#
#...#..#..#
#.........#
#.........#
#####D#####

5
1
#####d#####
#.........#
#.....#.#.#
#.......#.#
#.....#...#
D.........#
#.#.......#
##.#......#
##........#
#.........#
###########

5
0
#####d#####
#.........#
#.........#
#.........#
#.........#
#.........D
#.........#
#.........#
#.........#
#.........#
###########

2
1
#####D#####
#.........#
#.........#
#.........#
#.........#
D.........l
#..##.....#
#..##.....#
#.........#
#.........#
#####D#####

1
0
#####D#####
#.........#
#.........#
#.........#
#.........#
#..##@....D
#..###....#
#..##.....#
#..##.....#
#.........#
#####D#####

3
1
#####D#####
#.........#
#......#..#
#.......#.#
#.........#
l.........D
#.........#
#.#.....#.#
#..#...#..#
#.........#
#####d#####
locked : 1

