2
3
#####.#####
#.........#
#.........#
#..#..#...#
#.........#
.........k#
#..#..#...#
#.........#
#.........#
#........##
#####.#####
key : 2

4
2
#####l#####
#.........#
#.........#
#....#....#
#....##...#
#...#.#....
#.........#
#.........#
#.........#
#.........#
#####l#####
locked : 0

3
4
###########
#.......ee#
#.........#
##..#..#..#
#.........#
..........#
#...#.....#
#.........#
#.........#
##.......e#
###########
enemies 3
door 0 : 0

5
2
#####l#####
#.........#
#.........#
#.........#
#.........#
#.........d
#.####....#
##.###....#
#..##.....#
#.........#
#####.#####
locked : 2

2
1
#####.#####
#.........#
#.........#
#..#..#..##
#.........#
...........
#...#..#..#
#.........#
#.........#
#........##
#####.#####

0
1
###########
#k........#
#......#..#
#.......#.#
#.........#
#.........#
#.........#
#.........#
#.........#
#.........#
#####.#####
key : 0

2
0
###########
#?.....##.#
#.........#
#.....###.#
#.........#
#....@.....
#.........#
#.........#
#.........#
#.........#
#####.#####
sign The dungeon remembers all who enter.

3
2
#####.#####
#.........#
#.........#
#.........#
#..###....#
...#.......
#.#####...#
##..##.#..#
#..#......#
#.........#
#####l#####

1
1
#####.#####
#s........#
#.........#
#.........#
#?........#
#e........d
#.........#
#.........#
#.........#
#.........#
#####.#####
enemies 1
switch 0 : 0
sign The brave are rewarded.

6
3
#####.#####
#.........#
#.........#
#.........#
#.........#
..........#
#......#..#
#.........#
#.........#
#........X#
###########

1
3
###########
#........k#
#.......#.#
#....#.##.#
#......##.#
......##..#
#.......#.#
#.........#
#.........#
#.........#
#####.#####
key : 1

6
2
#####.#####
#.........#
#.........#
#...#.###.#
#.....###.#
#....#.#...
#...##.##.#
#...#.....#
#.........#
#k........#
###########
key : 3

4
3
#####.#####
#e.......?#
#.........#
#.........#
#.........#
.........e#
#.........#
#.........#
#.........#
#e........#
#####.#####
enemies 3
sign A locked path — look elsewhere first.

1
2
###########
#.#.....#.#
#.........#
#..#.#.#.##
#.........#
d...#.#....
#.........#
#..#.#.#.##
#.........#
#.#.......#
#####d#####

3
0
#####.#####
#.........#
#.........#
#.........#
#.........#
#.........d
#.#.......#
#.#.......#
#..#......#
#.........#
###########

3
3
#####.#####
#.#.......#
#...#.....#
#.........#
#.........#
...........
#.....#...#
#.#.....#.#
#..#...#..#
#.........#
#####.#####

3
1
#####.#####
##.....#..#
#.........#
#.........#
#...#..#..#
d..........
#.........#
##..#..#..#
#.........#
#.........#
###########

5
3
#####.#####
#..#......#
##.##.....#
#.........#
#.#.#.....#
d..##e....#
#.###.....#
#.##.#....#
##........#
#.........#
#####.#####
boss
enemies 1

2
2
#####d#####
#.........#
#.........#
#.........#
#.........#
...........
#.........#
#.........#
#.........#
#.........#
#####.#####

