2
0
#####d#####
#.........#
#..#..##..#
#.#.....#.#
#.........#
#.........D
#.........#
#.........#
#.........#
#.........#
#####l#####
locked : 0

1
2
###########
#.#.......#
#.##......#
#.#...#...#
#.#.##....#
d...#e....#
#.........#
#.........#
#.........#
#.........#
#####D#####
boss
enemies 1

0
1
###########
#.........#
#.........#
#.........#
#.........#
#.........#
#.........#
#.........#
#.........#
#.........#
#####D#####

5
1
#####D#####
#.........#
#.........#
#.#..#..#.#
#.........#
D.........#
#..#......#
#.........#
#.........#
#.#.....#.#
#####D#####

7
0
#####D#####
#.........#
#.........#
#.........#
#.........#
#.........D
#.........#
#.........#
#.........#
#k........#
###########
key : 4

6
1
#####D#####
#.........#
#.........#
#.........#
#.........#
d.........D
#.........#
#.......#.#
#......#..#
#.........#
#####l#####

4
0
#####D#####
#.........#
#.........#
#.........#
#.........#
#..##@....D
#.#.......#
#.##......#
#.........#
#.........#
#####D#####

3
2
#####D#####
#..#......#
#.#.......#
#..#......#
#..#.#....#
D..#......#
#.........#
#.........#
#.........#
#........k#
###########
key : 3

7
1
#####l#####
#.#.....#.#
#.........#
#.........#
#..#......#
D.........#
#.........#
#.#..#..#.#
#.........#
#.........#
###########
locked : 4

3
0
#####l#####
#.........#
#.........#
#...#.....#
#.#.......#
#.e###....D
#.##.#....#
#....#....#
##..#.....#
#.........#
#####D#####
enemies 1

6
0
#####D#####
#k........#
##.#......#
#.........#
#....#....#
#.........d
#..#.#.#..#
#.........#
##.#...#.##
#.........#
#####D#####
key : 1

1
1
#####D#####
#.#.......#
#..##.....#
#.######..#
#.###.....#
D....#....d
#..##.#...#
#...#.....#
#.........#
#.........#
#####d#####

5
0
#####D#####
#.........#
#..#......#
#.#.......#
#.........#
#.........D
#.........#
#.........#
#.........#
#.........#
#####D#####

4
1
#####D#####
#.........#
##........#
#.........#
#.........#
D...#.....#
#.........#
#.........#
##..#..#..#
#.........#
#####D#####

3
1
#####D#####
#k........#
#..#...#..#
#.#.....#.#
#.........#
D.........D
#.#...#...#
#.........#
#.........#
#.........#
#####D#####
key : 0

1
0
###########
#.........#
##.#...#.##
#.........#
#..#.#.#..#
#.........D
#..#.#.#..#
#.........#
##.#...#.##
#.........#
#####d#####

6
2
###########
#.......ee#
#.........#
#.........#
#.........#
D.........#
#.........#
#.........#
#.........#
#........e#
###########
enemies 3

2
1
#####d#####
#.........#
#.........#
#...#..#..#
#.........#
D.........D
#....#..#.#
#.........#
#.........#
##.....#..#
#####D#####

2
2
#####D#####
#.........#
#.....##.##
#......##X#
#.......#.#
D.........#
#.....##..#
#.....#...#
#.....##..#
#.........#
#####D#####

