1
3
#####d#####
#.........#
##.#.....##
#.........#
#...#...#.#
d.........#
#..#.#.#..#
#.........#
#.#.#...#.#
#.........#
#####.#####

3
2
#####.#####
#.........#
#.....##..#
#....####.#
#......#..#
#....#.#...
#.....###.#
#.........#
#e........#
#ee.......#
###########
enemies 3

2
1
###########
#e...e....#
#.........#
#.........#
#.........#
...........
#.........#
#.........#
#.........#
#....e....#
###########
enemies 3

4
3
#####.#####
#.........#
#..#......#
#k#.......#
#.........#
#..........
#.........#
#.........#
#.........#
#.........#
#####d#####
key : 2

3
4
###########
#........k#
#.........#
#...#.....#
#...#.....#
....###...#
#.........#
#.........#
#.........#
#.........#
#####.#####
key : 3

6
3
#####d#####
#.........#
#.........#
#.........#
#.........#
#.........l
#.........#
#.........#
#.........#
#.........#
###########

2
2
#####l#####
#.........#
#..#.....##
#.........#
#.#.#.#.#.#
...........
#..#.#.#..#
#.........#
#.#.#.#...#
#.........#
#####.#####

2
3
#####.#####
#.........#
#..#......#
#.#.......#
#.........#
.........k#
#.........#
#.........#
#.........#
#.........#
#####.#####
key : 4

5
3
#####d#####
#.........#
#..#......#
#.#.......#
#.........#
#.........#
#.........#
#.#.......#
#..#......#
#.........#
#####d#####

1
0
###########
#k........#
#..#...#..#
#..#.###..#
#...#.##..#
#.........#
#.........#
#.........#
#.........#
#.........#
#####.#####
key : 0

7
4
#####.#####
#.........#
#.........#
#...#####.#
#...#.....#
#...####..#
#...#.##..#
#.....###.#
#.........#
#X........#
###########

2
0
#####.#####
#.........#
#.........#
#.........#
#..#......#
#?...@#....
#.........#
#.........#
#.#...#...#
#.........#
#####.#####
sign The torches flicker in a sourceless wind.

4
4
#####.#####
#.........#
#.........#
#.........#
#.........#
..........#
#.........#
#.........#
#.........#
#.......ee#
###########
enemies 2

3
0
#####.#####
#......#..#
#......#..#
#.......#.#
#.........#
#.........#
#.........#
#.........#
#.........#
#.........#
###########

1
2
#####.#####
#.........#
#.........#
#..###....#
#.#.#.....#
#.....#...d
#.#.##....#
#.#.#.#...#
#........##
#.........#
#####l#####
locked : 0

6
4
###########
#..#......#
#..#..#.#.#
#.....##..#
#...e.#.#.#
l....#....#
#.......#.#
#.....###.#
#.........#
#.........#
#####.#####
locked : 2
boss
enemies 1

3
3
#####.#####
#.........#
#.........#
#.........#
#.........#
...........
#.........#
#.........#
#.........#
#.........#
#####.#####

0
2
###########
#.........#
#.......#.#
#.........#
#..###....#
#....##....
#...##....#
#..#.##...#
#.#.......#
#.........#
#####.#####

0
3
###########
#.........#
#..#......#
#.#.......#
#.........#
..........#
#.........#
#.......#.#
#......#..#
#.........#
#####d#####

