2
2
#####l#####
#.........#
##.#.....##
#.........#
#...#...#.#
D.........D
#..#.#.#..#
#.........#
#.#.#...#.#
#.........#
#####D#####

2
0
#####D#####
#.........#
#.###..p..#
#?####....#
#...#.#...#
#...#@#...D
#.........#
#.........#
#.........#
#.........#
#####D#####
sign The torches flicker in a sourceless wind.

3
3
#####D#####
#.........#
#..#......#
#.#.......#
#.........#
D.........D
#.........#
#.........#
#.........#
#.........#
#####D#####

0
3
###########
#.........#
##.#...#.##
#.........#
#.#...#...#
D.........#
#..#...#..#
#.........#
#.#.#.#.#.#
#.........#
#####d#####

3
4
###########
#........k#
#.#...#.#.#
#.........#
#.#.#.#...#
D.........#
#.#.#.#...#
#.........#
#.#.#.#...#
#.........#
#####D#####
key : 3

4
4
#####D#####
#.........#
#.........#
##........#
#.........#
D.........#
#.#..#..#.#
#.........#
#.........#
##.....#ee#
###########
enemies 2

6
4
###########
#.........#
#.....##..#
#.....##..#
#...#..#..#
l...e##...#
#.....###.#
#.........#
#.........#
#.#.......#
#####D#####
locked : 2
boss
enemies 1

5
3
#####d#####
#.........#
#.........#
#.........#
#.........#
#.........#
#.........#
#.........#
#.........#
#.........#
#####d#####

1
0
###########
#k........#
#..#......#
#.#.......#
#.........#
#.........#
#.........#
#.#.....#.#
#..#...#..#
#.........#
#####D#####
key : 0

4
3
#####D#####
#k#.......#
#.........#
#.#...#...#
#.........#
#.........D
#.........#
#.#.#.#...#
#.........#
#.........#
#####d#####
key : 2

1
2
#####D#####
#.........#
#........##
#.........#
#.........#
#...#.....d
#.........#
#.........#
#..#..#..##
#.........#
#####l#####
locked : 0

7
4
#####D#####
#......#..#
#......#..#
#.....##..#
#.........#
#.........#
#.........#
#.........#
#.........#
#X........#
###########

3
2
#####D#####
#.#.....#.#
#.........#
#.........#
#.#.....#.#
#.........D
#.........#
#e#..#..#.#
#e........#
#e........#
###########
enemies 3

3
0
#####D#####
#.........#
#......#..#
#.......#.#
#.........#
#.........#
#.........#
#.........#
#.........#
#.........#
###########

2
3
#####D#####
#.........#
#.........#
#.#.....#.#
#.........#
D.........#
#.#..#..#.#
#.........#
#.........#
#k#.......#
#####D#####
key : 4

1
3
#####d#####
#.........#
#......#..#
#.......#.#
#.........#
d.........#
#.........#
#.#.......#
#..#......#
#.........#
#####D#####

0
2
###########
#.........#
#..#......#
#.#.......#
#.........#
#.........D
#.........#
#.........#
#.........#
#.........#
#####D#####

6
3
#####d#####
#.........#
#.........#
##.###....#
#.#.###.#.#
#...###...l
#.####.#..#
#.####....#
#...#.###.#
#.........#
###########

2
1
###########
#.........#
#.........#
#....##...#
#...#e##..#
D..#e.....D
#..###e#..#
#....###..#
#.........#
#.........#
###########
enemies 3

