3
0
#####D#####
#.........#
#.........#
#.....#...#
#.####....#
#..?###...D
#..##@....#
#...##....#
##........#
#.........#
#####D#####
sign Those who search shall find.

2
1
#####D#####
#.........#
##.#...#.##
#.........#
#....#....#
l.........D
#..#.#.#..#
#.........#
##.#...#.##
#.........#
#####D#####
locked : 1

2
0
#####D#####
#e........#
#.........#
#.........#
#s........#
#e........l
#.........#
#.........#
#.........#
#.........#
#####D#####
enemies 2
switch 0 : 0 1

3
2
#####D#####
#e........#
#.........#
#.........#
#.........#
D.........D
#.........#
#...#.....#
#.........#
#e........#
#####d#####
enemies 2

4
1
#####l#####
#.........#
#.........#
#.........#
#.........#
D....#....D
#.........#
#...#.....#
#.........#
#.........#
###########
locked : 0

1
1
###########
#....k....#
#.........#
#..#.....##
#.........#
D.........D
#...#.....#
#.........#
#.........#
#........##
#####D#####
key : 3

3
3
#####D#####
#.........#
#.........#
#.#..#..#.#
#.........#
D.........#
#..#......#
#.........#
#........e#
#?#....e#e#
###########
enemies 3
door 0 : 0 1
sign The dungeon remembers all who enter.

2
3
#####d#####
#.......#.#
#.........#
#.#.#.#.#.#
#.........#
D...#.....d
#.........#
#.#.#.#.#.#
#.........#
#.#.....#.#
#####D#####

5
2
#####l#####
#.........#
#.........#
#.........#
#.........#
#....e....#
#.........#
#.........#
#.........#
#.........#
#####D#####
locked : 3
boss
enemies 1

2
2
#####l#####
#k........#
#......#..#
#.......#.#
#.........#
D.........D
#.........#
#.........#
#.........#
#.........#
#####D#####
key : 2

1
0
#####D#####
#.........#
#.......#.#
#...#.....#
#.........#
#k........D
#.......#.#
#.......#.#
#......#..#
#.........#
#####D#####
key : 1

2
4
###########
#.........#
#..#......#
#.#.......#
#.........#
d...#.....#
#.........#
#.#.....#.#
#..#...#..#
#.........#
###########

4
2
#####d#####
#.........#
#..#...#..#
#.#.....#.#
#.........#
D.........#
#.........#
#.........#
#.........#
#.........#
#####l#####

3
1
#####D#####
#.........#
#.........#
#.#.....#.#
#.........#
D.........D
#..#..#...#
#.........#
#.........#
#k#.....#.#
#####l#####
key : 0

6
2
#####D#####
#.........#
####......#
##.#......#
#.........#
#..##.....#
#.####....#
#.##......#
#..#..#...#
#X.#......#
###########

4
0
#####D#####
#.........#
#......#..#
#.......#.#
#.........#
#.........D
#.........#
#.#.......#
#..#......#
#.........#
###########

0
0
###########
##.#.....##
#.........#
#....#.#.##
#.........#
#..#.#.#..#
#.........#
#..#.#.#.##
#.........#
##.#...#.##
#####D#####

1
3
###########
#.........#
#.........#
#.........#
#.........#
D.........#
#.........#
#.........#
#.........#
#.........#
#####d#####

1
2
###########
#.........#
#.........#
##..#.....#
#.........#
D.........D
#......#..#
#.........#
#.........#
##.....#..#
#####l#####
locked : 2

