2
2
#####.#####
#.........#
##.#...#.##
#.........#
#..#.#.#..#
...........
#..#.#....#
#.........#
##.#...#.##
#.........#
#####l#####

3
3
#####l#####
#.........#
#......#..#
#.......#.#
#.........#
...........
#.........#
#.........#
#.........#
#.........#
###########
locked : 3

4
0
#####.#####
#.........#
#.........#
#.........#
#.........#
#.........#
#.........#
#.........#
#s........#
#e?......e#
###########
enemies 2
switch 0 : 0
sign Many have walked this path.

1
0
###########
#k........#
#.........#
#.........#
#.........#
#..........
#.........#
#.........#
#.........#
#.........#
#####.#####
key : 1

1
2
###########
#...k.....#
#...#.....#
#...#.....#
#.........#
...........
#.........#
#.........#
#.........#
#.........#
#####.#####
key : 3

2
3
#####d#####
#k........#
#.........#
#.....#...#
#.........#
..........d
#...#.....#
#.........#
#.........#
#.........#
#####l#####
key : 2

5
4
#####.#####
#.........#
#.........#
#.........#
#..#......#
#...##....#
#X###..#..#
##..##....#
#.........#
#......#..#
###########

1
3
###########
#.........#
#...#...#.#
#.........#
#.#.#.#.#.#
...........
#...#...#.#
#.........#
#.#.#.#.#.#
#.........#
#####d#####

2
0
#####.#####
#.........#
#.........#
#.........#
#..#@.##..#
#..?##.#...
#..##.....#
#..##.....#
#...#..#..#
#.........#
#####.#####
sign A useful tool lies just ahead.

3
2
#####l#####
#.........#
#.........#
#.........#
#.........#
#..........
#.........#
#.#.....#.#
#..#...#..#
#.........#
###########
locked : 2

3
5
###########
#........e#
#..#..#..##
#.........#
#.........#
..........#
#.........#
#.........#
#..#..#..##
#.........#
###########
enemies 1
door 0 : 0

3
0
#####.#####
#.........#
#......#..#
#.......#.#
#.........#
#.........#
#.........#
#.........#
#.........#
#.........#
#####.#####

4
4
#####.#####
#.........#
#...#..#..#
#..#e#....#
#....###..#
#e..##e..?#
#....##...#
#.........#
#.........#
#.........#
#####.#####
enemies 3
sign Beware what lurks ahead.

2
4
#####.#####
#.........#
#.........#
#.........#
#.........#
d.........#
#.........#
#.........#
#.........#
#.........#
#####d#####

0
1
###########
#......##.#
#.....#...#
#...###.#.#
#....##.#.#
#.........#
#.........#
#.........#
#.........#
#.........#
#####d#####

1
4
###########
#.........#
#......#..#
#.........#
#....###..#
.....##...#
#....###..#
#.........#
#.........#
#.........#
#####.#####

1
1
#####d#####
#.........#
#.#.......#
#..###....#
#..#.#....#
...#.#.....
#.........#
#.........#
#.........#
#.........#
#####.#####

3
4
#####d#####
#.........#
#.........#
#.........#
#.........#
.....e.....
#.........#
#.........#
#.........#
#.........#
#####.#####
boss
enemies 1

2
1
#####.#####
#k#.......#
#.........#
#.#.#.#...#
#.........#
....#.#....
#.........#
#...#.#.#.#
#.........#
#.......#.#
###########
key : 0

