4
1
#####D#####
#..#...#.##
#.........#
#.#...#...#
#.........#
d..#.#.#..#
#.........#
#.#.#.#...#
#.........#
#..#...#..#
#####D#####

2
1
#####D#####
#.........#
#.........#
#.........#
#.........#
D.........#
#.........#
#.........#
#.........#
#.........#
#####D#####

0
1
###########
#.........#
#.#.#.#.#.#
#.........#
#...#.#...#
#.........D
#...#.#.#.#
#.........#
#.#.#.#...#
#.........#
#####D#####

2
0
#####D#####
#.e#......#
#e#e#.....#
#...#.....#
#.........#
#?........D
#.........#
#.........#
#.........#
#.........#
#####l#####
enemies 3
sign Only the prepared may pass.

3
1
#####D#####
#.........#
#.........#
#.........#
#.........#
D........k#
#.........#
#.........#
#.........#
#.........#
#####D#####
key : 1

1
2
#####d#####
#.........#
#.#.#.#...#
#.........#
#..#...#..#
d.........D
#...#...#.#
#.........#
#..#...#..#
#.........#
###########

0
3
###########
#.........#
#.........#
##..#..#..#
#.........#
D.........#
#...#..#..#
#.........#
#.........#
##.....#..#
#####l#####
locked : 3

5
0
#####l#####
#......##.#
#.....###.#
#...#...#.#
#...###...#
#...##....D
#...###...#
#...###...#
#.........#
#.........#
#####l#####
locked : 1

7
0
#####D#####
#.........#
#..#......#
#.........#
#.........#
#..#......#
#.....##..#
#....###..#
#......#.##
#........X#
###########

2
3
#####D#####
#.........#
#..#...#..#
#.#.....#.#
#.........#
#.........#
#.........#
#.......#.#
#......#..#
#k........#
###########
key : 5

1
3
#####l#####
##p#......#
#k#.......#
#...#...p.#
#.#.......#
D.........D
#..##.....#
#..###....#
#..##.....#
#.........#
#####D#####
key : 3

1
0
###########
#?........#
##........#
#.##..#...#
#..#......#
#....@....D
#.........#
#.........#
#.........#
#.........#
#####D#####
sign A useful tool lies just ahead.

0
2
###########
#.#.......#
#.........#
#....#.#.##
#.........#
D.....#...D
#.........#
#....#....#
#.........#
#.........#
#####d#####

5
1
#####D#####
#.......#.#
#.........#
#..#.#...##
#.........#
D.....#...#
#.........#
#..#.#...##
#........?#
#.#.....#e#
###########
enemies 1
door 0 : 0
sign A locked path — look elsewhere first.

1
4
###########
#.......se#
#.........#
#.........#
#.........#
D.........#
#....##...#
#...#.....#
#...#.....#
#........e#
###########
enemies 2
switch 0 : 0

1
1
#####D#####
#k........#
#......#..#
#.......#.#
#.........#
D.........d
#.........#
#.......#.#
#......#..#
#.........#
#####D#####
key : 0

3
0
#####l#####
#.........#
#.#...#.#.#
#.........#
#..#.#....#
#.........D
#.#.#.#.#.#
#.........#
#..#...#..#
#.........#
#####D#####
locked : 0

4
0
#####D#####
#.........#
#.........#
#..#..#..##
#.........#
#.........d
#.....#...#
#.........#
#.........#
#.........#
#####l#####

6
0
#####l#####
#.........#
#..##.....#
#..#......#
#...#.....#
#....e....#
#.........#
#.........#
#.........#
#.........#
#####D#####
locked : 5
boss
enemies 1

