4
3
#####.#####
#.........#
#.........#
#.........#
#.........#
..........#
#.........#
#.........#
#.........#
#........X#
###########

5
1
#####.#####
#.........#
#......#..#
#.......#.#
#.........#
..........#
#.........#
#.........#
#.........#
#........k#
###########
key : 2

3
0
#####.#####
#.........#
#.........#
#...#..#..#
#.........#
#..........
#...#..#..#
#.........#
#.........#
##.....#..#
#####.#####

4
1
#####.#####
#.#.......#
#.........#
#...#.#.#.#
#.........#
....#.#....
#.........#
#...#.#.#.#
#.........#
#.#.....#.#
#####.#####

1
1
###########
#.......#.#
#.........#
#........##
#.........#
..........#
#.........#
#.#.......#
#.........#
#.........#
#####d#####

2
0
#####d#####
#.........#
#.....#...#
#.........#
#.........#
#k.........
#.........#
#.......#.#
#......##.#
#.........#
#####.#####
key : 1

2
3
###########
#......e.e#
#...#e##..#
#....###..#
#...###...#
..........#
#.........#
#.........#
#.........#
#.........#
#####.#####
enemies 3

4
0
#####.#####
#.........#
#.....#...#
#...###...#
#.........#
#?...@.....
#.........#
#.........#
#.........#
#.........#
#####.#####
sign What you seek is close.

2
1
#####d#####
#.........#
#.........#
#.........#
#..####...#
...##e....l
#..e##....#
#..#e#....#
#..#..#...#
#.........#
#####.#####
enemies 3
door 0 : 0

5
0
#####.#####
##.#...#..#
#k........#
##.#.#....#
#.........#
#..#.#.#...
#.........#
##...#.#.##
#.........#
##.#...#.##
#####.#####
key : 0

0
0
###########
#.........#
#.........#
#..#......#
#.........#
#..#.##...#
#..#.#....#
#...##....#
#..##.#...#
#..#......#
#####d#####

7
0
#####.#####
#.........#
#.........#
##........#
#.........#
#.........#
#.........#
#.#.....#.#
#..#...#..#
#k........#
###########
key : 4

3
2
#####.#####
#.........#
#.........#
#.........#
#.........#
l....###..d
#.#.###...#
#...##.##.#
#......####
#........##
#####.#####
locked : 2

3
1
#####.#####
#e........#
#.........#
#.........#
#..#e#....#
...###....l
#s#.e#....#
###.#.....#
#.........#
#?........#
#####.#####
enemies 3
switch 0 : 0
sign A locked path — look elsewhere first.

2
2
###########
#.........#
#...#...#.#
#.........#
#.#.#.#...#
l..........
#.#.#.#...#
#.........#
#.#.#.#.#.#
#.........#
#####.#####
locked : 1

3
3
#####.#####
#.........#
#.........#
#.........#
#.#.#e##..#
d...##.#..#
#.####....#
####.#....#
####..#...#
###.......#
#####.#####
boss
enemies 1

4
2
#####.#####
#.........#
#......#..#
#......#..#
#.........#
...........
#......#..#
#.......#.#
#...#.###.#
#.........#
###########

6
0
#####.#####
#.........#
#.........#
#.........#
#.........#
#..#......#
#.#.......#
##.#......#
##..#.....#
###.......#
#####.#####

1
0
#####d#####
#.#.......#
#.###.....#
#..#.#....#
#.........#
#..#.#.....
#..#.#....#
#.........#
#.........#
#.........#
#####d#####

