2
2
#####D#####
#.........#
#.........#
#.p.......#
#.........#
D.........#
#.........#
#.........#
#.........#
#Xp.......#
#####D#####

3
3
###########
#k#.......#
#.........#
#...#.#.#.#
#.........#
D...#.#...D
#.........#
#.#.#.#.#.#
#.........#
#.#.....#.#
#####d#####
key : 2

5
1
#####D#####
#.........#
#.........#
#.........#
#.........#
d....###..#
#.......#.#
#....##.#.#
#.........#
#......#..#
###########

2
0
#####D#####
#.........#
#.........#
#.#.......#
#..#......#
#..#......D
#.........#
#.........#
#.........#
#.........#
#####D#####

3
4
###########
#.........#
#.........#
#.........#
#.........#
D.........#
#.........#
#.#.......#
#..#......#
#.........#
###########

3
1
#####D#####
#.........#
#..#......#
#.#.#.....#
#.........#
D.........d
#.........#
#.#.....#.#
#.##...#..#
#.........#
#####D#####

3
2
#####D#####
#.........#
##.#......#
#.#.......#
#.........#
d.........D
#.........#
#.........#
##........#
#.......#.#
#####D#####

1
1
###########
#....k....#
#.........#
#.........#
#.........#
D.........l
#.........#
#.........#
#.........#
#.........#
#####D#####
key : 3

2
1
#####D#####
#e.....#..#
#.....#e..#
#......##.#
#....#....#
D.........D
#.........#
#.........#
#.........#
#e........#
#####D#####
enemies 3

1
2
###########
#.........#
#.........#
#.........#
#.........#
l....e....#
#.........#
#.........#
#.........#
#.........#
#####D#####
locked : 1
boss
enemies 1

3
0
#####D#####
#.........#
#.........#
#.........#
#.........#
#....@....D
#.........#
#.........#
#.........#
#.........#
#####D#####

6
0
#####l#####
#.........#
#.#.#.#...#
#.........#
#.#.#.#...#
#.........#
#.#...#.#.#
#.........#
#...#.#.#.#
#.........#
###########
locked : 2

4
3
#####d#####
#.........#
#......#..#
#.......#.#
#.........#
D.........#
#.........#
#.......#.#
#......#..#
#.........#
###########

5
0
#####d#####
#.........#
#......#..#
#.......#.#
#.........#
#.........d
#.........#
#.#.......#
#..#....#.#
#.........#
#####l#####

1
0
#####l#####
#.........#
#.........#
#.........#
#.........#
#k........D
#.........#
#.........#
#.........#
#.........#
#####D#####
key : 1

0
0
###########
#.........#
#.........#
#.........#
#.........#
#.........#
#.........#
#.........#
#.........#
#.........#
#####l#####
locked : 0

4
2
#####D#####
#.........#
#.........#
#.........#
#.........#
D.........D
#.........#
#.#.......#
#..#......#
#.........#
###########

4
0
#####D#####
##.#...#..#
#.........#
#k#...#...#
#.........#
#..#.#.#..D
#.........#
#.#.#.#...#
#.........#
##.....#..#
#####d#####
key : 0

4
1
#####D#####
#e.......?#
#.........#
#.........#
#.........#
D.........D
#.........#
#.........#
#.........#
#e........#
#####D#####
enemies 2
sign Those who search shall find.

