3
0
#####.#####
#.........#
#.........#
#......#..#
#.#####...#
#..##..#..#
#...#..#..#
####......#
#...#.....#
#.........#
###########

2
2
#####.#####
#.........#
#.........#
#.........#
#.........#
..........l
#.........#
#.#.......#
#..#......#
#.........#
#####.#####

5
4
#####.#####
#.........#
#.........#
#.........#
#.........#
..........#
#.........#
#.........#
#.........#
#........X#
###########

2
4
#####.#####
##.....#..#
#.........#
#.........#
#.........#
.........k#
#.........#
##.....#..#
#.........#
#.........#
#####.#####
key : 2

3
4
#####.#####
#.........#
#.........#
#.........#
#.........#
d.........#
#.........#
#.........#
#.........#
#.........#
#####.#####

3
3
#####.#####
#k........#
##..#..#..#
#.........#
#.........#
.....#....d
#.........#
#.........#
##..#..#..#
#.........#
#####l#####
key : 1

4
3
#####l#####
#.........#
#.........#
#..#..#...#
#.........#
..........l
#.....#...#
#.........#
#.........#
#..#.....##
#####.#####
locked : 1

1
3
###########
#.........#
##.#...#.##
#.........#
#...#.#.#.#
...........
#..#.#.#..#
#.........#
#.#.#...#.#
#.........#
#####d#####

2
1
#####.#####
#.........#
#..#..#..##
#.........#
#.........#
....#..#...
#.........#
#.........#
#..#..#..##
#.........#
###########

2
3
#####d#####
#.........#
#.#...#.#.#
#.........#
#.........#
l..........
#.....#.#.#
#.........#
#..#...#.##
#.........#
#####.#####
locked : 0

5
3
#####.#####
#.........#
#.........#
#.........#
#.........#
#..........
#.........#
#.........#
#?........#
#e........#
###########
enemies 1
sign Turn back; you are not yet ready.

2
0
###########
#?........#
#.........#
#.........#
#..##.....#
#..##@.....
#.#.#.....#
#.........#
#.........#
#.........#
#####.#####
sign Beware what lurks ahead.

0
2
###########
#.........#
#.........#
#..#..#...#
#.........#
#.........#
#...#..#..#
#.........#
#.........#
#........##
#####d#####

1
4
###########
#..#.....k#
#...#.##..#
#...####..#
#..###....#
...#.###..#
#.....###.#
#...#.....#
#.........#
#.........#
#####.#####
key : 4

1
1
###########
#e........#
#?........#
##..####..#
#...#.#...#
#..##.##...
#..##.....#
#..##.#...#
#.........#
#.........#
#####.#####
enemies 1
sign Many have walked this path.

4
4
#####.#####
#.........#
#.........#
#.........#
#...e.###.#
l....#.#..#
#.......#.#
#...#####.#
#...#.....#
#.........#
#####.#####
locked : 4
boss
enemies 1

1
2
#####d#####
#.........#
#.#.#.#.#.#
#.........#
#..#......#
...........
#...#.#.#.#
#.........#
#..#...#.##
#.........#
#####.#####

4
2
#####d#####
#.........#
#.........#
#..#..#..##
#.........#
#..........
#..#..#...#
#.........#
#.........#
#.........#
###########

3
2
#####.#####
#.........#
#..#...#..#
#.#.....#.#
#.........#
#..........
#.........#
#.......#.#
#.....#####
#........k#
#####d#####
key : 0

