7
0
#####.#####
##........#
##.#......#
##..#.....#
#.##......#
#..#......#
#.........#
#.........#
#.........#
#X........#
###########

1
3
#####.#####
#.........#
#......#..#
#.....#.#.#
#.........#
d.........#
#.........#
#.......###
#......#..#
#.........#
#####.#####

0
2
###########
#....?e#..#
#.........#
#.......#.#
#.........#
...........
#.........#
#.........#
#.........#
#.........#
#####.#####
enemies 1
door 0 : 0
sign Those who search shall find.

3
1
#####.#####
#e........#
#.........#
#.........#
#.........#
...........
#.........#
#.........#
#.........#
#?...e....#
###########
enemies 2
sign Beware what lurks ahead.

0
3
###########
#........k#
#......#..#
#.......#.#
#.........#
..........#
#.........#
#.........#
#.........#
#.........#
#####.#####
key : 8

1
2
#####.#####
#k........#
#.........#
#.........#
#.#.....#.#
..........d
#.........#
#.#..#....#
#.........#
#.........#
#####.#####
key : 2

2
1
#####.#####
#e.#......#
#..##.....#
#.#e#.....#
#.........#
..........d
#.........#
#.........#
#.........#
#s........#
#####.#####
enemies 2
switch 0 : 0

3
0
#####.#####
#.........#
#.........#
#.........#
#e##......#
#?e........
#e#.#.....#
#.........#
#.........#
#.........#
#####.#####
enemies 3
sign Beware what lurks ahead.

0
1
###########
#........##
#.....#...#
#....##...#
#.........#
...........
#.......#.#
#......##.#
#.....#.#.#
#.........#
#####.#####

5
0
#####.#####
#.........#
#k#.......#
#.........#
#.........#
#.........#
#.........#
#.........#
#.........#
#.........#
#####l#####
key : 3

1
1
#####.#####
#.........#
#.........#
#.........#
#.........#
...........
#.........#
#.........#
#.........#
#.........#
#####.#####

0
0
###########
#.........#
#.........#
#.........#
#.........#
#..........
#.........#
#.........#
#.........#
#.........#
#####.#####

6
0
#####l#####
#.........#
#.........#
#.........#
#...e.....#
#..###....#
#.........#
#.........#
#.........#
#.........#
#####.#####
locked : 2
boss
enemies 1

2
0
#####.#####
#.........#
#.........#
#....###..#
#.........#
#?...@.....
#.........#
#.........#
#.........#
#.........#
#####.#####
sign An eerie silence fills the chamber.

1
0
#####.#####
#.........#
#.........#
#.#..#..#.#
#.........#
#..........
#k#..#....#
#.........#
#.........#
#.#.....#.#
#####.#####
key : 0

4
0
#####.#####
#.........#
#..#......#
#.#.......#
#...#.....#
#.........#
#.........#
#.........#
#.........#
#.........#
#####.#####

3
2
#####d#####
#.........#
##..#..#..#
#.........#
#.........#
....#.....#
#.........#
#.........#
##.....#..#
#.........#
###########

2
3
#####.#####
#.........#
#..#......#
#.#.......#
#.........#
d.........#
#.........#
#.#.......#
#..#......#
#.........#
###########

2
2
#####.#####
#.........#
#.........#
#.........#
#.........#
d.........d
#.........#
#.#.......#
#..#......#
#.........#
#####d#####

