3
3
#####.#####
#.........#
#.#.#.#.#.#
#.........#
#..#.#.#..#
..........#
#.#.....#.#
#.........#
#..#...#.##
#.........#
#####d#####

0
3
###########
#e........#
#...#.#.#.#
#.........#
#....#.#..#
#.........#
#...#.#.#.#
#.........#
#.........#
#.........#
#####.#####
enemies 1

1
2
###########
#.........#
#.#.....#.#
#.........#
#.........#
#....#....d
#.........#
#.........#
#.#.....#.#
#.........#
#####d#####

3
1
###########
#.........#
#.......#.#
#......#..#
#.....#e#.#
.....##....
#....##.#.#
#.........#
#.........#
#.........#
#####.#####
enemies 1

5
2
#####l#####
#.#.....#.#
#.........#
#.#.#...#.#
#.........#
....#.#...#
#.........#
#...#...#.#
#.........#
#.#.......#
###########
locked : 3

2
2
#####d#####
#.........#
##..#.....#
#.........#
#.........#
#....#.....
#.........#
#.........#
##.....#..#
#.........#
#####d#####

4
1
#####.#####
##.....#k##
#.........#
#.#.#.#.#.#
#.........#
...#.#.#..l
#.........#
#...#.#.#.#
#.........#
##.....#.##
#####.#####
key : 2

4
3
#####d#####
#.........#
#.........#
#......#..#
#.........#
.....#.#..#
#.......#.#
#.........#
#.........#
#......#..#
###########

5
0
#####.#####
#k........#
##.#...#.##
#.........#
#.....#.#.#
#.........l
#..#.#.#..#
#.........#
#...#...#.#
#.........#
#####.#####
key : 1

2
0
###########
#k.#......#
##........#
#...#.....#
#...#.....#
#..#......#
#.........#
#.........#
#.........#
#.........#
#####.#####
key : 3

5
1
#####.#####
#.........#
#..#...#..#
#.#.....#.#
#.........#
l..........
#.........#
#.........#
#.........#
#.........#
###########
locked : 1

4
0
#####.#####
#.........#
#.........#
#.........#
#.........#
#?...@.....
#.........#
#.........#
#.........#
#.........#
#####.#####
sign The brave are rewarded.

1
3
#####.#####
#.........#
#.........#
#.........#
#.........#
d....e#....
#.........#
#.........#
#.........#
#.........#
#####.#####
boss
enemies 1

6
0
#####.#####
#..#...#.##
#.........#
#.#.#.#.#.#
#.........#
#..#.#.#..#
#.........#
#.....#.#.#
#.........#
##.#.....##
###########

4
2
#####.#####
#......#..#
#.........#
#.........#
#.#.....#.#
l..........
#.........#
#...#..#..#
#.........#
#.........#
#####l#####
locked : 2

3
2
#####d#####
#.........#
#.........#
#.........#
#.........#
...........
#.........#
#.......#.#
#......#..#
#.........#
#####.#####

3
0
#####.#####
##.......##
#k........#
##.#...#..#
#.........#
#..#.#.....
#.........#
##...#.#..#
#.........#
##.#...#.##
#####.#####
key : 0

2
3
#####.#####
#.........#
#.###.....#
#..#.##...#
#.#..#....#
....#.....#
#.........#
#.........#
#.........#
#.........#
#####.#####

1
4
###########
#........X#
#.........#
#.........#
#.........#
..........#
#.........#
#.........#
#.........#
#.........#
###########

