1
2
###########
#.......#.#
#.........#
#........##
#.........#
D.........#
#.........#
#.........#
#.........#
#......#..#
###########

3
1
#####D#####
#k........#
##..#..#..#
#.........#
#.........#
D...#.....#
#.........#
#.........#
#.........#
#.........#
#####D#####
key : 0

1
1
#####l#####
#.........#
#..#......#
#.#...#...#
#.........#
D...#.....D
#.........#
#......#..#
#.........#
#.........#
#####D#####

6
2
#####D#####
##.#......#
#.........#
##.#.#.#.##
#.........#
#..#.#.#..D
#.........#
##...#.#.##
#.........#
#......#.##
###########

5
4
###########
#........k#
#......#..#
#.......#.#
#.........#
D.........#
#.........#
#.......#.#
#......#..#
#.........#
###########
key : 6

0
1
###########
#.........#
#.........#
#.........#
#.........#
#.........#
#.........#
#.........#
#.........#
#.........#
#####l#####
locked : 0

6
3
#####D#####
#e........#
##..#.....#
###.#.....#
#..#.#....#
D....#....#
#.#..#....#
#.........#
#.........#
#.........#
#####d#####
enemies 1

8
3
#####D#####
#..#...#..#
#..##..#..#
#..##..#..#
#..#......#
#.........#
#.........#
#.........#
#.........#
#X........#
###########

5
1
#####D#####
#.........#
#.........#
#....#.####
#....###..#
#....##...d
#....##...#
#....#.##.#
#e........#
#e?.......#
###########
enemies 2
sign A useful tool lies just ahead.

2
0
#####D#####
#......##.#
#.....##..#
#....#....#
#.#.####..#
#..#.##...D
#.##.#....#
#..#.#....#
#.#.......#
#.........#
#####D#####

4
1
#####D#####
##.#...#.##
#k........#
##...#.#..#
#.........#
#..#.#....D
#.........#
##.#.#.#.##
#.........#
#......#.##
#####D#####
key : 1

4
2
###########
#.........#
#......#..#
#.........#
#.........#
D....#....D
#.........#
#.........#
##..#..#..#
#.........#
#####l#####
locked : 1

5
3
#####d#####
#........##
#.........#
#.........#
#.........#
d.........D
#.........#
#.#.......#
#..#......#
#.........#
#####D#####

7
3
#####d#####
#.........#
#.........#
#.........#
#.........#
#....e....#
#.........#
#.........#
#.........#
#.........#
#####D#####
boss
enemies 1

1
0
###########
#k.....#..#
#.........#
#.........#
#...#..#..#
#.........D
#.........#
##..#..#..#
#.........#
#.........#
#####D#####
key : 2

3
0
#####D#####
#.........#
#.........#
#....##...#
#...@.....#
#....###..D
#.........#
#.........#
#.........#
#?........#
###########
sign The brave are rewarded.

5
2
#####l#####
#..#......#
#.###.....#
#.#..#....#
#.........#
d.........d
#.........#
#.........#
#.........#
#.........#
#####D#####

4
3
###########
#.........#
#.........#
#.........#
#.#.......#
D...#.....#
#.#.......#
#.##.....##
#.........#
#.........#
#####d#####

2
1
#####D#####
#........##
#........e#
#.........#
#...#.....#
D........e#
#........e#
#........##
#.........#
#.........#
#####D#####
enemies 3

