3
0
#####.#####
#.........#
#e#.#.#.#.#
#.?.......#
#e#.#...#.#
#e.........
#.....#...#
#.........#
#.......#.#
#.........#
#####.#####
enemies 3
sign Those who search shall find.

3
1
#####.#####
#k........#
#..#......#
#.#.......#
#.........#
..........d
#.........#
#.........#
#.........#
#.........#
#####l#####
key : 1

3
2
#####.#####
#.........#
##.#...#.##
#.........#
#..#.#.#..#
d.........d
#..#......#
#.........#
#......#.##
#.........#
#####.#####

2
0
#####.#####
#.##......#
#.###.....#
#.#.#.....#
#.#.#.....#
#...##.....
#...@..#..#
#.........#
#.........#
#..#......#
#####.#####

1
0
###########
#.........#
#.......#.#
#.........#
#.........#
#....#.....
#.........#
#.........#
#.#.....#.#
#.........#
#####.#####

1
1
###########
#.........#
#.........#
#.........#
#.........#
...........
#.........#
#.........#
#.........#
#.........#
#####.#####

1
2
#####.#####
#.........#
#..#..#...#
#.........#
#.........#
......#...l
#.........#
#.........#
#..#..#..##
#.........#
#####d#####

5
0
#####d#####
#.#.....#.#
#.........#
#.........#
#.#..#..#.#
#.........#
#.........#
#.#..#..#.#
#.........#
#.........#
###########

3
3
#####.#####
#.........#
#......#..#
#.......#.#
#.........#
d.........#
#.........#
#.........#
#.........#
#.........#
#####.#####

4
3
#####.#####
#.........#
#......#..#
#.......#.#
#.........#
..........#
#.........#
#.......#.#
#......#..#
#........k#
###########
key : 3

2
1
#####.#####
#k#.....#.#
#.........#
#.#...#...#
#.........#
....#.#....
#.........#
#.#...#.#.#
#.........#
#.#.....#.#
#####.#####
key : 0

4
0
#####.#####
#.........#
#.........#
#.#..#....#
#.........#
#..........
#.....#...#
#.........#
#.........#
#.#.......#
#####d#####

1
3
#####.#####
#.........#
#..#..##..#
#.....##..#
#...#..#..#
l....e#...#
#....###..#
#......#..#
#.........#
#..#......#
#####.#####
locked : 2
boss
enemies 1

2
3
#####.#####
#.........#
#.........#
#...#.....#
#....#....#
l..##.....#
#.........#
#.........#
#.........#
#.........#
#####.#####
locked : 1

0
2
###########
#e........#
#?........#
#.........#
#.........#
#..........
#.........#
#.........#
#.........#
#.........#
#####.#####
enemies 1
sign The dungeon remembers all who enter.

4
2
#####.#####
#k#.....#.#
#.........#
#..#.#.#.##
#.........#
...........
#.........#
#..#.#....#
#.........#
#.......#.#
###########
key : 2

0
3
###########
#........X#
#.........#
#....#....#
#..##.....#
...#......#
#...#.....#
#...#.....#
#.##......#
#.........#
#####.#####

2
2
#####d#####
#.........#
#.........#
#..#...#..#
#......#..#
....####..l
#..#####..#
#....##...#
#...#.....#
#.........#
#####.#####

4
1
#####l#####
#.........#
#..#......#
#.#.......#
#.........#
...........
#.........#
#.........#
#.........#
#.........#
###########
locked : 0

