0
0
###########
#e.e.....e#
#..#..#..##
#........s#
#.........#
#.....#...#
#.........#
#.........#
#..#..#..##
#.........#
#####D#####
enemies 3
switch 1 : 2

4
1
#####D#####
#.........#
#..#...#..#
#.#.....#.#
#.........#
d.........D
#.........#
#.#.......#
#..#......#
#.........#
#####D#####

5
1
#####D#####
#.........#
#..#......#
#.........#
#.........#
D...#.....l
#.........#
#.#.#.....#
#..#......#
#.........#
###########

1
2
###########
#........k#
#..#.....##
#.........#
#..#.#....#
#.........#
#....#.#..#
#.........#
##.#.....##
#.........#
#####D#####
key : 2

3
1
#####D#####
#.........#
#.........#
#.........#
#...#.#...#
d....#.#..D
#.####.##.#
#.#.##....#
#.......#.#
#.........#
#####D#####

4
0
#####D#####
#.........#
#.........#
#.....#...#
#.........#
#k........d
#...#..#..#
#.........#
#.........#
#.........#
#####D#####
key : 0

2
1
###########
#.........#
#.........#
#.........#
#.........#
d.........D
#.........#
#.......#.#
#......#..#
#.........#
#####D#####

5
0
#####D#####
#.........#
#.........#
#.........#
#.........#
#....@....D
#.........#
#.........#
#.........#
#.........#
#####D#####

4
2
#####D#####
#.........#
#.........#
#.........#
#.........#
D........X#
#.........#
#.........#
#.........#
#.........#
#####D#####

6
0
#####D#####
#.........#
#.#.#.#...#
#.........#
#..#......#
#.........#
#.#...#.#.#
#.........#
#..#...#.##
#.........#
###########

3
2
#####d#####
#.........#
#.........#
#.........#
#.....#...#
D...#e#...#
#...#.....#
#.........#
#.........#
#.........#
#####D#####
boss
enemies 1

2
3
###########
#..k......#
#..#...#..#
#.#.....#.#
#.........#
D.........D
#.........#
#.........#
#.........#
#.........#
###########
key : 3

2
5
###########
#.#......e#
#..#......#
#.........#
#.........#
D.........#
#......#..#
#.....##..#
#.......#.#
#.........#
###########
enemies 1
door 1 : 2

1
0
#####D#####
##.#...#.##
#........e#
#..#.#.#.##
#.........#
#....#.#..#
#?........#
##...#.#.##
#........s#
#..#.....##
#####D#####
enemies 1
switch 0 : 0 1
sign Many have walked this path.

3
0
#####D#####
##.#.....##
#e........#
##.....#.##
#.........#
#..#.#.#..d
#.........#
##.#.#.#.##
#.........#
##.#...#..#
#####D#####
enemies 1
door 0 : 0 1

2
0
#####D#####
#.........#
#.........#
#.........#
#.........#
#.........d
#.........#
#.........#
#.........#
#.........#
#####D#####

2
2
#####D#####
#.........#
#.........#
#.........#
#.........#
D.........D
#.........#
#.#.......#
#..#......#
#.........#
#####d#####

2
4
###########
#..k......#
#..#......#
#.#.......#
#.........#
D.........D
#.........#
#.........#
#.........#
#.........#
###########
key : 4

5
2
#####D#####
#.........#
##.#...#.##
#.........#
#..#.#....#
l.........#
#....#.#..#
#.........#
#..#...#.##
#.........#
###########
locked : 0

