5
4
#####d#####
#.........#
#.....##..#
#......#..#
#..#...#..#
#....e....#
#.........#
#.........#
#.........#
#.........#
#####D#####
boss
enemies 1

0
0
###########
#.........#
#..#......#
#.#.......#
#.........#
#.........#
#.........#
#.........#
#.........#
#.........#
#####d#####

5
2
#####D#####
#.........#
##........#
#.........#
#.#.#.#.#.#
#.........#
#......#..#
#.........#
#.#.#.#.#.#
#e........#
###########
enemies 1

4
5
###########
#.........#
#.........#
#..##.....#
#..###.#..#
D..#.###..#
#....#.#..#
#..###....#
#.........#
#.........#
###########

1
1
###########
#.....k...#
#..#..#...#
#.........#
#.........#
D.....#...d
#.........#
#.........#
#..#..#..##
#.........#
#####D#####
key : 3

2
0
#####d#####
#.........#
##.#...#..#
#.........#
#..#.#.#..#
#.........D
#.........#
#.........#
##.#.....##
#.........#
#####l#####
locked : 0

2
2
#####D#####
#.........#
#.........#
#.........#
#.#.......#
D..#......#
#...##....#
#...##....#
#.#.......#
#.........#
#####D#####

4
2
#####D#####
#k........#
#......#..#
#.......#.#
#.........#
D.........D
#.........#
#.......#.#
#......#..#
#.........#
#####D#####
key : 2

2
1
#####D#####
#.##......#
#.........#
#.....#####
#....###..#
D.....#...D
#....#.##.#
#....#.##.#
#.........#
#.........#
#####D#####

1
2
###########
##.....#..#
#.........#
#.........#
#...#.....#
d.........#
#.........#
#...#..#..#
#.........#
#.........#
#####D#####

1
0
#####d#####
##.#...#..#
#.........#
#.#.#...#.#
#.........#
#..#.#.#..D
#.........#
#.#.#.#.#.#
#.........#
#..#...#.##
#####d#####

4
4
###########
#.........#
#.........#
#....###.##
#.....e#..#
D....##...D
#......#..#
#......####
#.........#
#.........#
#####d#####
enemies 1

4
3
###########
#.........#
#..#..##..#
#.##...#..#
#..#..##..#
D.........D
#.........#
#.........#
#.........#
#.........#
###########

3
0
#####l#####
#......##?#
#...#..##.#
#....#.#..#
#...###...#
#...#@##..D
#..#..##..#
#.....#...#
#.........#
#.........#
#####D#####
sign Only the prepared may pass.

3
1
#####D#####
#k........#
#.........#
#...p.....#
#.........#
D....##...l
#.##......#
#..#....p.#
#..##.....#
#.........#
#####D#####
key : 0

3
2
#####D#####
#.........#
#...#.###.#
#...#.#.#.#
#....##...#
l.........#
#.........#
#.........#
#.........#
#.........#
#####D#####
locked : 1

4
0
#####D#####
#.........#
#.........#
#.#.#.....#
#.#.......#
#...#.....D
#.........#
#.........#
#.........#
#.........#
###########

4
1
#####D#####
#.........#
#.##......#
#.#.......#
#.#.#.....#
D.........D
#.........#
#.........#
#.........#
#....k....#
###########
key : 1

6
4
#####D#####
#.........#
#.........#
#.........#
#.#.##....#
#..#......#
#..###....#
#..###....#
###.......#
#X........#
###########

