3
0
###########
#?........#
#.........#
#.........#
#.........#
#...#@.....
#.#.......#
#.#.#.....#
#.........#
#.........#
###########
sign Water drips somewhere in the darkness.

3
4
#####.#####
#.#.....#.#
#.........#
#.#.....#.#
#.........#
....#.#....
#.........#
#...#.#.#.#
#.........#
#.#.....#.#
#####d#####

4
3
#####.#####
#......#..#
#.........#
#..#.#....#
#.........#
...#.#.#...
#.........#
##.....#..#
#k........#
##.#...#.##
#####.#####
key : 2

2
2
###########
#.........#
##........#
#.........#
#.........#
...........
#.........#
#.#.......#
#..#......#
#..#......#
#####.#####

5
2
#####.#####
#.........#
#..#......#
#.#.......#
#.........#
#.........l
#.........#
#.........#
#.....#...#
#.........#
#####.#####

3
5
###########
#.........#
#..#.....##
#.........#
#.........#
.......#..#
#.........#
#.........#
#..#..#..##
#.........#
###########

1
3
###########
##e....#..#
#e........#
#.........#
#e#..#..#.#
#..........
#.........#
#...#..#..#
#.........#
#.........#
#####.#####
enemies 3

0
4
###########
#X........#
#.........#
#.........#
#...#.##..#
#..#..#...#
#.#.##.#..#
#....#...##
#.....#.###
#.........#
#####.#####

3
1
#####.#####
#.........#
#..#..#..##
#.........#
#.........#
......#....
#.........#
#.........#
#..#..#..##
#.........#
###########

2
1
###########
#k........#
#..#......#
#.#.......#
#.........#
#..........
#.........#
#.......#.#
#......#..#
#.........#
#####.#####
key : 0

2
3
#####.#####
#..#......#
#.........#
#.........#
#......#..#
...........
#.........#
#..#..#..##
#.........#
#.........#
#####d#####

3
3
#####d#####
#.........#
#......#..#
#.......#.#
#.........#
...........
#.........#
#.......#.#
#......#..#
#.........#
#####.#####

4
2
#####d#####
#.........#
#.........#
#.#.....#.#
#.........#
#..........
#..#..#...#
#.........#
#.........#
#.#.....#.#
#####.#####

5
3
#####.#####
#.........#
#.........#
#.........#
#.........#
l.........#
#.#.##....#
###.##....#
#.###.....#
#.........#
###########
locked : 0

2
4
#####d#####
#.........#
#.........#
#.#e##....#
#.#####...#
.....#e..?#
#....#....#
#..#.#....#
#.........#
#.........#
#####.#####
enemies 2
sign Many have walked this path.

6
2
#####.#####
#..#......#
#..##.....#
#...#.....#
#.........#
#..#.#.#..#
#...#.#...#
#......#..#
#...#.....#
#k.....#..#
###########
key : 3

3
2
#####.#####
#k........#
#..#......#
#.#.......#
#.........#
...........
#.........#
#.##......#
#..#......#
#.........#
#####d#####
key : 1

1
4
#####.#####
#.#.......#
#.........#
#.........#
#.........#
.....e....#
#.........#
#.........#
#.........#
#.........#
#####d#####
boss
enemies 1

4
4
#####d#####
#.........#
#.#...#.#.#
#.........#
#.#.#...#.#
..........#
#...#.#.#.#
#.........#
#.#...#...#
#.........#
###########

