4
4
#####l#####
#.........#
##..#..#..#
#.........#
#.........#
#..........
#.........#
#.........#
##..#..#..#
#.........#
###########
locked : 3

4
2
#####d#####
#.........#
#.....#...#
#.........#
#...#.#.#.#
#.........#
#.#...#.#.#
#.........#
#.#.....#.#
#.........#
###########

1
3
###########
#.........#
#......#..#
#.......#.#
#.........#
..........#
#.........#
#.......#.#
#......#.##
#.........#
#####.#####

4
5
#####.#####
#.........#
#.........#
#..#.#....#
#.#.##....#
....#.....#
#.###.....#
##..#.....#
##.#......#
#........X#
###########

2
4
###########
#.........#
#.........#
#.####.#..#
#..#....#.#
d...####..d
#.#..###..#
#.#######.#
#.........#
#.........#
#####.#####

3
4
#####.#####
#......##k#
#.......#.#
#....####.#
#.....##..#
#....###..l
#.........#
#.........#
#.........#
#.........#
#####l#####
key : 4

1
0
#####.#####
#.........#
#.........#
#.........#
#.........#
#....@.....
#...#.#...#
#...#.#...#
#...#.....#
#.........#
#####.#####

3
2
#####.#####
#.........#
#..#...#.##
#.##....#.#
#.........#
..........#
#......#..#
#.........#
#.........#
#.........#
#####d#####

0
0
###########
#k........#
#......#..#
#...#...#.#
#.........#
#...#.....#
#.........#
##........#
#.........#
#.........#
#####.#####
key : 0

3
0
#####.#####
#.........#
#.........#
#.........#
#.........#
#..........
#.........#
#.........#
#.........#
#.........#
###########

2
5
###########
#.........#
#.........#
#.........#
#.........#
d.........#
#.........#
#.........#
#.........#
#.........#
#####.#####

2
0
#####.#####
#.........#
#e........#
##..#..#..#
#e........#
#.........d
#e#..#....#
#.........#
#.........#
#.........#
#####.#####
enemies 3

1
2
###########
#.......#.#
#...#...#.#
##..k##.#.#
#...#.##..#
...........
#.........#
#.........#
#.........#
#.........#
#####.#####
key : 1

3
5
#####.#####
#.........#
#...#.....#
##.#......#
#..##.....#
l..##e....#
#.##......#
#.........#
#.#.......#
#.........#
#####.#####
locked : 4
boss
enemies 1

1
1
###########
#.........#
#.........#
#.........#
#.........#
...........
#.........#
#.........#
#.........#
#.........#
#####.#####

3
1
#####.#####
##.#...#.##
#.........#
#..#.#....#
#.........#
.....#.#...
#.........#
##.#.#....#
#.........#
##e#...#.##
###########
enemies 1

2
2
#####.#####
#k........#
#..#......#
#.#.......#
#.........#
...........
#.........#
#.........#
#.........#
#.........#
#####.#####
key : 3

2
1
#####.#####
##.....#.##
#.........#
#.#...#.#.#
#.........#
d..#.#.....
#.........#
#...#.#.#.#
#.........#
##.#...#.##
#####.#####

2
3
#####.#####
#e........#
#.........#
#.........#
#.........#
..........d
#.........#
#.........#
#.........#
#e..?e....#
###########
enemies 3
sign Those who search shall find.

