3
1
#####.#####
#.........#
#.........#
#.........#
#.....##..#
....#..#...
#...###.#.#
#...###.#.#
#.....#...#
#.......#k#
#####.#####
key : 1

3
2
###########
##.#...#.##
#.........#
#.#...#.#.#
#.........#
...#.#.#..#
#.........#
#.#.#.#.#.#
#.........#
##.....#.##
#####.#####

6
3
###########
#.........#
#.........#
#.........#
#.........#
d....e....#
#.........#
#.........#
#.........#
#.........#
#####.#####
boss
enemies 1

2
1
#####.#####
#.........#
#..#..#..##
#.........#
#.........#
....#..#..#
#.........#
#.........#
#.....#..##
#.........#
#####.#####

4
1
#####.#####
###.......#
#e#.......#
#...#.....#
#e#.#.....#
#e.........
#.........#
#.........#
#.........#
#.........#
#####l#####
enemies 3

3
0
#####.#####
#.........#
#.........#
#.#..#..#.#
#.........#
#..........
#..#......#
#.........#
#.........#
#.......#.#
###########

5
2
#####d#####
#.........#
#......#..#
#.......#.#
#.........#
..........#
#.........#
#.........#
#.........#
#.........#
#####.#####

6
2
#####.#####
#e.......e#
##.......##
#.........#
#..#.#.#..#
..........d
#..#......#
#.........#
##.....#.##
#e.......?#
#####.#####
enemies 3
sign Beware what lurks ahead.

7
1
#####d#####
#.........#
#.........#
#.........#
#.........#
#..........
#.........#
#.#.......#
#..#......#
#.........#
###########

4
3
###########
#.........#
#.........#
#.........#
#.........#
....##.#..#
#...####..#
#....#....#
#...#.##..#
#.......#k#
###########
key : 4

5
1
#####l#####
#.........#
##.#......#
#.........#
#...#.#.#.#
#..........
#....#.#..#
#.........#
#.#.#...#.#
#.........#
#####d#####
locked : 3

1
1
###########
#.........#
##.#...#.##
#.........#
#.....#.#.#
l.........#
#..#.#.#..#
#.........#
#.#.#.#.#.#
#.........#
#####.#####
locked : 0

7
3
#####.#####
#.........#
#.........#
#.........#
#.........#
..........#
#.........#
#.........#
#.........#
#........X#
###########

2
0
#####.#####
#?#.......#
#...#.....#
##........#
#..#@#....#
#...###....
#....#....#
#.........#
#.........#
#.........#
#####.#####
sign What you seek is close.

1
0
#####l#####
#.........#
#..##.....#
#k#.......#
#.........#
#.........l
#.........#
#.........#
#.........#
#.........#
#####.#####
key : 0

6
1
#####d#####
#.........#
#......#..#
#.......#.#
#.........#
#..........
#.........#
#.#.......#
#..#......#
#.........#
#####d#####

0
0
###########
#......#..#
#..##.##..#
#..###.#..#
#..###.#..#
#......#..#
#.........#
#.........#
#..##..#..#
#.........#
#####l#####
locked : 1

7
2
#####.#####
#.........#
#.........#
#.........#
#.........#
...........
#.........#
#.........#
#.........#
#.........#
###########

4
2
#####.#####
#......##k#
#.....##..#
#...###...#
#.........#
...........
#.........#
#.........#
#.........#
#.........#
#####d#####
key : 3

