1
0
#####.#####
##.....#..#
#.........#
#.........#
#k#..#..#.#
#.........l
#.........#
##..#..#..#
#.........#
#.........#
#####.#####
key : 1

4
2
###########
#.....s..e#
#..#..#...#
#.........#
#.........#
....#.....#
#.........#
#........e#
#..#..#..##
#.....?..e#
###########
enemies 3
switch 0 : 0
sign The dungeon remembers all who enter.

0
1
###########
#.........#
#.........#
#.........#
#.........#
...........
#...#e#e#.#
#....###?.#
#.....###.#
#.........#
#####.#####
enemies 2
sign Only the prepared may pass.

4
0
#####.#####
#.#.....#.#
#.........#
#.........#
#.#..#..#.#
#..........
#.........#
#.#..#..#.#
#.........#
#.........#
###########

2
2
#####.#####
#.........#
#..#...#..#
#...##....#
#....#.#..#
...#.#.....
#..##k#...#
#..#......#
#.........#
#.........#
###########
key : 2

4
1
#####.#####
#.........#
#.........#
#..#..#..##
#.........#
...........
#...#..#..#
#.........#
#.........#
#.........#
###########

1
4
###########
#........k#
#.........#
#.....#...#
#..##...#.#
....#.....#
#.##......#
#.........#
#.........#
#.........#
###########
key : 4

2
1
#####d#####
#.......#.#
#.........#
#.#...#.#.#
#.........#
....#.#....
#.........#
#.#.#.#.#.#
#.........#
#.#.....#.#
#####.#####

2
0
#####.#####
#.k#......#
#.#.......#
#..#......#
#..##.....#
#..........
#.........#
#.........#
#.........#
#.........#
#####.#####
key : 0

2
3
#####l#####
#.##......#
#.##......#
#.##......#
#..##.....#
.....e....#
#.........#
#.........#
#.........#
#.........#
#####.#####
locked : 1
boss
enemies 1

1
2
#####d#####
#.........#
#......#..#
#......#.##
#....#.#..#
.....###..d
#....#.##.#
#.........#
#.........#
#.........#
#####.#####

0
0
###########
#.........#
#.........#
#.........#
#.........#
#..........
#.....###.#
#.....#...#
#.....###.#
#.........#
#####.#####

3
1
#####.#####
#.........#
#.........#
#.........#
#.........#
d.........#
#.........#
#.........#
#.........#
#.........#
#####.#####

3
3
#####.#####
#.........#
#####.....#
#.##......#
#..#.#....#
#..#......#
#.#.......#
#.........#
#.........#
#X........#
###########

3
0
#####.#####
#.........#
#.........#
#..###....#
#.........#
#...#@....d
#.........#
#.........#
#.........#
#.........#
#####.#####

0
3
###########
#..#e....e#
#...#?##..#
#...####..#
#..###....#
..........#
#.........#
#..#......#
#.........#
#.........#
#####.#####
enemies 2
door 0 : 0
sign Many have walked this path.

0
2
###########
#.........#
#.........#
#.........#
#.........#
...........
#.........#
#.........#
#.........#
#.........#
#####d#####

1
1
#####.#####
#.........#
#.........#
#.........#
#.........#
l..........
#.........#
#.......#.#
#......#..#
#.........#
#####d#####
locked : 0

1
3
#####.#####
#.........#
#..#......#
#.#.......#
#.........#
d..........
#.#.......#
#.#.......#
#..#......#
##........#
#####l#####

