1
4
###########
#k........#
#.........#
#.........#
#.........#
#.........#
#.........#
#.........#
#.........#
#.........#
#####.#####
key : 2

4
1
#####.#####
#e........#
#..#......#
#.....###.#
#s.#.##e#.#
#e.........
#?........#
#.........#
#.........#
#.........#
#####d#####
enemies 3
switch 0 : 0 1
sign Many have walked this path.

5
1
#####d#####
##........#
#####.....#
####......#
#.###.#.#.#
#.....#...l
#.........#
#...#.....#
#.........#
#.........#
#####.#####

3
0
###########
#.........#
#.........#
#.......#.#
#..#...#..#
#..##@##...
#.........#
#....#.#..#
#..#...#..#
#.........#
###########

3
1
#####.#####
#e.#...#..#
#..#...#..#
#..#####..#
#...#e##..#
...........
#.........#
#.........#
#.........#
#?........#
#####.#####
enemies 2
sign The dungeon remembers all who enter.

0
2
###########
#.#.....#.#
#.........#
#....#.#.##
#.........#
#...#.#...#
#.........#
#..#...#..#
#.........#
#.......#.#
#####d#####

3
4
#####d#####
#.......#.#
#...#.#...#
#...###...#
#...e#.##.#
....##.#...
#.........#
#.........#
#.........#
#.........#
#####.#####
boss
enemies 1

2
4
#####.#####
#e........#
#.........#
#.........#
#.........#
.........e#
#.........#
#.........#
#.........#
#e........#
#####d#####
enemies 3
door 0 : 0 1

3
5
###########
#........X#
#.........#
#.........#
#.........#
..........#
#.........#
#.........#
#.........#
#.........#
###########

3
2
#####.#####
#.........#
#.........#
##..#..#..#
#.........#
...........
#.#.......#
#.........#
#.........#
##.....#..#
#####d#####

2
1
###########
#.........#
#..#......#
#.#.....#.#
#.........#
#..........
#..#......#
#.........#
#.........#
#.........#
#####.#####

4
2
#####d#####
#.........#
#......#..#
#.......#.#
#.........#
..........#
#.........#
#.........#
#.........#
#.........#
#####.#####

3
3
#####.#####
##........#
#k#.#.....#
#..##....##
#...##....#
...#.......
#.........#
#.........#
#.........#
#........##
###########
key : 0

1
2
#####d#####
#.........#
#..#...#..#
#.#.....#.#
#.........#
#.........#
#.........#
#.........#
#.........#
#.........#
#####l#####
locked : 0

2
3
###########
#.........#
#.........#
#.........#
#.........#
...........
#.........#
#.#.......#
#..#......#
#.........#
#####.#####

2
2
#####l#####
#.........#
#.........#
#.........#
#.........#
...........
#.........#
#.........#
#.........#
#.........#
#####.#####

6
1
#####.#####
#..#......#
#..#......#
#.#.......#
#.........#
#.........#
#.........#
#.........#
#.........#
#k.#......#
###########
key : 1

4
4
#####.#####
#.........#
#..#......#
#.#.......#
#.........#
#.........#
#.........#
#.........#
#.........#
#k........#
###########
key : 7

5
2
#####.#####
#.........#
#.........#
##........#
#..#......#
l.........#
#.........#
#.........#
#..#......#
#.........#
###########
locked : 1

