4
2
#####.#####
#.........#
#..#......#
#.#.......#
#.........#
..........#
#.........#
#.#.......#
#..#......#
#.........#
#####d#####

1
3
#####.#####
#.#.......#
#.........#
#.........#
#.........#
#....e....#
#.........#
#....#....#
#.........#
#.........#
#####l#####
locked : 9
boss
enemies 1

2
3
#####l#####
#.........#
#..#......#
#.#.......#
#.........#
#..........
#.........#
#.........#
#.........#
#.........#
#####d#####

5
2
#####d#####
#.#.....#.#
#.........#
#.#.#.#.#.#
#.........#
l..........
#.........#
#.#.#.#.#.#
#.........#
#.#.....#.#
###########
locked : 1

6
1
#####.#####
#.........#
#.........#
#.....##..#
#....###..#
....####..#
#...#.##..#
#...#.##..#
#.....###.#
#......##k#
###########
key : 2

0
3
###########
#X........#
#.........#
#.........#
#...##....#
#....##...#
#...#.#...#
#...#.#...#
#...#.#...#
#.........#
#####.#####

4
0
#####.#####
#.........#
#.........#
#.........#
#...@#..#.#
#....#.....
#....##...#
#....##.#.#
#.....##.##
#.........#
#####.#####

3
3
#####d#####
#.........#
#.........#
#.........#
#.........#
..........d
#.........#
#.........#
#.........#
#.........#
###########

5
1
#####.#####
#.#.....#.#
#.........#
#.........#
#..#......#
..........l
#.........#
#.#..#..#.#
#.........#
#.........#
#####.#####

3
1
###########
#..k......#
#..#......#
#.#.......#
#.........#
..........d
#.........#
#.......#.#
#......#..#
#.........#
#####.#####
key : 1

3
2
###########
#.........#
#.........#
#.........#
#.........#
d..........
#.........#
#.#.......#
#..#......#
#.........#
#####.#####

5
4
###########
#.........#
#......#..#
#.......#.#
#.........#
l.........#
#.#.......#
#.....#...#
#.......#.#
#.........#
###########
locked : 2

5
0
#####.#####
#.........#
#.........#
#...#.....#
#...#.....#
#?e##......
#e##......#
#.........#
#.........#
#.........#
#####.#####
enemies 2
sign What you seek is close.

6
0
#####.#####
#........##
#.........#
#.........#
#......#..#
#..........
#.........#
#.#.......#
#..#......#
#k........#
###########
key : 0

4
1
#####.#####
#.........#
#..#......#
#.#.......#
#.........#
...........
#.........#
#.......#.#
#......#..#
#.........#
#####.#####

2
4
###########
#........k#
#..#......#
#.#.......#
#.........#
..........#
#.........#
#.#.....#.#
#..#...#..#
#........##
#####.#####
key : 9

3
4
#####.#####
#..#......#
#.........#
#.........#
#......#..#
d.........#
#.........#
#..#..#...#
#.........#
#.........#
###########

5
3
###########
#.........#
##..#.....#
#.........#
#.........#
..........l
#.........#
#.........#
##..#..#..#
#.........#
###########

3
0
###########
#.........#
#.........#
##.##.....#
#.###.....#
#..#.......
#..#......#
#.#......##
#.........#
#.........#
#####.#####

