2
1
#####.#####
#.........#
#.........#
#.........#
#.........#
...........
#.........#
#.#.......#
#..#......#
#.........#
#####.#####

1
0
###########
#.........#
#..#......#
#.#.......#
#.........#
#..........
#.........#
#.#.......#
#..#......#
#.........#
#####.#####

0
1
###########
#.........#
#.........#
#.........#
#.........#
#..........
#.........#
#.#.......#
#..#......#
#.........#
#####d#####

2
2
#####.#####
#e........#
#.........#
##..#..#..#
#.........#
...........
#.#..#..#.#
#.........#
#.........#
#?........#
#####d#####
enemies 1
sign This door will not yield without a key.

0
3
###########
#.........#
#..#......#
#.#.......#
#.........#
..........#
#.........#
#.......#.#
#......#..#
#.........#
#####l#####
locked : 1

4
4
#####.#####
#.........#
#..#......#
#.........#
#.........#
#...###...#
#....#..#.#
#........##
#.....###X#
#.........#
###########

1
1
#####d#####
#.........#
#.#....#..#
#.....#e..#
#....#e#..#
...#......l
#...#.#...#
#...###...#
#...#.#...#
#.........#
#####.#####
enemies 2

0
2
###########
#.........#
#.........#
#.##......#
#.######..#
....#k#....
#..#...##.#
#..#..#...#
#.......#.#
#.........#
#####.#####
key : 1

2
3
#####.#####
#........##
###.......#
####....#.#
#.##..##..#
.....#k#..#
#.........#
#.........#
#.........#
#.........#
#####.#####
key : 2

1
4
###########
#........k#
#.##......#
#.##......#
#...#.....#
.....#....#
#.........#
#.........#
#.........#
#.........#
###########
key : 3

3
0
#####.#####
#.#.......#
#.........#
#..#.#.#.##
#.........#
#...#......
#.........#
#..#.....##
#.........#
#k#.......#
###########
key : 0

3
3
#####.#####
#e........#
#.........#
#..#.#....#
#..#......#
..........d
#.........#
#...#.....#
#.........#
#e...e....#
###########
enemies 3

3
4
###########
#.#.......#
#.#.#.....#
#...#.....#
#.........#
d....e....#
#.........#
#.........#
#.........#
#.........#
#####.#####
boss
enemies 1

3
2
#####d#####
##.#...#.##
#.........#
##.#...#.##
#.........#
...#.......
#.........#
##.#.#.#.##
#.........#
##.#...#.##
###########

2
0
#####.#####
#.........#
#.........#
#.........#
#...@.....#
#..#.#.....
#..###....#
#?####....#
##....#...#
##........#
#####.#####
sign What you seek is close.

1
2
#####.#####
#.........#
#.........#
#.........#
#..#......#
l..###....d
#.####....#
#.####....#
##.#......#
##........#
#####.#####
locked : 0

3
1
#####.#####
#.........#
#..#......#
#.##......#
#..##.....#
...........
#......#..#
#......#..#
#......#..#
#.........#
#####.#####

1
3
#####l#####
##.....#.##
#.........#
#.....#.#.#
#.........#
d..#.#.#...
#.........#
#.......#.#
#.........#
##.....#..#
#####.#####

4
1
#####.#####
#.#.......#
#..#......#
#.........#
#.........#
#.........#
#.........#
#.........#
#.........#
#.........#
###########

