1
0
###########
#e?......e#
#e........#
#.........#
#......#..#
#.........#
#.........#
#...#..#..#
#.........#
#.........#
#####.#####
enemies 3
sign Beware what lurks ahead.

2
3
###########
#.#.....#.#
#.........#
#..#.#.#..#
#.........#
d...#.#...d
#.........#
#..#...#.##
#.........#
#.......#.#
#####.#####

3
5
#####.#####
#.........#
#.##......#
#.##.#....#
#...###...#
..........#
#.........#
#.........#
#.........#
#........X#
###########

3
0
#####.#####
#.........#
#..#......#
#..##.....#
#..##.....#
#..........
#.........#
#.........#
#.........#
#.........#
#####.#####

4
0
#####.#####
#.........#
#.#.......#
#.......#.#
#.........#
#....@##..#
#.........#
#.........#
#.........#
#.........#
###########

3
3
#####.#####
##........#
#.........#
#.........#
#.#..#....#
...........
#.........#
##..#..#..#
#.........#
#e........#
#####d#####
enemies 1

3
4
#####.#####
#.........#
#.........#
#.........#
#.........#
....###....
#.........#
#...#.#...#
#.........#
#.........#
#####.#####

3
2
#####.#####
#.........#
#.........#
#.........#
#.........#
l..........
#.........#
#.#.......#
#..#......#
#.........#
#####.#####
locked : 0

2
1
###########
#....k....#
#.........#
#....##...#
#....#....#
.....#.....
#...#.....#
#......#..#
#.........#
#.........#
#####.#####
key : 0

2
4
###########
#.........#
#...#.#...#
#...#.#...#
#.....#...#
d..#.##...d
#...##....#
#.........#
#.........#
#.........#
#####.#####

3
1
#####.#####
#.........#
#.........#
#.........#
#.........#
..........l
#.........#
#.........#
#.........#
#.........#
###########

2
2
#####l#####
#k........#
#.........#
#...##....#
#..###....#
...##.....d
#.........#
#.........#
#.........#
#.........#
#####.#####
key : 2

4
2
#####.#####
#.........#
#.........#
#.........#
#.........#
#..........
#.........#
#.#.......#
#..#......#
#.........#
###########

1
2
#####.#####
#.........#
#......#..#
#.......#.#
#.........#
#.........#
#.........#
#.........#
#.........#
#.........#
#####l#####
locked : 2

4
3
#####d#####
#.........#
#..#......#
#.#.......#
#.........#
...........
#.......#.#
#.........#
#...#.#...#
#.........#
###########

0
2
###########
##.....#.k#
#.........#
#.........#
#.#..#..#.#
#.........#
#.........#
#...#..#..#
#.........#
#.........#
#####.#####
key : 5

4
4
#####.#####
#.........#
#.........#
#.........#
#.........#
..........#
#.........#
#.........#
#.........#
#.......#k#
###########
key : 6

2
5
###########
#.........#
#.........#
#.........#
#.........#
d....e....#
#.........#
#.........#
#.........#
#.........#
#####.#####
boss
enemies 1

2
0
#####.#####
#.........#
#..#......#
#.#.......#
#.........#
#..........
#.........#
#.#.......#
#..#......#
#.........#
#####.#####

