3
1
#####.#####
#e........#
#..#...#..#
#....###..#
#..#e#e...#
...#####...
#....#....#
#.........#
#.........#
#.........#
#####.#####
enemies 3

6
0
###########
#X........#
#..#..#...#
#......#..#
#.........#
#..##..#...
#..##.#...#
#....#....#
#.........#
#.........#
###########

2
1
#####.#####
#.........#
#.###.#...#
#.#.#.....#
#.#.#.....#
....#......
#.........#
#.....#...#
#.........#
#.........#
#####.#####

6
2
#####.#####
##.....#.##
#.........#
##.#...#.##
#.........#
.....#.#..#
#.........#
##.#.#.#..#
#.........#
##.#...#.##
###########

1
0
#####.#####
#.........#
#.........#
#.........#
#.........#
#.........d
#.........#
#.........#
#.........#
#.........#
#####.#####

5
2
#####.#####
#.#.......#
#.........#
##.#......#
#..##.....#
...#......#
#.##......#
#..#.....##
#.........#
#..#......#
#####.#####

6
1
#####d#####
#.........#
#.........#
#.........#
#.........#
.....e.....
#.........#
#.........#
#.........#
#.........#
#####.#####
boss
enemies 1

7
1
#####.#####
#.........#
#.........#
#....#....#
#...##....#
#...#.....#
#.........#
#.........#
#.........#
#k........#
###########
key : 10

1
1
###########
#.........#
##..#..#..#
#.........#
#.........#
d...#.....#
#.........#
#.........#
#...#..#..#
#.........#
#####.#####

5
1
#####l#####
#.........#
#.........#
#.........#
#.........#
#..........
#.........#
#.#.......#
#..#......#
#.........#
#####d#####
locked : 1

2
2
###########
#e..e..?..#
##..#..#..#
#.........#
#.........#
...........
#.........#
#.........#
##..#..#..#
#e........#
#####.#####
enemies 3
sign A useful tool lies just ahead.

4
0
#####.#####
#.........#
#.........#
#.........#
#.........#
#..........
#.........#
#.........#
#.........#
#.........#
###########

0
0
###########
#.........#
#.........#
#.........#
#.......#.#
#.........#
#.........#
#.........#
#.........#
#.........#
#####.#####

3
0
#####d#####
#.......###
#......##.#
#.....#.#.#
#.....#...#
#..........
#.........#
#.........#
#.........#
#.........#
#####.#####

4
2
#####d#####
#.........#
#..#...#.##
#.........#
#....#.#..#
..........#
#..#.#.#..#
#.........#
#..#...#.##
#.........#
#####.#####

2
0
#####.#####
#.........#
#.....#...#
#.#..#....#
#.....#...#
#..##@#....
#.###.....#
#....#....#
#.........#
#.........#
#####d#####

3
2
#####.#####
#.........#
#......#..#
#.......#k#
#.........#
..........#
#.........#
#.......#.#
#.#....#..#
#.........#
#####d#####
key : 2

2
3
###########
#..#.....##
#.........#
#.........#
#..#..#...#
..........#
#.........#
#..#..#...#
#.........#
#........k#
###########
key : 3

4
1
#####.#####
#.........#
#.....#.#.#
#.#...#.#.#
#..#......#
.....###...
#..##k#...#
###.......#
#.........#
#.........#
#####l#####
key : 1

