5
1
#####.#####
#.........#
#.........#
#.........#
#.........#
d..........
#.........#
#.........#
#.........#
#.........#
###########

2
3
#####.#####
#e#e......#
#.###.....#
#.##......#
#.##..#...#
...####...#
#.........#
#.........#
#.........#
#.........#
#####.#####
enemies 2
door 0 : 0

1
0
###########
#k........#
#.........#
#..#.#.#..#
#...###...#
#....##...#
#......#..#
#..####...#
#.........#
#.........#
#####.#####
key : 1

1
3
###########
#........k#
#.........#
#.........#
#.........#
..........#
#.........#
#.........#
#.........#
#.........#
#####.#####
key : 7

5
2
#####.#####
#.#.....#.#
#.........#
#..#.#.#.##
#.........#
....#.#...#
#.........#
#..#...#.##
#.........#
#.#.......#
###########

3
2
#####.#####
#.........#
#.#...#.#.#
#.........#
#..#.#.#..#
..........d
#.#.#.#.#.#
#.........#
#..#...#..#
#.........#
#####.#####

4
2
#####.#####
#.........#
#........e#
#..#..#..##
#........e#
.........s#
#...#..#..#
#.........#
#........?#
#..#.....##
#####.#####
enemies 2
switch 0 : 0
sign A locked path — look elsewhere first.

3
1
#####.#####
#.........#
#.........#
#.........#
#.........#
...........
#.........#
#......#..#
#.........#
#.........#
#####.#####

5
0
#####.#####
#.......#.#
#.........#
#.#...#.#.#
#.........#
#...#.....d
#.........#
#.#.....#.#
#.........#
#.#.....#.#
#####.#####

6
0
#####.#####
#.........#
#.........#
##..#..#..#
#.........#
#.........#
#...#.....#
#.........#
#.........#
##.......k#
###########
key : 2

3
3
#####.#####
#.........#
#..#...#..#
#.#.....#.#
#.........#
d.........#
#.........#
#.........#
#.........#
#.........#
###########

0
2
###########
#X........#
#.........#
#.#.......#
#.###.....#
#..#......#
#.........#
#.........#
#.........#
#.........#
#####.#####

2
1
###########
#......#..#
#.........#
#.........#
#....#..#.#
d..........
#.........#
##..#.....#
#.........#
#.........#
#####.#####

4
1
#####.#####
#..#.....##
#.........#
#...#.....#
#.........#
l..#.#.#...
#.........#
#.#.#...#.#
#.........#
##.#...#..#
#####.#####
locked : 0

2
2
#####d#####
#e........#
#.........#
#.........#
#.........#
...........
#.........#
#.........#
#.........#
#e........#
#####.#####
enemies 2

3
0
#####.#####
#.........#
#.........#
#.........#
#?#.......#
#..#.@.....
#..##.....#
#.....#...#
#.........#
#.........#
#####.#####
sign Those who search shall find.

4
0
#####.#####
#.........#
#.........#
#.........#
#.........#
#..#.##...l
#.#..#....#
#.k#..#...#
#.#.#.....#
#.#.......#
#####.#####
key : 0

1
2
#####.#####
#.........#
#.........#
#.........#
#.........#
#....e.....
#.........#
#.........#
#.........#
#.........#
#####d#####
boss
enemies 1

2
0
#####.#####
#.........#
#..#......#
#..###....#
#..#......#
#.........d
#.........#
#.........#
#.........#
#.........#
#####.#####

