3
2
#####.#####
#e........#
#.........#
#.#..#..#.#
#.........#
...........
#.#..#..#.#
#.........#
#.........#
#?......#e#
#####.#####
enemies 2
sign Something glints behind that door…

3
3
#####d#####
#.#.....#.#
#.........#
#..#...#.##
#.........#
...........
#.........#
#..#.....##
#.........#
#.#.....#.#
#####d#####

2
2
#####.#####
#.........#
#..#..#..##
#.........#
#.........#
....#..#...
#.........#
#.........#
#..#.....##
#.........#
#####.#####

1
3
###########
#......k..#
#......#..#
#.......#.#
#.........#
...........
#.........#
#.......#.#
#......#..#
#.........#
#####.#####
key : 4

0
2
###########
#e.......e#
#s........#
#.........#
#......#..#
#.........#
#.........#
#..#..#..##
#.........#
#.........#
#####.#####
enemies 2
switch 0 : 0 1

3
0
###########
#?........#
#.........#
#.........#
#.........#
#....@.....
#.........#
#.........#
#.........#
#.........#
###########
sign A useful tool lies just ahead.

4
3
#####d#####
#.........#
#..#......#
#.#.......#
#.........#
..........#
#.........#
#.#.......#
#.........#
#.........#
###########

2
1
#####d#####
#.........#
#.........#
##..#..#..#
#.........#
#..........
#.#.....#.#
#.........#
#.........#
##........#
#####.#####

2
5
###########
#........X#
#.###.#...#
#.###.....#
#..##.....#
....#.#...#
#...###...#
#.........#
#.........#
#.#.......#
###########

1
2
#####.#####
#k........#
#.........#
#.........#
#.........#
...........
#.........#
#.#.....#.#
#..#...#..#
#.........#
#####.#####
key : 3

5
1
#####d#####
#.........#
#...#.....#
#..###.#..#
#..###.#..#
#..#####..#
#..#.#.#..#
#..#......#
#...#..#..#
#.........#
###########

3
4
#####.#####
#.........#
#.........#
#.........#
#.........#
..........#
#.........#
#.......#.#
#......#..#
#.........#
###########

2
4
#####.#####
#.........#
#.........#
#.........#
#.........#
l....e.....
#.........#
#.........#
#.........#
#.........#
#####.#####
locked : 3
boss
enemies 1

4
2
#####.#####
#k#.....#.#
#.........#
#.........#
#..#..#...#
...........
#.........#
#.#..#..#.#
#.........#
#.........#
###########
key : 1

1
4
###########
#......?ee#
#.......#e#
#.........#
#.........#
..........#
#.........#
#......#..#
#.........#
#.........#
#####.#####
enemies 3
door 0 : 0 1
sign Seek the matching key before you proceed.

3
1
#####.#####
#.........#
#.#.......#
#.####....#
#.####....#
....k#.#...
#..##..#..#
#..#.#....#
#.........#
#.........#
#####l#####
key : 0

4
1
#####l#####
#.........#
#.#.#.#.#.#
#.........#
#...#.#.#.#
#..........
#.#...#.#.#
#.........#
#.#...#.#.#
#.........#
#####d#####
locked : 0

2
3
#####.#####
##.#...#.##
#.........#
##...#.#.##
#.........#
...#.#.#..l
#.........#
#..#.#.#..#
#.........#
##.......##
#####d#####

1
1
###########
#.........#
#.........#
#.........#
#.........#
#..........
#.........#
#.......#.#
#......#..#
#.........#
#####d#####

