2
3
#####d#####
#.........#
#..#...#..#
#.#.....#.#
#.........#
D.........D
#.........#
#.........#
#.........#
#.........#
#####D#####

3
0
#####D#####
#.#.....#.#
#.........#
#.#...#.#.#
#.........#
#.....#...#
#.........#
#.#.#.#.#.#
#.........#
#.#.......#
###########

3
4
#####D#####
#..#......#
#..##.....#
#..#.#.##.#
#.....#...#
l.....##..#
#.........#
#.........#
#.........#
#.........#
#####D#####
locked : 3

2
4
#####D#####
#k........#
#.........#
#.........#
#.........#
D.........D
#.........#
#.......#.#
#......#..#
#.........#
#####D#####
key : 2

2
2
###########
#.........#
#.#.#.#.#.#
#.........#
#...#.#.#.#
d.........D
#...#.#.#.#
#.........#
#.#.#.#.#.#
#.........#
###########

5
4
#####d#####
#......#..#
#.....##..#
#....#.#.p#
#.........#
#....e....#
#.........#
#.........#
#.........#
#.p.......#
#####D#####
boss
enemies 1

1
3
#####l#####
#.........#
#......#..#
#.......#.#
#.........#
#.........D
#.........#
#.......#.#
#......#..#
#.........#
#####d#####

1
0
###########
#e........#
##.#...#.##
#s........#
#..#.#....#
#.........D
#..#.#.#..#
#.........#
#..#...#..#
#.........#
#####D#####
enemies 1
switch 0 : 0

2
0
#####D#####
##.#......#
#..##.....#
##.###....#
#..###....#
#....@....D
#.........#
#.........#
#.........#
#.........#
#####D#####

6
4
#####D#####
#..#......#
#.........#
#.#.......#
#.........#
#.........#
#.........#
#.........#
#.........#
#X........#
###########

3
3
#####D#####
#.........#
#..#......#
#.#.......#
#.........#
#.........l
#.........#
#.#.....#.#
#..#...#..#
#.........#
#####D#####

1
4
#####D#####
#.........#
#..#......#
#.#.......#
#.........#
D.........#
#.........#
#.......#k#
#......#..#
#.........#
#####D#####
key : 3

4
3
#####D#####
#.........#
#......#..#
#.......#.#
#.........#
#.........D
#.........#
#.........#
#.........#
#.........#
###########

0
4
###########
#.........#
#.........#
#.........#
#.........#
d.........#
#.........#
#.........#
#.........#
#.........#
#####D#####

2
1
#####D#####
#.........#
#......#..#
#.......#.#
#.........#
D..#......d
#.....#...#
#....#..#.#
#......#..#
#......k..#
###########
key : 0

0
3
###########
#.........#
#..#..#...#
#.........#
#.........#
#...#..#..d
#.........#
#.........#
#..#..#..##
#.........#
#####l#####
locked : 2

1
1
###########
#........k#
#.........#
#...#.....#
#.........#
D.........#
#.#..#..#.#
#.........#
#.........#
##.....#..#
#####D#####
key : 1

4
4
#####D#####
#.........#
##.#...#.##
#.........#
#.#.#...#.#
D.........#
#..#.#....#
#.........#
#.#.#.#.#.#
#.........#
#####d#####

2
5
###########
#........e#
#.........#
#.........#
#..###....#
D...##.#..#
#..#..#e..#
#.....##..#
#..#..##..#
#........e#
###########
enemies 3
door 0 : 0

