2
3
###########
#.........#
#.........#
#..#.....##
#.........#
D.........D
#...#..#..#
#.........#
#.........#
#........##
#####l#####
locked : 1

3
4
#####d#####
#.........#
#.........#
#.........#
#.........#
D.........#
#.........#
#.........#
#.........#
#.........#
###########

6
1
#####D#####
#k##......#
#..#..#...#
#...#..#..#
#...##.#..#
D.........#
#.........#
###.......#
#.........#
#.........#
#####D#####
key : 1

7
1
#####D#####
#.........#
#.........#
#.........#
#.....##..#
#..#.#.#..#
#.###.....#
#.##..##..#
#.##..#.#.#
#.k#......#
###########
key : 3

3
3
#####l#####
#.........#
#......#..#
#.........#
#.........#
D.........D
#.........#
#.#.......#
#.##......#
#.........#
#####D#####

1
2
###########
####......#
##.#......#
##.#......#
#.........#
#.........#
#.........#
#.........#
#.........#
#.........#
#####d#####

4
2
#####D#####
#e.......e#
#.........#
#.........#
#.........#
D.........D
#.........#
#.........#
#.........#
#e.......?#
#####D#####
enemies 3
sign A locked path — look elsewhere first.

4
3
#####D#####
#.........#
#.....##..#
#.....##..#
#.........#
D.........#
#.........#
#.........#
#.........#
#.........#
###########

4
1
###########
#k#.......#
#.........#
#.........#
#....#..#.#
#.........D
#.........#
#.#..#..#.#
#.........#
#.........#
#####D#####
key : 2

3
2
#####D#####
#.........#
#..#.....##
#.........#
#.........#
#..#..#...D
#.........#
#.........#
#..#..#..##
#.........#
#####D#####

1
4
#####D#####
#.........#
###.#.....#
##.#......#
#..#e#....#
#..#.##...#
#...#.....#
#.........#
#.........#
#.........#
#####d#####
boss
enemies 1

5
1
#####D#####
#e.......e#
#.#.......#
#.........#
#.........#
D....#....l
#.........#
#.........#
#.#.....#.#
#e........#
#####D#####
enemies 3

0
4
###########
#X##......#
#.#.#.....#
#.#.......#
#.##......#
#...#.....#
#.........#
#.........#
#.........#
#.........#
#####D#####

6
0
#####D#####
#.........#
#.........#
#.........#
#.........#
#....#....D
#.#.......#
#.##......#
#k........#
###.......#
###########
key : 0

5
2
#####D#####
#.........#
#.........#
#.........#
#.........#
l.........#
#.........#
#.........#
#.........#
#.........#
###########
locked : 0

5
0
###########
#?........#
#.........#
#.........#
#.........#
#....@....D
#.........#
#.........#
#.........#
#.........#
#####D#####
sign A useful tool lies just ahead.

2
2
#####d#####
#e#.......#
#.........#
#....#.#.##
#.........#
#...#.#...D
#.........#
#....#.#.##
#.........#
#.........#
#####D#####
enemies 1

2
4
#####d#####
#.........#
#.#...#.#.#
#.........#
#.#.#.#.#.#
D.........d
#.#.#.#.#.#
#.........#
#.#.#.#.#.#
#.........#
#####d#####

2
5
###########
#.........#
#.........#
#..#..#..##
#.........#
d.........#
#...#.....#
#.........#
#.........#
#..#.....##
###########

