2
0
###########
#.........#
#.........#
#.........#
#..##.....#
#..###.....
#..#.#....#
#.........#
#.........#
#.........#
#####.#####

1
1
#####.#####
#.........#
#.........#
#.........#
#.........#
#.........l
#.........#
#.........#
#.........#
#.........#
#####d#####

5
0
#####.#####
#........##
#.........#
#.........#
#..#......#
#.........#
#.........#
#.....#...#
#.........#
#.........#
###########

2
1
#####d#####
#.........#
#.........#
#.#..#..#.#
#.........#
..........d
#.#..#....#
#.........#
#.........#
#e#.....#.#
#####.#####
enemies 1

2
3
#####.#####
#k........#
#..#...#..#
#.#.....#.#
#.....#...#
..........d
#.........#
#.#.....#.#
#..#...#..#
##........#
#####.#####
key : 1

3
0
#####.#####
#.........#
#.........#
#.........#
#.........#
#..........
#.........#
#.#.......#
#..#......#
#.........#
#####.#####

4
1
#####.#####
#.........#
#......#..#
#.......#.#
#.........#
..........#
#.........#
#.#.......#
#..#......#
#.........#
###########

3
2
#####.#####
#.........#
#.....##..#
#..#......#
#..#.###..#
...#####...
#..####...#
#.........#
#.........#
#.........#
###########

1
2
#####.#####
#.........#
#...#.....#
#....#..#.#
#..##...#.#
l.....#....
#.........#
#.........#
#.........#
#.........#
#####.#####
locked : 1

2
4
#####d#####
#.#.....#.#
#.........#
#..#.#.#.##
#.........#
d...#.....#
#.........#
#....#.#.##
#.........#
#.......#.#
###########

2
2
#####.#####
#.........#
#.........#
#.........#
#.#.......#
d..#.......
#.........#
#.........#
#.........#
#.........#
#####.#####

3
1
#####.#####
#.........#
#.........#
#.........#
#.........#
...........
#.........#
#.#.....#.#
#..#...#..#
#.........#
#####.#####

4
0
#####.#####
#.........#
#.##..###.#
#..#..##..#
#.#.###...#
#...@##....
#...#.....#
#.........#
#.........#
#.........#
#####.#####

1
4
#####.#####
#.#.......#
#..##.....#
#.###.....#
#.##......#
.....e....#
#.........#
#.###.....#
#.##......#
#.........#
#####d#####
boss
enemies 1

0
4
###########
#X........#
#.........#
#...##....#
#.#.##....#
#...##....#
#..###....#
####.#....#
###.......#
###.......#
#####.#####

3
3
#####.#####
#..#...#..#
#.........#
#...###...#
#....#....#
...#.###..#
#.........#
#.........#
#.........#
#........k#
###########
key : 3

0
1
###########
#k........#
#.........#
#.........#
#.........#
#..........
#.........#
#.........#
#..#......#
#.......#.#
#####.#####
key : 2

1
3
###########
#.........#
#.........#
#....#.#.##
#.....#.#.#
.....#.....
#....##...#
#....#...##
#.........#
#.........#
#####.#####

0
2
###########
#........k#
#......#..#
#.......#.#
#.........#
..........#
#.........#
#.#.......#
#..#......#
#.........#
#####.#####
key : 4

