2
2
#####.#####
#.........#
#.........#
##.#......#
#..#.#....#
...#......d
#.........#
#.........#
#.........#
#.........#
#####.#####

2
5
#####.#####
##.#......#
##..#.....#
###.......#
#..##.....#
d...#e.....
#.........#
#.........#
#.........#
#.........#
#####.#####
boss
enemies 1

1
5
###########
#.......ee#
#.###.....#
##.##.....#
#..##.....#
....#.....#
#.##.#....#
#..#......#
###.......#
#.........#
#####.#####
enemies 2

1
0
###########
#.........#
#.........#
#.........#
#.........#
#....@.....
#.........#
#.........#
#.........#
#.........#
###########

0
1
###########
#.........#
#.........#
#....#.#..#
#..#.#.#..#
#....###..#
#.....#...#
#..#.#....#
#.........#
#.........#
#####l#####
locked : 0

1
2
###########
#.........#
#.#.......#
#.#...#.#.#
#..#....#.#
......#...#
#.........#
#.........#
#.........#
#.........#
#####.#####

3
4
#####l#####
#.........#
##.#...#.##
#.........#
#..#.#....#
d..........
#..#.#.#..#
#.........#
##.#...#.##
#.........#
###########

1
4
###########
#.........#
#.........#
#.........#
#.........#
#..........
#...###...#
#...###...#
#.....#...#
#.........#
#####.#####

1
1
#####l#####
#k........#
#.........#
#.........#
#.........#
...........
#.........#
#.........#
#.........#
#.........#
#####.#####
key : 0

3
2
#####.#####
#.........#
#.........#
#.........#
#.........#
..........d
#.........#
#.........#
#.........#
#.........#
#####.#####

3
1
#####l#####
#..#.....##
#.........#
#.........#
#..#......#
#..........
#.........#
#.....#..##
#.........#
#.........#
#####.#####
locked : 1

4
1
#####.#####
#.......#.#
#.........#
#..#.#.#.##
#.........#
#...#.#....
#.........#
#..#.#.#.##
#.........#
#.......#.#
###########

3
5
#####.#####
#.........#
#.........#
#.........#
#.........#
..........#
#.........#
#....#....#
#.........#
#........X#
###########

3
3
#####.#####
#.........#
#......#..#
#.......#.#
#.........#
d.........d
#.........#
#.....#...#
#...#.....#
#.........#
###########

2
3
###########
##........#
#.........#
#.........#
#...#..#..#
d..........
#.........#
##..#..#..#
#.........#
#.........#
#####.#####

2
1
#####.#####
#.........#
#..#......#
#k#.......#
#.........#
#..........
#.........#
#.........#
#.........#
#.........#
#####l#####
key : 1

4
2
#####.#####
#.........#
#.........#
#.........#
#.........#
..........#
#.........#
#.........#
#.........#
#........k#
###########
key : 4

2
6
###########
#........k#
#.#.#.....#
#.........#
#.#.#...#.#
..........#
#.#.#.#...#
#.........#
#.#.#.#.#.#
#.........#
###########
key : 5

2
4
#####.#####
####......#
#...#.....#
#.#.##....#
#..#.##...#
......#...d
#.........#
#.........#
#.........#
#.........#
#####l#####
locked : 4

