3
1
#####.#####
#e........#
#...#.#.#.#
#.........#
#...#.#.#.#
...........
#...#...#.#
#.........#
#.#.#...#.#
#e........#
#####.#####
enemies 2

4
2
#####l#####
#k.#......#
#.........#
#.........#
#..#..#...#
...........
#.........#
#.....#..##
#.........#
#.........#
#####d#####
key : 3

4
4
###########
#.....?.ee#
#.#.#.#.#e#
#.........#
#.#.....#.#
..........#
#.#...#.#.#
#.........#
#.#...#.#.#
#.........#
#####.#####
enemies 3
sign The dungeon remembers all who enter.

3
0
#####d#####
##.....####
#.....##..#
#.......#.#
#...@..#..#
#....##....
#.........#
#.........#
#.........#
#.........#
#####.#####

2
0
#####.#####
#.........#
#.#.......#
#.........#
#.........#
#....#.....
#.........#
#.........#
#.#.....#.#
#.........#
#####d#####

5
0
#####.#####
#.........#
#.........#
#.........#
#.........#
#.........#
#.........#
#.........#
#.........#
#.........#
###########

2
1
#####l#####
#.........#
#......#..#
#.......#k#
#.........#
..........#
#.........#
#.......#.#
#......#..#
#.........#
#####.#####
key : 1

5
2
#####d#####
#.........#
#.........#
#.........#
#.........#
#..........
#.........#
#.#.......#
#..#......#
#.........#
###########

4
3
###########
#.#.....#.#
#.........#
#.........#
#.#.....#.#
...........
#.........#
#.#..#..#.#
#.........#
#.........#
#####d#####

4
0
#####.#####
#.........#
#.........#
#.........#
#.........#
#.....#....
#.......#.#
#.#...#.#.#
#..#...#..#
#.........#
#####.#####

1
0
#####d#####
#.........#
#.........#
#.........#
#.........#
#..........
#.........#
#.........#
#.........#
#.........#
#####.#####

1
1
###########
#.........#
#.........#
#.........#
#.........#
...........
#.........#
#.#.....#.#
#..#...#..#
#.........#
#####l#####
locked : 1

1
2
###########
#........e#
#.....#e#.#
#....#.##.#
#.##...#..#
...#.##...#
#.#.#.##..#
#...#.....#
####......#
#.........#
###########
enemies 2

5
3
#####d#####
#.........#
#.........#
#.........#
#.........#
.....e.....
#.....#...#
#....###..#
#.........#
#.........#
#####.#####
boss
enemies 1

4
1
#####.#####
#........k#
#..#..#..##
#.........#
#.........#
.......#...
#.........#
#.........#
#..#.....##
#.........#
###########
key : 0

3
2
###########
#.........#
#.........#
#.........#
#.#.......#
..........#
#..#......#
##.#......#
###.#....##
#.........#
#####l#####
locked : 0

5
4
#####.#####
#.........#
#.........#
#.........#
#.........#
......#...#
#.....###.#
#.........#
#.........#
#........X#
###########

0
0
###########
#.........#
#.........#
#.........#
#.........#
#..##.....#
#..###....#
#.##..#...#
#.###.....#
####......#
#####d#####

6
3
#####.#####
#.........#
#......#..#
#.......#.#
#.........#
#.........#
#.........#
#.#.......#
#..#......#
#k........#
###########
key : 5

