0
0
###########
#k........#
#..#......#
#.#.......#
#.........#
#.........#
#.........#
#.#.....#.#
#..#...#..#
#.........#
#####.#####
key : 0

3
3
#####.#####
#.........#
#.........#
#.........#
#...e..#..#
...#.#.....
#..#......#
#.........#
#.#......##
#.##......#
#####d#####
boss
enemies 1

5
2
#####.#####
#.........#
#..#...#..#
#.#.....#.#
#.........#
#..........
#.........#
#.........#
#.........#
#.........#
#####d#####

3
1
#####.#####
#.........#
#...#...#.#
#.........#
#.#.#...#.#
l..........
#.#.#.#.#.#
#.........#
#.#.#.#.#.#
#.........#
#####l#####
locked : 1

6
2
#####d#####
#.........#
#..#......#
#.#.......#
#.........#
#.........#
#.........#
#.#.......#
#..#......#
#.........#
###########

2
2
#####l#####
#.........#
#..#......#
#.#.......#
#.........#
d..........
#.........#
#.........#
#.........#
#.........#
#####.#####

3
4
###########
#........X#
##.##.#.#.#
####.##...#
#.##.##...#
.....#....#
#..#......#
#.........#
#.........#
#.........#
###########

1
2
###########
#.........#
#.........#
#.........#
#.........#
..........#
#.........#
#.........#
#.........#
#.........#
#####l#####
locked : 3

1
0
#####.#####
#.........#
#.....#.#.#
#.........#
#..##.#...#
#...##.....
#..#@.#...#
#..#.#.#..#
#..#......#
#.........#
#####.#####

3
2
#####.#####
#k........#
#.........#
##..#..#..#
#.........#
...........
#....#..#.#
#.........#
#.........#
##........#
#####.#####
key : 3

4
2
#####.#####
#k........#
#.........#
#..#..#...#
#.........#
..........d
#.....#...#
#.........#
#.........#
#..#.....##
#####.#####
key : 4

2
3
###########
#.........#
#......#..#
##......#.#
#.........#
..........#
#.........#
#.........#
#.........#
#.........#
#####.#####

5
3
#####.#####
#.........#
#..##.....#
#....#....#
#.#.###...#
.....#e...#
#.....#...#
#.........#
##........#
#........e#
###########
enemies 2

2
0
#####.#####
#.........#
#......#..#
#.......#.#
#.........#
#..........
#.........#
#.#.....#.#
#..#...#..#
#.........#
#####.#####

4
3
#####d#####
#..#......#
#..##.....#
#.........#
#.........#
d.........#
#.........#
#.#.......#
#..#......#
#.........#
#####.#####

3
0
#####.#####
##.#.....##
#.........#
#...#.#.#.#
#.........#
#..#.#.#..l
#.........#
#...#.#.#.#
#.........#
##k#...#.##
###########
key : 1

1
1
###########
#...e....?#
#...#....##
#.........#
#.........#
.....#.....
#.##...#..#
#.#..##...#
#.........#
#.........#
#####.#####
enemies 1
sign Turn back; you are not yet ready.

4
1
#####l#####
#.........#
#..#...#..#
#.#.....#.#
#.........#
#..........
#.........#
#.........#
#.........#
##........#
###########
locked : 0

2
1
#####.#####
#.........#
#..#......#
#.#.......#
#.........#
..........d
#.........#
#.........#
#.........#
#.........#
#####.#####

