3
2
#####D#####
#.........#
#.....#..##
#.........#
#.........#
D...#..#..#
#.........#
#........s#
#.....#..##
#.....?..e#
###########
enemies 1
switch 0 : 0
sign What you seek is close.

2
1
#####D#####
#.........#
#.........#
#..##.....#
#.##......#
D..##.....d
#.........#
#.........#
#.........#
#.........#
#####D#####

0
1
###########
#.........#
#..#......#
#..##.....#
#..##.....#
D.........#
#...#.....#
#.........#
#.###.....#
#p........#
#####D#####

6
1
#####D#####
#.........#
#.....##..#
#..###k#..#
#...#..#..#
D...#.##..#
#.........#
#.#.......#
#.........#
#.........#
#####D#####
key : 5

3
0
#####D#####
#........?#
#........##
#.....#...#
#.........#
#....@....D
#...#.###.#
#.....##..#
#.....##..#
#......##.#
#####l#####
sign Seek the matching key before you proceed.

3
1
#####D#####
#k........#
#.........#
##..#..#..#
#.........#
D.........D
#...#..#..#
#.........#
#.........#
##.....#..#
#####D#####
key : 0

1
1
#####D#####
#.........#
#......#..#
#.......#.#
#.........#
d.........#
#.........#
#.........#
#.........#
#.........#
#####D#####

4
0
#####l#####
#.........#
#..#...#..#
#.#.....#.#
#.........#
#.........D
#.........#
#.#.......#
#..#......#
#.........#
#####D#####
locked : 0

4
1
#####D#####
#.........#
#.........#
#.........#
#.........#
D.........#
#.........#
#.........#
#.........#
#.........#
#####D#####

7
0
#####l#####
#.........#
#...#..##.#
#...##..#.#
#...e#.##.#
#...##....D
#...####p.#
#...#.....#
#......p..#
#.........#
#####D#####
locked : 2
boss
enemies 1

5
1
#####D#####
#.........#
#..##.#...#
#.####....#
#.#.####..#
D....k#...#
#.####....#
#.###.....#
#.........#
#.........#
#####D#####
key : 8

2
0
#####D#####
#.#.......#
#.........#
#.........#
#....#..#.#
#.........D
#.........#
#....#....#
#.........#
#.........#
#####D#####

5
0
#####D#####
#.........#
#.#.#.....#
#.........#
#k#.#.#...#
#.........D
#...#.#...#
#.........#
#.#.#...#.#
#.........#
#####d#####
key : 2

2
2
###########
#.........#
#.......#.#
#.........#
#.........#
d..#..#...#
#.........#
#.........#
#.#.....#.#
#.........#
#####D#####

7
1
#####D#####
#..#...#..#
#.....#...#
#..#...#..#
#..#.###..#
D.....e#..#
#.....#...#
#.........#
#........?#
#.#.....ee#
###########
enemies 3
door 0 : 0
sign A locked path — look elsewhere first.

8
0
#####D#####
#.........#
#.........#
#.........#
#.........#
#.........#
#.........#
#.........#
#.........#
#X........#
###########

6
0
#####d#####
#.........#
#........##
#.........#
#.........#
#......#..D
#.........#
#.......#.#
#......#..#
#.........#
#####l#####

1
0
#####d#####
#.........#
#.........#
#.........#
#.......#.#
#.........d
#.......#.#
#.#.......#
#.##......#
#.........#
#####D#####

0
0
###########
#.........#
#......#..#
#.......#.#
#.........#
#.........D
#.........#
#.........#
#.........#
#.........#
#####d#####

