6
4
#####D#####
#.........#
#.........#
#.........#
#.........#
#.........#
#.........#
#.........#
#.........#
#X........#
###########

0
3
###########
#.........#
#.........#
#...#.##..#
#....#....#
D.....##..#
#.......#.#
##...###..#
#.........#
#.........#
#####d#####

0
2
###########
#e..e.....#
#?..#.....#
#.........#
#.........#
#......#..D
#.........#
#.........#
##..#.....#
#.........#
#####D#####
enemies 2
door 0 : 0 1
sign The brave are rewarded.

2
5
###########
#.........#
#.........#
#.........#
#.........#
d.........#
#.........#
#.......#.#
#......#..#
#.........#
###########

1
3
#####d#####
##.#...#..#
#.........#
#....#...##
#.........#
l..#...#..D
#.........#
##.#.#.#..#
#.........#
#..#...#.##
#####D#####
locked : 1

2
2
#####D#####
##.#.....##
#.........#
##.#.#.#.##
#.........#
D..#.#....d
#.........#
##.#.#.#.##
#.........#
#......#.##
###########

4
5
###########
#........k#
#.........#
#....##...#
#..#..#...#
D..#.#....#
#.#.###...#
#.#.###...#
#...#.#...#
#.........#
###########
key : 2

2
1
#####l#####
#........k#
#........##
#.........#
#.........#
D..#......D
#.........#
#.........#
#.........#
#.........#
#####D#####
key : 0

4
4
#####D#####
#.........#
#.........#
#.#.#..p..#
#....#....#
#..###....D
#.#.#.....#
#...##....#
#.........#
#.........#
#####d#####

2
0
###########
#.........#
#.........#
#.......#.#
#...@#.#..#
#....###..D
#....####.#
#.......#.#
#......##.#
#.........#
###########

5
4
#####d#####
#.........#
#.........#
#.........#
#.........#
#....e....#
#.........#
#.........#
#.........#
#.........#
#####D#####
boss
enemies 1

3
1
#####D#####
#.........#
#..#...#.##
#.........#
#..#.#.#..#
#.........#
#..#.#.#..#
#.........#
#..#...#.##
#s.......e#
###########
enemies 1
switch 0 : 0 1

3
3
#####D#####
#.........#
#..#..#...#
#.#....#..#
#.........#
#.........D
#...#.....#
#.......#.#
#......#..#
#k........#
###########
key : 3

2
3
#####D#####
#.........#
#......#..#
#.......#.#
#.........#
d.........D
#.........#
#.........#
#.........#
#.........#
#####D#####

1
2
#####D#####
#.......#k#
#.........#
#.........#
#.........#
D.........l
#.........#
#.........#
#.........#
#.........#
#####D#####
key : 1

3
4
#####D#####
#.........#
#.........#
#.........#
#.........#
D........e#
#..#......#
#..#e#....#
#..##.....#
#.........#
#####D#####
enemies 2

1
4
###########
#.........#
#.........#
#.........#
#.........#
D.........#
#.........#
#.#.......#
#..#......#
#.........#
#####D#####

1
1
###########
#.#.....#.#
#.........#
#.........#
#.#..#..#.#
#.........D
#.........#
#....#..#.#
#.........#
#.........#
#####l#####
locked : 0

2
4
#####D#####
#.........#
#.........#
#.........#
#.........#
D.........d
#.##..###.#
####..#...#
#.##..p##.#
#.........#
#####D#####

