3
2
#####D#####
#.........#
#.........#
#.........#
#.........#
D.........D
#.........#
#...#.....#
#.........#
#.........#
#####l#####
locked : 3

1
0
#####D#####
#.........#
#.........#
#.........#
#...@.....#
#...##.#..D
#...####..#
#.....#.#.#
#.....#...#
#.........#
#####l#####

2
2
#####D#####
#.........#
#..#..#...#
#.........#
#.........#
d...#.....#
#.........#
#.........#
#..#..#..##
#.........#
#####D#####

6
0
#####l#####
#.........#
#......#..#
#.......#.#
#.........#
#.........#
#.........#
#.........#
#.........#
#.........#
###########
locked : 2

1
2
###########
#......e#e#
#.......e.#
#.#...#.#.#
#.........#
D.....#...#
#.........#
#.#.#.#.#.#
#.........#
#.#.....#.#
#####D#####
enemies 3

0
0
###########
#k#.....#.#
#.........#
#...#.#...#
#.........#
#...#.....#
#.........#
#...#.#.#.#
#.........#
#.......#.#
#####D#####
key : 0

4
1
#####D#####
#k........#
#.........#
#.........#
#.........#
D.........d
#.........#
#.......#.#
#......#..#
#.........#
#####d#####
key : 1

3
3
###########
#........X#
#.........#
#.........#
#.........#
D.........#
#.........#
#.........#
#.........#
#.........#
#####D#####

4
0
#####D#####
#.........#
#......#..#
#.......#.#
#.........#
#.........D
#.........#
#.#.......#
#..#......#
#.........#
#####D#####

2
0
#####l#####
#.........#
#..#...#..#
#.......#.#
#.........#
#.........D
#.#.......#
#.#.....#.#
#..#...##.#
#.........#
#####D#####
locked : 0

3
1
#####D#####
#......#..#
#.........#
#.........#
#.##......#
D...#.....D
#..#...#..#
#.....##..#
##.##.#.#.#
#.........#
#####D#####

4
3
#####D#####
#.........#
#.........#
#.........#
#.........#
d....e....#
#....#....#
#...###...#
#.........#
#.........#
#####D#####
boss
enemies 1

5
3
#####D#####
#.........#
#.........#
#.#.......#
#.........#
#.........#
#..#..#...#
#.........#
#.........#
#e#?.....e#
###########
enemies 2
sign Beware what lurks ahead.

3
0
#####D#####
#.........#
#..#...#..#
#.#.....#.#
#.........#
#.........D
#.........#
#.........#
#.........#
#.........#
#####D#####

1
1
###########
#..#......#
#.........#
##.#.#.#.##
#.........#
D..#.#....D
#.........#
#..#.#.#.##
#.........#
##.#.....##
#####D#####

5
0
#####D#####
##.#...#.##
#k........#
##...#.#.##
#.........#
#..#.#.#..D
#.........#
##.#...#.##
#.........#
##.#...#.##
#####l#####
key : 3

2
1
#####D#####
#k........#
#..#......#
#.#.......#
#.........#
D.........d
#.........#
#.........#
#.........#
#.........#
#####D#####
key : 2

4
2
#####l#####
#.........#
#.....#.#.#
#.........#
#..#...#..#
d.........d
#.#...#...#
#.........#
#..#...#.##
#.........#
###########

5
1
#####d#####
#.........#
#...#.....#
#.###.....#
#.##......#
D...#.....#
#.####....#
#.........#
#.........#
#.........#
###########

