4
2
#####D#####
#k........#
##.#...#.##
#.........#
#..#.#.#..#
D.........D
#..#...#..#
#.........#
#..#...#.##
#.........#
###########
key : 1

1
3
#####D#####
#.........#
#.....#..##
#....#.####
#....#.#..#
D....e....#
#....#....#
#.........#
#.........#
#.........#
#####d#####
boss
enemies 1

2
1
###########
#.........#
#......#..#
#.......#.#
#.........#
D.........D
#.........#
#.#.......#
#..#......#
#.........#
#####l#####
locked : 0

3
1
#####l#####
#k#.......#
#.........#
#.#.#...#.#
#.........#
D...#.#...D
#.........#
#...#...#.#
#.........#
#.#.......#
#####D#####
key : 0

2
3
#####d#####
#.........#
#..#...#.##
#.........#
#.....#.#.#
D.........#
#..#...#..#
#.........#
#.#.#.#.#.#
#.........#
#####d#####

3
0
#####D#####
#.........#
#.........#
#.........#
#.........#
#?...@....D
#.........#
#.........#
#.........#
#.........#
#####D#####
sign What you seek is close.

0
3
###########
#X........#
#.........#
#.........#
#.........#
#.........#
#.........#
#...#.....#
#...#.....#
#.........#
#####D#####

3
3
#####d#####
#k........#
##.#...#.##
#.........#
#...#.#.#.#
D.........D
#....#....#
#.........#
#.#.#.#.#.#
#.........#
#####l#####
key : 2

3
4
###########
#.........#
#..#...#..#
#.#.......#
#.........#
D.........#
#.........#
#.........#
#.........#
#.........#
#####D#####

3
2
#####D#####
#.........#
#.#.#...#.#
#.........#
#.#.#.#.#.#
D.........D
#.#...#.#.#
#.........#
#.#.#.#...#
#.........#
#####D#####

4
1
#####D#####
#.#.......#
#.........#
#.........#
#.........#
D.........D
#.........#
#.........#
#.........#
#.........#
###########

1
2
###########
#k........#
#.........#
#.........#
#.........#
#.........D
#.........#
#.........#
#.........#
#.........#
#####D#####
key : 3

2
0
###########
#.........#
#.....#.#.#
#.........#
#..#.#....#
#.........D
#.#.#.....#
#.........#
#......#.##
#.........#
#####D#####

5
3
#####l#####
#.........#
##.....#..#
#.........#
#.........#
#...#.....#
#.........#
#.........#
##..#..#..#
#.........#
###########
locked : 3

4
3
#####l#####
#.........#
#..##.....#
###.......#
#.........#
D....#....l
#.........#
#.......#.#
#......#..#
#.........#
#####l#####
locked : 1

2
2
#####D#####
#.........#
#..#......#
#.#.......#
#.........#
D.........D
#.........#
#.#.......#
#..#......#
#.........#
#####D#####

5
0
#####d#####
#.........#
#.###.#...#
#.###.#...#
#.##.#....#
#.........#
#.........#
#.........#
#...#.....#
#.........#
###########

4
0
#####D#####
#e........#
##.##.##..#
########..#
#..#.##...#
#..#.##...D
#.##......#
#.........#
#.........#
#.........#
#####d#####
enemies 1

4
4
#####D#####
#.........#
#.........#
#.........#
#.....#...#
l....#....#
#.....#.#.#
#.......###
#......####
#.........#
###########
locked : 2

