2
2
#####D#####
#.........#
#.........#
#.........#
#.........#
#.........D
#.##......#
#.###.....#
#...#.....#
#.........#
#####d#####

1
3
#####D#####
#.........#
#........##
#.........#
#...e.....#
l....##...#
#...##....#
#...#.....#
#.........#
#.........#
#####D#####
locked : 3
boss
enemies 1

3
2
#####d#####
#.........#
#..#...#..#
#.#.....#.#
#.........#
#.........D
#.........#
#.......#.#
#......#..#
#.........#
#####d#####

6
1
#####d#####
#.........#
##.#...#.##
#.........#
#..#.#.#..#
D.........D
#..#.#....#
#.........#
##.#...#.##
#.........#
#####D#####

7
2
#####D#####
#.........#
#.....#...#
#.........#
#.........#
d...#..#..#
#.........#
#.........#
#..#..#..##
#.........#
###########

4
3
#####D#####
#.........#
#......#..#
#.......#.#
#.........#
D.........#
#.........#
#.........#
#.........#
#........k#
###########
key : 2

7
1
#####D#####
#e........#
#.........#
#.........#
#.........#
D.........d
#.........#
#.........#
#.........#
#s...e....#
###########
enemies 2
switch 0 : 0

5
1
###########
#.........#
#.........#
#.........#
#.........#
D.........l
#.........#
#.........#
#.........#
#.........#
#####d#####

5
2
#####D#####
#.........#
#..##.....#
#....#....#
#..##.....#
l.........#
#.........#
#.........#
#.........#
#.........#
#####D#####
locked : 0

4
2
#####d#####
#.........#
#.........#
#.........#
#.........#
#.........D
#.........#
#.......#.#
#......#..#
#.........#
#####D#####

7
0
#####D#####
#.........#
#..#...#.##
#.........#
#...#.#...#
#.........D
#....#.#..#
#.........#
#.#...#.#.#
#.........#
###########

2
3
#####D#####
#.........#
#..#......#
#.#.......#
#.........#
D........k#
#.........#
#.........#
#.........#
#.........#
#####D#####
key : 5

3
3
#####D#####
#.........#
#.........#
#.........#
#.........#
D........k#
#.........#
#.........#
#.........#
#.........#
#####D#####
key : 3

6
3
###########
#........e#
#.........#
#.........#
#.........#
D.........#
#.........#
#.........#
#.........#
#.........#
###########
enemies 1
door 0 : 0

6
0
#####D#####
#.........#
#.........#
#.........#
#...@#....#
#..#?#....D
#...##....#
#.........#
#.........#
#.........#
#####D#####
sign Many have walked this path.

0
3
###########
#.......#X#
#.........#
#....####.#
#......##.#
#.........#
#.........#
#p........#
#.........#
#.........#
#####D#####

6
2
#####D#####
#k........#
#.........#
#.........#
#.........#
D.........D
#.........#
#.........#
#.........#
#.........#
#####D#####
key : 0

1
2
###########
#.........#
#..#...#..#
#.#.....#.#
#.........#
#.........l
#.........#
#.........#
#.........#
#.........#
#####D#####

5
0
###########
#.........#
#.........#
#.........#
#.....#...#
#.........D
#.........#
#.........#
#.........#
#.........#
#####D#####

