5
2
###########
#.........#
#.....#...#
#.........#
#.........#
d...#..#..#
#.........#
#.........#
#..#..#..##
#.........#
###########

5
0
#####l#####
#.......#.#
#......#..#
#....####.#
#.....##..#
#....#.#..D
#....#....#
#.........#
#.........#
#.#.......#
###########
locked : 2

6
1
#####l#####
#.........#
#.........#
#.........#
#.........#
#....e....#
#.........#
#.........#
#.........#
#.........#
#####D#####
locked : 8
boss
enemies 1

7
1
#####D#####
#.........#
#.........#
#.###.#...#
#.#.##....#
#...#.....#
#.##..#...#
#..#.#....#
#.........#
#X........#
###########

0
2
###########
#.........#
#.........#
#.........#
#...##....#
#...#..#..#
#...##....#
#...##..#.#
#...#.###.#
#......##.#
#####D#####

1
0
#####D#####
#.........#
#..#...#..#
#.#.....#.#
#.........#
#.........D
#.........#
#.......#.#
#......#..#
#.........#
#####d#####

0
0
###########
#k........#
#.........#
#.....#.#.#
#.....###.#
#....###..#
#....#..#.#
#...###...#
#.........#
#.........#
#####D#####
key : 2

2
1
#####D#####
#k........#
#..#...#..#
#.#...###.#
#.#.......#
D.........D
#.........#
#.......#.#
#......#..#
#.........#
#####D#####
key : 0

1
2
#####D#####
##.#...#.##
#k........#
##.#.#.#.##
#.........#
D..#.#.#..d
#.........#
##.....#.##
#.........#
##.....#.##
#####D#####
key : 5

3
2
#####D#####
#..#......#
##........#
#.##......#
#.........#
d.........#
#.........#
#.........#
#.........#
#.........#
###########

4
0
#####D#####
#.........#
#.........#
#.#..#..#.#
#.........#
#.........D
#e#..#..#.#
#.........#
#.........#
#e#.....#?#
#####l#####
enemies 2
sign A locked path — look elsewhere first.

1
3
###########
#.........#
#..#......#
#.#.......#
#.........#
d.........#
#.........#
#.........#
#.........#
#.........#
###########

5
1
#####D#####
#.........#
#.........#
#.........#
#.......#.#
D.....##..d
#....###..#
#.........#
#.....#..##
#.........#
#####l#####

3
1
#####D#####
#.........#
#..#......#
#.#.......#
#.........#
l.........d
#.........#
#.......#.#
##.....#..#
#.........#
#####D#####
locked : 0

1
1
###########
##.....#..#
#.........#
#.........#
#.#.....#.#
D.........D
#.........#
##.....#..#
#.........#
#.........#
#####D#####

2
2
#####D#####
##.....#..#
#.........#
#.........#
#.#.....#.#
D.........#
#.........#
##........#
#.........#
#.........#
#####D#####

2
0
#####d#####
#..#...#..#
#.....#...#
#...####..#
#..#.###..#
#....@....D
#.........#
#.........#
#.........#
#.........#
#####D#####

4
1
#####D#####
#.........#
#.........#
#....###..#
#......#..#
D..#..#...#
#...#.....#
#####.....#
##........#
#k........#
#####D#####
key : 8

3
0
#####D#####
#.#.......#
#.##...#..#
#..#...#..#
#.####.#..#
#..###....l
#.........#
#.........#
#.........#
#..#......#
#####D#####

