1
0
###########
##........#
#..#...#..#
#.#.....#.#
#.........#
#.........D
#.........#
#.........#
#.........#
#.........#
#####l#####
locked : 0

0
1
###########
#e.....#se#
#...#..#..#
#...#.#e..#
#...####..#
#.........#
#.........#
#.........#
#.........#
#.#.......#
#####D#####
enemies 3
switch 0 : 0 1

3
5
###########
#.........#
#.........#
#.........#
#...###...#
d..###....#
#..##e#...#
#..#...#..#
#.........#
#.........#
#####D#####
boss
enemies 1

2
4
###########
#.......ee#
#........?#
#.....#...#
#.........#
D....##...#
#.....##..#
#.....#...#
#.........#
#.........#
#####D#####
enemies 2
door 0 : 0 1
sign Turn back; you are not yet ready.

3
2
#####D#####
#.........#
#.........#
#.........#
#.#.##....#
D..###....d
#.###.....#
#....#....#
#...#.#...#
#.........#
#####D#####

4
3
#####D#####
#.........#
#......#..#
#.......#.#
#.........#
D.........D
#.........#
#.........#
#.........#
#....k....#
###########
key : 3

3
0
#####D#####
#.##......#
#.##......#
#.###.....#
#...###...#
#....@....D
#.........#
#.........#
#.........#
#.........#
###########

3
1
#####D#####
#.........#
#.........#
#.........#
#.........#
D.........D
#.........#
#.#.....#.#
#..#...#..#
#.........#
#####D#####

2
2
###########
#.........#
#.........#
#.........#
#....##...#
d..##.##..l
#..#..##..#
#..##.#...#
#..##.##..#
#.........#
#####D#####

4
5
#####D#####
#.........#
#.........#
#.........#
#.........#
D.........#
#.........#
#.........#
#.........#
#........X#
###########

2
0
#####l#####
#.........#
#..#...#..#
#.#.....#.#
#.........#
#.........D
#k........#
##........#
#.........#
#.........#
#####D#####
key : 0

3
3
#####D#####
##.....#..#
#.........#
#.........#
#.#..#..#.#
d.........D
#.........#
##..#.....#
#.........#
#.........#
#####D#####

4
1
#####D#####
#.........#
#..#...#..#
#.#.....#.#
#...#.....#
#.........D
#.........#
#.........#
#.........#
#k........#
###########
key : 1

1
1
#####D#####
#.........#
#.........#
#.........#
#.........#
D.........#
#.........#
#.#.......#
#..#......#
#.........#
#####d#####

3
4
#####D#####
#e.......?#
#.........#
#.........#
#.........#
D.........d
#.........#
#.........#
#.........#
#e........#
#####D#####
enemies 2
sign Many have walked this path.

2
1
#####d#####
#.........#
#..#...#..#
#.#.....#.#
#.........#
D.........d
#.........#
#.#.....#.#
#..#...#..#
#.........#
#####D#####

4
2
#####D#####
#.........#
#.........#
#.........#
#.........#
D.........D
#.........#
#.#.....###
#..#...#..#
#..k......#
###########
key : 2

2
3
###########
#.#.....#.#
#.........#
#..#.#.#.##
#.........#
l...#.....D
#.........#
#..#.#.#.##
#.........#
#.#.....#.#
#####D#####
locked : 1

4
4
#####D#####
#.........#
#.........#
#.........#
#.........#
D.........D
#.........#
#.......#.#
#......#..#
#.........#
###########

