2
0
#####D#####
#..#......#
#.........#
#.........#
#...#..#..#
#.........D
#.........#
#..#..#..##
#.........#
#.........#
#####D#####

4
0
#####D#####
#.........#
#.........#
#.........#
#.........#
#.........D
#..###....#
#...##....#
#.........#
#.........#
###########

0
0
###########
#k.....##.#
#..#..##..#
#.....#...#
#.#.......#
#.........D
#.........#
#.........#
#.........#
#.........#
#####D#####
key : 1

1
1
#####D#####
#k........#
#.....#...#
#.........#
#.........#
D.........d
#.......#.#
#.........#
#.........#
#.........#
#####l#####
key : 2

0
1
###########
#.#.......#
#.........#
#.........#
#.#.....#.#
D.........D
#.........#
#.#..#..#.#
#.........#
#.........#
#####D#####

1
2
#####l#####
#.........#
#.........#
#.........#
#.........#
d.........D
#.........#
#.#.....#.#
#..#...#..#
#.........#
#####d#####

1
3
###########
#.........#
#.........#
#.........#
#.........#
D.........d
#.........#
#.#.......#
#..#......#
#..k......#
###########
key : 4

3
3
###########
#.......ee#
#.........#
#.........#
#.........#
D.........#
#.........#
#.........#
#.........#
#........e#
###########
enemies 3
door 0 : 0

1
0
#####D#####
#.........#
#.........#
#.........#
#.........#
#.........D
#.........#
#.........#
#.........#
#.........#
#####D#####

0
4
###########
#.........#
#.........#
#...#.#.#.#
#...##.##.#
#...##....#
#...#####.#
#...##.##.#
#.........#
#.........#
#####D#####

0
2
###########
#.........#
#.........#
#.....#..##
#.........#
D.........#
#..#..#...#
#.........#
#.........#
#..#.....##
#####l#####
locked : 4

1
5
###########
#.........#
#.........#
#.#.###...#
#.#.##....#
d..#.e....#
#...##....#
#....#....#
#.........#
#.........#
#####D#####
boss
enemies 1

3
0
#####D#####
#.........#
#.........#
#.........#
#.........#
#....@....#
#.........#
#.........#
#.........#
#.........#
#####D#####

2
5
#####D#####
#.........#
#.........#
#.........#
#.........#
#.....#...#
#.....##..#
#....######
#......#..#
#X........#
###########

2
2
#####d#####
#.........#
#.........#
#.........#
#.........#
D.........#
#.........#
#.........#
#.........#
#.........#
#####D#####

4
1
###########
#........k#
##.#...#..#
#.........#
#....#....#
D.........#
#..#.#.#..#
#.........#
##.#...#..#
#.........#
###########
key : 0

3
2
#####D#####
#..#...#.##
#.........#
#.#.#...#.#
#.........#
#..#.#....D
#.........#
#.#.#...#.#
#s........#
##e#...#..#
###########
enemies 1
switch 0 : 0

2
1
#####l#####
#.........#
#.....##..#
#....###..#
#....##...#
D.........D
#.........#
#.........#
#........##
#.........#
###########
locked : 2

1
4
#####D#####
#.........#
##.#...#..#
#.........#
#.#.#.#.#.#
d.........d
#..#.#.#..#
#.........#
#.#.#.....#
#.........#
###########

