2
2
#####.#####
#k........#
#.........#
#.........#
#.........#
...........
#.........#
#.........#
#.........#
#.........#
#####.#####
key : 2

0
2
###########
#..#......#
#.........#
#.........#
#.........#
...........
#.........#
#..#..#..##
#.........#
#.........#
#####d#####

1
0
#####.#####
#.........#
##........#
#k##......#
#..#......#
#..........
#.........#
#.........#
#.........#
#.........#
#####.#####
key : 0

1
4
###########
#.........#
#..#......#
#.#.......#
#.........#
..........#
#.........#
#.........#
#.........#
#.........#
###########

2
0
#####.#####
#.#.......#
#.........#
#.........#
#.#...###.#
#....@.#...
#..#.####.#
#.........#
#......#..#
#.........#
#####.#####

4
1
#####.#####
#.........#
#......#..#
#.......#.#
#.........#
#..........
#.........#
#.........#
#.........#
#k........#
###########
key : 3

3
3
#####.#####
#.........#
#.........#
#...#.....#
#.........#
....#.....#
#.........#
#.........#
#.........#
#........X#
###########

2
3
#####d#####
#.........#
#.........#
#.........#
#..##.....#
...#.e.#..#
#..####...#
#..##.##..#
#..#......#
#.........#
#####.#####
boss
enemies 1

2
1
#####l#####
#.........#
#.........#
#.........#
#.........#
...........
#.........#
#.........#
#.........#
#.........#
#####.#####

0
0
###########
#es.......#
#e#.#...#.#
#.........#
#..#.#.#..#
#..........
#.#.#.#...#
#.........#
#..#......#
#.........#
#####.#####
enemies 2
switch 0 : 0

1
2
#####d#####
#.........#
#.#.....#.#
#.........#
#.........#
d....#....l
#.........#
#.........#
#.#.......#
#.........#
#####.#####

0
3
###########
#......?.e#
##.#...#.##
#.........#
#....#.#..#
..........#
#..#.#.#..#
#.........#
#..#...#.##
#.........#
#####.#####
enemies 1
door 0 : 0
sign Turn back; you are not yet ready.

1
3
#####.#####
#.........#
#.........#
#...#..#..#
#.........#
l..........
#....#..#.#
#.........#
#.........#
#......#..#
#####d#####
locked : 0

3
1
#####.#####
#......##.#
#...#.##..#
#....#.##.#
#...##..#.#
....#.#...d
#.........#
#.........#
#.........#
#.........#
#####.#####

1
1
#####.#####
#.#.....#.#
#.........#
#.........#
#..#..#...#
..........d
#.........#
#.#.....#.#
#.........#
#.........#
#####l#####
locked : 1

0
1
###########
#....?....#
#.........#
#.........#
#.........#
...#.......
#....###..#
#...###...#
#.###.....#
#e##......#
#####.#####
enemies 1
sign Turn back; you are not yet ready.

4
2
#####.#####
#.........#
#.#.#.....#
#..##.....#
#...#.....#
..........#
#.........#
##........#
#.........#
#.......#.#
###########

3
0
#####.#####
#.........#
#..#......#
#.#.......#
#.........#
#..........
#.........#
#.........#
#.........#
#k........#
###########
key : 1

3
2
#####.#####
#.........#
#.........#
#.........#
#.........#
d..........
#.........#
#.........#
#.........#
#.........#
#####.#####

