7
1
#####.#####
#e#.......#
#......#..#
#.........#
#.........#
#e.........
#e###.....#
#...#.....#
#.#.#.....#
#.........#
#####.#####
enemies 3

4
1
#####d#####
#.........#
#.........#
#.........#
#.........#
..........#
#.........#
#.........#
#.........#
#.........#
#####.#####

6
1
#####.#####
####......#
##.#......#
##..#.....#
#.#.......#
#.........l
#.........#
#.........#
#.........#
#.........#
#####.#####

1
1
#####.#####
#.........#
#.........#
#.........#
#.........#
..........d
#.........#
#.........#
#.........#
#.........#
#####d#####

4
0
#####.#####
#.........#
#.........#
#.#..#....#
#.........#
#..........
#.#..#..#.#
#.........#
#.........#
#.......#.#
#####.#####

2
2
#####.#####
#.........#
#......#..#
#.......#.#
#.........#
..........#
#.........#
#.........#
#.........#
#.........#
###########

6
2
###########
#.........#
#.........#
##........#
#.........#
l.........#
#.#.......#
#..#....#.#
#......#..#
#.........#
#####.#####
locked : 0

2
1
#####d#####
#.........#
#.........#
#.........#
#.........#
...........
#....##...#
#.....k#..#
#.....##..#
#.........#
#####.#####
key : 1

0
1
###########
#k........#
#.........#
#.#..#....#
#.........#
#..........
#..#..#...#
#.........#
#.........#
#.......#.#
#####.#####
key : 4

1
0
###########
#e.....#..#
#......#..#
#....###..#
#?##......#
#...#......
#.##......#
#.##......#
#...#.....#
#.........#
#####.#####
enemies 1
sign Beware what lurks ahead.

5
0
#####.#####
#.........#
#.........#
#.........#
#......#..#
#....@.....
#.........#
#.........#
#.........#
#?........#
###########
sign Many have walked this path.

2
0
#####.#####
#.........#
#.........#
##.##.....#
#..##.....#
#..###.....
#.#.##....#
#...##....#
#.........#
#.........#
#####d#####

0
2
###########
#..#...####
#......#X##
#.....#...#
#.........#
...#.##...#
#.....#...#
#......#..#
#.....#...#
#..#...#..#
#####.#####

3
0
#####d#####
#.........#
#.........#
#.........#
#.........#
#..#.......
#k##......#
#.........#
#.........#
#.........#
#####.#####
key : 0

7
2
#####.#####
#.........#
#.........#
#.#.......#
#...#.....#
...##.....#
#.........#
#.........#
#.........#
#.........#
###########

8
1
#####.#####
#.........#
#.........#
#.........#
#.........#
#.........#
#.........#
#.........#
#.........#
#k........#
###########
key : 2

3
1
#####.#####
#.......#.#
#...#.....#
#....#.#..#
#......#..#
...##..#..#
#...##....#
#....#....#
#.........#
#.........#
#####d#####

5
1
#####.#####
#.........#
#.........#
#..##.#...#
#.##e#e...#
......#...#
#..#..#...#
#.........#
#.........#
#.........#
#####.#####
enemies 2

1
2
#####.#####
#.........#
#.........#
#.........#
#.........#
d....e....#
#.........#
#.........#
#.........#
#.........#
#####.#####
boss
enemies 1

