0
4
###########
#k........#
#.........#
#.........#
#.........#
#..........
#.........#
#.........#
#.........#
#.........#
#####.#####
key : 1

1
5
#####d#####
#e.......e#
#...#.#.#.#
#.........#
#...#.#.#.#
...........
#.#.#.#.#.#
#.........#
#.#.......#
#e........#
#####.#####
enemies 3

2
2
#####.#####
#.........#
##.......##
#.........#
#...#.#.#.#
...........
#..#.#....#
#.........#
#.#.#...#.#
#.........#
###########

2
0
###########
#?........#
#.#.#.....#
#..#...##.#
#....#.##.#
#....@.....
#.......#.#
#....#..###
#.........#
#.........#
#####.#####
sign What you seek is close.

2
1
#####.#####
#.........#
#.........#
#....#....#
#.........#
...........
#....#..#.#
#.........#
#.........#
#k#.....#.#
###########
key : 0

1
6
###########
#........k#
##..#..#..#
#.........#
#.........#
..........#
#.........#
#.........#
##..#..#..#
#.........#
#####.#####
key : 2

2
5
#####.#####
#.........#
#...#.#...#
#...##....#
#..####...#
#...#......
#k#.#.....#
#.........#
#.........#
#.........#
#####d#####
key : 3

3
8
#####.#####
#.........#
#.....#..##
#....#....#
#....##.#.#
#....##...#
#...##.##.#
#.........#
#.........#
#X........#
###########

3
0
#####.#####
#.........#
#.#....#..#
#.......#.#
#.........#
#.........#
#.......#.#
#.......#.#
#......#..#
#.........#
###########

2
6
#####.#####
#.........#
#.........#
#..#..#..##
#.........#
..........l
#...#.....#
#.........#
#.........#
#.e#ee....#
###########
enemies 3

2
3
#####.#####
#.........#
#.........#
#.........#
#.........#
..........#
#.........#
#.#.....#.#
#..#...#..#
#.........#
###########

1
1
###########
#.........#
#..#...#..#
#.#.....#.#
#.........#
#..........
#.........#
#.........#
#.........#
#.........#
#####.#####

2
7
###########
#.........#
#.........#
#.........#
#.........#
l.........d
#.........#
#.#.......#
#..#......#
#.........#
###########
locked : 2

1
4
#####.#####
#.........#
#.........#
#..##.....#
#...#.....#
d..#.......
#.........#
#.........#
#.........#
#.........#
###########

2
8
###########
#.........#
#.........#
#.........#
#.........#
d....e....#
#...#.....#
#.#.......#
#.........#
#.........#
#####.#####
boss
enemies 1

1
2
###########
#.........#
##........#
#.........#
#.........#
....#.....l
#.........#
#.........#
##..#..#..#
#.........#
#####.#####

3
5
#####d#####
#.........#
#.........#
#..#..#..##
#.........#
#.........#
#.....#...#
#.........#
#.........#
#..#.....##
###########

1
3
###########
#.........#
#.........#
#.........#
#.........#
l.........d
#.........#
#.#...#...#
#..#......#
##........#
#####.#####
locked : 0

0
5
###########
#.........#
#.......#.#
#.........#
#.........#
...#......#
#..##.....#
###.#.....#
#...#.....#
#.........#
#####d#####

