3
1
#####.#####
#.........#
#.........#
#....#....#
#..#...#..#
...#.#....d
#....###..#
#...###...#
#.#.....#.#
#.........#
#####.#####

2
0
#####.#####
#.........#
#...#..#..#
#.......#.#
#.........#
#..........
#.........#
#.......###
#......#..#
#.........#
#####.#####

4
0
#####d#####
#.........#
#......#..#
#.......#.#
#.........#
#..........
#.........#
#.#..#....#
#..#......#
#.........#
###########

2
1
###########
#....k....#
#.........#
##.....#..#
#.........#
...........
#.#..#..#.#
#.........#
#.........#
##.....#..#
#####.#####
key : 0

4
2
#####.#####
#........k#
#..#..#..##
#.........#
#.........#
.......#..#
#.........#
#.........#
#..#......#
#.........#
#####l#####
key : 2

3
3
#####d#####
#.........#
#..#...#..#
#.#.....#.#
#.........#
d.........#
#.........#
#.#.......#
#..#......#
#.........#
###########

2
2
#####l#####
#.........#
#.........#
#.........#
#.........#
.....##....
#....##...#
#.....#...#
#...#.....#
#.........#
#####l#####
locked : 1

2
3
###########
#.........#
#..#......#
#.#.......#
#.........#
..........#
#.........#
#.......#.#
#......#..#
#.........#
#####d#####

1
2
#####.#####
#.........#
#.........#
#.........#
#...e..#..#
#....##...#
#.........#
#.........#
#.........#
#.........#
#####l#####
locked : 2
boss
enemies 1

5
3
###########
#........k#
#.....##..#
#.....#...#
#.........#
..........#
#....#....#
#..#......#
#.........#
#.........#
###########
key : 4

3
0
#####.#####
#.........#
#.........#
#.........#
#.....#.#.#
#....@?#...
#.....#.#.#
#.........#
#.........#
#.........#
#####d#####
sign The dungeon remembers all who enter.

5
2
#####l#####
#.........#
#.........#
#.........#
#.......#.#
...........
#....#....#
#.......#.#
#......#..#
#.........#
#####.#####
locked : 0

3
2
#####l#####
#.........#
#.........#
#.........#
#.........#
d.........d
#.........#
#.........#
#.........#
#.........#
#####.#####

4
1
#####.#####
#.........#
##..#..#..#
#.........#
#.........#
...........
#.........#
#.........#
##..#.....#
#.........#
#####.#####

0
2
###########
#X........#
#.........#
#.........#
#.........#
#...####..#
#....###..#
#....##...#
#...#.###.#
#......#..#
#####.#####

1
0
###########
#.........#
#.........#
#.........#
#.........#
#.........#
#.........#
#.........#
#.........#
#.........#
#####.#####

6
2
#####.#####
#.........#
#.......#.#
#.........#
#.........#
#......#..#
#...###e..#
#...#####.#
#...#.....#
#e.....?#e#
###########
enemies 3
sign Only the prepared may pass.

5
1
#####.#####
#.........#
#.....#...#
#...##....#
#.........#
#..........
#......#..#
#.........#
#.........#
#k........#
###########
key : 1

