1
3
###########
#.........#
#.........#
##..#..#..#
#.........#
l.........#
#...#.....#
#.........#
#.........#
##........#
###########
locked : 4

2
2
#####.#####
#k........#
##.#.....##
#.........#
#..#.#.#..#
..........#
#..#.#.#..#
#.........#
##.#...#..#
#.........#
#####.#####
key : 3

0
2
###########
#e.......?#
#...#.#.#.#
#.........#
#.#...#.#.#
#.........#
#.#.#.#.#.#
#.........#
#.#.#.#.#.#
#.........#
#####.#####
enemies 1
door 0 : 0 1
sign The dungeon remembers all who enter.

6
1
#####.#####
#.........#
#.........#
#.#.......#
#..##.....#
...##.....#
#....##k..#
#.....##..#
#......#..#
#.........#
#####.#####
key : 4

2
0
###########
#......#..#
#.....###.#
#...#.###.#
#...###...#
#..........
#.........#
#.........#
#.........#
#.........#
#####.#####

4
1
#####.#####
#.........#
#.#.#...#.#
#.........#
#.#.#.#.#.#
d.........#
#.#...#.#.#
#.........#
#.#.#...#.#
#.........#
#####.#####

1
2
#####.#####
#.........#
#.........#
#.#..#..#.#
#.........#
..........l
#.#..#....#
#.........#
#.........#
#.......#.#
#####.#####

1
1
###########
#es.......#
#e........#
#.........#
#......#..#
#....#.....
#.....#...#
#.........#
#.........#
#.........#
#####.#####
enemies 2
switch 0 : 0 1

8
1
#####.#####
#..#......#
#.........#
####......#
#.........#
#.........#
#...#.....#
#.........#
#.........#
#X........#
###########

5
0
#####d#####
#.#.....#.#
#.........#
#....#.#..#
#.........#
#...#......
#.........#
#..#.#.#.##
#.........#
#.......#.#
#####d#####

3
0
#####.#####
#.........#
#.........#
#.........#
#.........#
#....@.....
#.........#
#.........#
#.........#
#.........#
#####.#####

7
0
#####.#####
#.........#
#.........#
#.........#
#.........#
#.........d
#.........#
#.#.......#
#..#......#
#k........#
###########
key : 5

6
0
#####d#####
#.......#.#
#.........#
#.........#
#.#.....#.#
#..........
#.........#
#.#..#....#
#.........#
#.........#
#####.#####

5
1
#####.#####
#e........#
#.........#
#.........#
#.#.......#
...#.....e#
#.##......#
#.........#
#.........#
#?........#
#####.#####
enemies 2
sign The brave are rewarded.

7
1
#####.#####
#.##......#
#.#.#.....#
#.#.#.....#
#.........#
d....e....#
#.........#
#.........#
#.........#
#.........#
#####.#####
boss
enemies 1

3
1
#####.#####
#.........#
#.........#
#.........#
#.........#
...........
#.........#
#.......#.#
#......#..#
#.........#
#####.#####

2
1
#####.#####
#..#......#
#..#......#
#.###.....#
#.#..#....#
...........
#..###....#
#.........#
#.........#
#.........#
#####.#####

3
2
#####.#####
##.....#..#
#.........#
#.........#
#....#..#.#
..........#
#.........#
#...#..#..#
#.........#
#........k#
###########
key : 0

4
0
#####.#####
#.........#
#..##.....#
#.#....#..#
#.........#
#.........d
#.........#
#...#.....#
#.........#
#.........#
#####d#####

