4
0
#####d#####
#.......#.#
#.........#
#......##.#
#...#..##.#
#....#....D
#..#......#
#...#.....#
#.........#
#.........#
#####D#####

0
0
###########
#k........#
#.#.#.#.#.#
#.........#
#.#.#.#.#.#
#.........D
#.#...#.#.#
#.........#
#.#.#.#.#.#
#.........#
#####D#####
key : 0

3
3
#####D#####
#........##
#.........#
#.........#
#.........#
D.........#
#.........#
#.......#.#
#.#....#..#
#........k#
###########
key : 6

5
0
#####D#####
#.........#
#...#.....#
#.........#
#..#...#..#
#.........#
#.....#...#
#.........#
#..#...#..#
#e.e...?.e#
###########
enemies 3
sign The dungeon remembers all who enter.

1
1
#####l#####
#.........#
#..#...#..#
#.#.....#.#
#.........#
D.........l
#.........#
#.........#
#.........#
#.........#
#####D#####

4
1
#####D#####
#.........#
#.#.....#.#
#.........#
#.........#
D..#..#...#
#.........#
#.........#
#.#.......#
#.........#
###########

1
2
###########
#.........#
#.........#
#.........#
#.........#
l....#.#..#
#....###..#
#....#....#
#.........#
#.........#
#####D#####
locked : 0

1
0
#####D#####
#.........#
#.........#
#.........#
#.........#
#..#.@....D
#...#.#...#
#.##......#
#...#.....#
#.........#
#####D#####

2
4
#####d#####
#.........#
#.#.#.#...#
#.#.......#
#.#.......#
D..##.#...#
#.#.#.....#
#...#.....#
#.#.#.....#
#.......?e#
###########
enemies 1
sign The dungeon remembers all who enter.

1
4
#####D#####
#.........#
#.........#
#.........#
#.........#
#....e#...#
#.........#
#.........#
#.........#
#.........#
#####d#####
boss
enemies 1

2
1
#####D#####
#k........#
#......#..#
#.......#.#
#.........#
D.........D
#.........#
#.#.......#
#..#......#
#.........#
#####D#####
key : 1

3
1
#####D#####
#k........#
#.........#
#.........#
#.........#
D...##....D
#...#.....#
#.........#
#.........#
#.........#
#####D#####
key : 2

0
1
###########
#.........#
#.........#
#.........#
#.........#
D.........#
#.........#
#.......#.#
#......#..#
#.........#
#####l#####
locked : 1

3
0
#####d#####
#.........#
#.........#
#.........#
#.........#
#.........D
#....##...#
#.........#
#...#.#...#
#.........#
#####d#####

2
3
###########
#.........#
#.........#
#.........#
#.........#
d.........D
#....#..#.#
#.........#
#.........#
#.........#
#####D#####

2
2
#####D#####
#.........#
#..#...#.##
#.........#
#.#.#.#.#.#
D.........d
#..#.#....#
#.........#
#.#.#.#.#.#
#.........#
#####l#####

3
2
#####l#####
#.........#
##.#......#
#.........#
#.#.....#.#
D.........D
#....#.#..#
#.........#
#.#.#.#.#.#
#.........#
###########
locked : 2

2
0
#####D#####
#.........#
#......##.#
##......#.#
#.........#
#.........D
#.........#
#.#......##
#..#......#
#.........#
#####d#####

0
4
###########
#X........#
####......#
##.##.....#
#..##.....#
#.........#
#.##......#
#.#.#.....#
#.#.......#
#.##......#
#####D#####

