5
0
#####.#####
#.........#
#......#..#
#.......#.#
#.........#
#..........
#.........#
#.#k#.....#
#..#......#
#.......#.#
#####.#####
key : 1

0
1
###########
#.......?e#
#.........#
#.........#
#.......#s#
..........#
#.........#
#.........#
#.......#.#
#.........#
#####.#####
enemies 1
switch 0 : 0
sign Something glints behind that door…

4
2
###########
#.........#
#...#..#..#
#.........#
#.........#
l...#..#..l
#.........#
#.........#
##........#
#.........#
###########
locked : 1

5
1
#####.#####
#.........#
#......#..#
#.......#.#
#.........#
..........#
#.........#
#.#.....#.#
#..#...#..#
#.........#
#####d#####

1
1
#####.#####
#.........#
#..#......#
#.#.......#
#.........#
.........k#
#......#..#
#.........#
#.........#
#.........#
#####.#####
key : 5

4
1
#####.#####
#k........#
#.........#
#.....#..##
#.........#
..........l
#...#..#..#
#.........#
#.........#
#..#.....##
#####.#####
key : 0

0
0
###########
#.........#
#.........#
#.........#
#.........#
#..........
#.....#...#
#.........#
#.........#
#.#.....#.#
#####d#####

6
1
#####d#####
#.........#
#.........#
#.........#
#.........#
...........
#.........#
#.........#
#.........#
#.........#
###########

6
2
###########
#........e#
#.........#
#.#.......#
#..#......#
...#......#
#.........#
#.........#
#.........#
#.........#
###########
enemies 1
door 0 : 0

3
0
#####d#####
#.........#
#.........#
#.........#
#.........#
#....@.....
#.........#
#.........#
#.........#
#.........#
#####.#####

1
0
#####d#####
#.........#
#.#...#...#
#.........#
#.#...#...#
#..........
#.#.#.#...#
#.........#
#...#.#.#.#
#.........#
#####d#####

5
3
#####.#####
#.#.......#
#.###.....#
#.#.......#
#..#......#
#.........#
#.........#
#.........#
#.........#
#X........#
###########

2
0
#####d#####
#.........#
##..#..#..#
#.........#
#.........#
#...#..#...
#.........#
#.........#
##.....#..#
#.........#
#####d#####

2
1
#####.#####
#.........#
#.........#
#.........#
#.........#
...........
#.........#
#.#.....#.#
#..#...#..#
#.........#
#####.#####

4
0
#####.#####
#.........#
#.........#
#......#..#
#.........#
#..........
#.........#
#.......#.#
#.#....##.#
#.........#
#####.#####

3
1
#####.#####
#.........#
#.........#
#...##....#
#....e#...#
....##e..e#
#.........#
#.........#
#.........#
#.........#
#####.#####
enemies 3

2
2
###########
##.......k#
#.###.#...#
#.##..#...#
#....##...#
......#...#
#.........#
#.#.......#
#.........#
#.........#
###########
key : 4

4
3
###########
#.......#.#
#...#.##..#
#...#####.#
#....#.##.#
l...#e.#..#
#.........#
#.........#
#.........#
#.........#
#####.#####
locked : 5
boss
enemies 1

6
0
#####.#####
#.........#
#..#......#
#.#.......#
#.........#
#..........
#.........#
#.#.......#
#..#......#
#.........#
###########

