0
4
###########
#..k......#
#..#......#
#.#.......#
#.........#
D.........D
#.........#
#.........#
#.........#
#.........#
#####D#####
key : 5

0
5
###########
#........X#
#.........#
#.........#
#.........#
D.........#
#.........#
#.........#
#..#......#
#.......#.#
#####D#####

2
3
#####D#####
#.........#
#.........#
#....p....#
#.........#
D....#e#..D
#....####.#
#...#.###.#
#.....#e#.#
#.......#e#
#####D#####
enemies 3

1
4
#####D#####
#.........#
#.........#
#.........#
#.........#
D.........d
#.....#...#
#...###..##
#.........#
#.........#
#####l#####
locked : 1

2
5
#####D#####
#.........#
#.........#
#.........#
#.........#
D.........#
#.........#
#.........#
#........e#
#.......ee#
###########
enemies 3

0
3
###########
#.........#
#.........#
#.........#
#.........#
#.........D
#.........#
#.........#
#.........#
#.........#
#####d#####

2
4
#####l#####
#k........#
#.........#
#.........#
#.........#
D..#......D
#.........#
#.........#
#.........#
#.........#
#####D#####
key : 1

3
0
#####D#####
#..#......#
#.........#
#.........#
#...#..#..#
#.........#
#.........#
#.....#..##
#.........#
#.........#
###########

1
3
#####d#####
#.........#
#.........#
#.........#
#.........#
D.........D
#.........#
#.......#.#
#......#..#
#.........#
#####D#####

1
5
#####D#####
#.........#
#.........#
#....###..#
#......#..#
d....e....#
#.........#
#.........#
#.........#
#.........#
#####D#####
boss
enemies 1

3
3
#####D#####
#k........#
##.#...#..#
#.........#
#...#.#.#.#
#.........l
#....#.#..#
#.........#
#.#.#.#...#
#.........#
#####d#####
key : 2

1
0
#####D#####
#.#.......#
#.........#
#.........#
#.#.......#
#.........#
#.........#
#.........#
#.........#
#.........#
#####D#####

3
4
#####D#####
#.........#
#.........#
#.........#
#.........#
l.........#
#.#.......#
###.......#
#.#.......#
#.........#
###########
locked : 0

2
0
#####D#####
#.........#
#.........#
#.#..##...#
#...##?.#.#
#....@#...D
#.........#
#.........#
#.........#
#.........#
#####D#####
sign Beware what lurks ahead.

1
2
###########
###.......#
#.##......#
#.###.....#
#..#.#....#
#..#......D
#.........#
#.........#
#.........#
#.........#
#####D#####

2
2
#####D#####
#..#.....##
#.........#
#.#.#.#...#
#.........#
d..#......D
#.........#
#...#.....#
#.........#
#..#...#.##
###########

0
0
###########
##k#......#
#.........#
#.....#...#
#.........#
#..#..#...#
#....##...#
#..#......#
#.........#
#.........#
#####D#####
key : 0

4
3
#####d#####
#.##......#
#.##......#
#..##.....#
#.........#
#......#..#
#.....##..#
#.....##..#
#.........#
#.........#
###########

2
1
###########
#.........#
#.........#
#....#..#.#
#.........#
D.........d
#.#..#..#.#
#.........#
#.........#
#.#.....#.#
###########

