2
1
#####D#####
#.#.......#
#..#....#.#
#.#.......#
#.........#
D.........D
#.........#
#.........#
#........##
#.........#
###########

5
4
#####D#####
#.........#
##.#...#.##
#.........#
#..#...#..#
D.........#
#..#.#.#..#
#.........#
##.#...#..#
#........e#
###########
enemies 1
door 1 : 1 2

3
0
#####D#####
#.........#
#.........#
#.........#
#.........#
#.........#
#.........#
#.........#
#.#.......#
#.........#
###########

1
1
#####d#####
#k........#
#.........#
#.........#
#.........#
D.........d
#.........#
#.........#
#.........#
#.........#
#####D#####
key : 0

4
3
#####D#####
#e.......s#
#.........#
#..##.....#
#.........#
D.........D
#.........#
#.........#
#.........#
#e.......?#
#####D#####
enemies 2
switch 1 : 1 2
sign What you seek is close.

1
0
###########
#.........#
#.......#.#
#......##.#
#..####.#.#
#..#@##...D
#..#..###.#
#.........#
#.........#
#.........#
#####D#####

3
3
#####D#####
#.........#
#..#......#
#.#.......#
#.........#
D........s#
#.........#
#.#.......#
#..#......#
#.........#
#####D#####
switch 0 : 0

2
0
#####D#####
#.........#
##.#...#.##
#.........#
#.#.#.....#
#.........D
#..#.#.#..#
#.........#
#.#.#.#...#
#.........#
#####D#####

1
2
#####d#####
#.........#
##.#...#.##
#.........#
#..#.#....#
d.........#
#......#..#
#.........#
##.#...#.##
#.........#
#####D#####

0
2
###########
#.........#
#.........#
#.........#
#.........#
D.........#
#.........#
#.........#
#.........#
#.........#
#####d#####

5
2
#####D#####
#.......#.#
#.....##..#
#....#.#.##
#.........#
#....##...D
#.##......#
#...##....#
#..##.....#
#k........#
###########
key : 4

2
3
###########
#.........#
#.###.#...#
#.#..#....#
#.##.#....#
D..#.##...#
#.##..#...#
#.....##..#
#.........#
#.........#
#####D#####

4
2
#####d#####
#.........#
#.........#
#.........#
#.........#
D....e....D
#.........#
#.........#
#.........#
#.........#
#####D#####
boss
enemies 1

5
3
#####D#####
#.........#
#..#......#
#.#.......#
#.........#
D.........D
#.........#
#.........#
#.........#
#....k....#
###########
key : 5

4
4
###########
#.........#
#.....###e#
#....###e##
#....#.#..#
D.........#
#.##......#
##........#
##........#
#.........#
#####D#####
enemies 2
door 0 : 0

4
1
###########
#X........#
#.........#
#.........#
#.......#.#
#.........D
#.#.......#
#.........#
#.........#
#.........#
###########

2
2
#####D#####
#?.....##e#
#..##.##..#
#..##.e#.##
#...####..#
D...#e##..D
#.........#
#.........#
#.........#
#.........#
#####D#####
enemies 3
sign Those who search shall find.

3
2
#####D#####
#.........#
#.........#
#.........#
#.........#
#k........D
#.........#
#.........#
#.........#
#.........#
#####d#####
key : 2

0
1
###########
#......#..#
#..##..#..#
#..#...#..#
#..#..##p.#
#.........D
#.........#
#.........#
#.........#
#.........#
#####d#####

