2
1
###########
#..#......#
#.........#
#..##.##..#
#...#..#..#
..........d
#.........#
#.........#
#.........#
#.........#
#####.#####

5
4
#####.#####
#.........#
#.#.....#.#
#.........#
#.........#
......#...#
#.........#
#.........#
#.#.....#.#
#........k#
###########
key : 5

2
3
#####d#####
#.........#
##.......##
#.........#
#..#......#
...........
#..#.#.#..#
#.........#
#.........#
#.........#
#####.#####

0
3
###########
#..#......#
#.........#
#.........#
#.........#
#.........#
#.........#
#.......###
#......#..#
#.#.......#
#####d#####

1
5
###########
#.........#
#.........#
#.......#.#
#.........#
d.........#
#.........#
#.........#
#.........#
#.........#
###########

5
3
#####.#####
#.........#
#.........#
#.........#
#.........#
#..........
#.........#
#.........#
#.........#
#k........#
###########
key : 3

1
0
###########
#.........#
#..#...#..#
#.#.....#.#
#.........#
#.........#
#.........#
#.......#.#
#......#..#
#.........#
#####.#####

2
2
###########
#.........#
#......#..#
#.......#.#
#.........#
d..........
#.........#
#.........#
#.........#
#.........#
#####.#####

2
0
#####.#####
#.........#
#.........#
#.........#
#.........#
#?...@.....
#.........#
#.........#
#.........#
#.........#
#####.#####
sign The dungeon remembers all who enter.

2
4
#####.#####
#.........#
#.........#
#.........#
#.........#
...#.##...#
#...##k...#
#.#.#.#...#
#.#...#...#
#.........#
#####.#####
key : 2

4
4
#####.#####
#.........#
#.........#
#.........#
#.........#
l....e....#
#.........#
#.........#
#.........#
#.........#
#####.#####
locked : 3
boss
enemies 1

3
1
#####.#####
#.........#
#.........#
#.........#
#.........#
...........
#.........#
#.......#.#
#......#..#
#......k..#
###########
key : 0

3
0
#####.#####
#.........#
#.#.....#.#
#.........#
#.........#
#..#..#....
#.........#
#.........#
#.......#.#
#.........#
###########

4
3
#####l#####
#.........#
#.........#
#...##.#..#
#....###..#
#.....##..l
#.....##..#
##........#
#.........#
#.........#
#####.#####
locked : 0

3
4
#####.#####
#.........#
#..#......#
#.#X##....#
#....#.#..#
.....###..#
#.....#...#
#....#..###
#......####
#.........#
#####.#####

1
4
###########
##.#...#.##
#.........#
#.....#.#.#
#.........#
l..#.#....d
#.........#
#...#.#.#.#
#.........#
##.#...#..#
#####.#####
locked : 2

3
2
#####.#####
#.........#
#......#..#
#.......#.#
#.........#
...........
#.........#
#.........#
#.........#
#.........#
###########

1
3
#####d#####
#.........#
#..#.....##
#.........#
#.........#
#..#..#...l
#.........#
#.........#
#..#..#..##
#.........#
#####d#####

3
3
#####.#####
#e#......?#
#.........#
#..#.#.#.##
#.........#
......#....
#.........#
#..#.#.#..#
#.........#
#e#.....#e#
#####l#####
enemies 3
sign Only the prepared may pass.

