0
2
###########
#.........#
#......#..#
#....##...#
#.........#
......#...#
#.........#
#.........#
#.........#
#.........#
#####l#####
locked : 0

3
4
###########
#........X#
#.........#
#.........#
#....#....#
.....###..#
#.#...#...#
#..###....#
#..##.....#
#.#.......#
###########

4
1
#####.#####
#.........#
#.#.....#.#
#.........#
#.........#
#.....#...l
#.........#
#.........#
#.........#
#.........#
#####.#####

3
1
#####.#####
#.........#
#..#......#
#.#....#.##
#.........#
...........
#.........#
#.#.......#
#.........#
#.........#
#####.#####

4
3
#####d#####
#.......#.#
#.........#
#.........#
#.........#
..........#
#.........#
#.#.......#
#..#......#
#.#......k#
###########
key : 3

1
2
#####l#####
#.#.....#.#
#.........#
#.........#
#.#..#..#.#
d.........#
#.........#
#....#....#
#.........#
#.........#
#####d#####

5
1
#####.#####
##........#
#.........#
#.........#
#.........#
#.........#
#.........#
#....#..#.#
#..#...#..#
#.........#
#####.#####

3
3
#####.#####
#.##......#
#..#......#
#.##......#
#.........#
.....e.....
#.........#
#.........#
#.........#
#.........#
#####d#####
boss
enemies 1

4
2
#####.#####
#.........#
#.........#
#.........#
#.........#
l..........
#.........#
#.......#.#
#......#..#
#.........#
###########
locked : 1

1
1
#####.#####
#k........#
#...#.....#
#...#.....#
#...##....#
..........d
#.........#
#.........#
#.........#
#.........#
#####.#####
key : 1

2
3
###########
#.......ee#
#.#.#.#.#?#
#.........#
#..#.#.#..#
..........#
#.#.#.#.#.#
#.........#
#..#...#..#
#.........#
#####.#####
enemies 2
door 0 : 0 1
sign The dungeon remembers all who enter.

6
1
#####.#####
#.........#
#.........#
#.........#
#.........#
#.........#
#.........#
#.......#.#
#......#..#
#k........#
###########
key : 5

2
2
#####d#####
#.........#
#......#..#
#.......#.#
#.........#
...........
#.........#
#.#.......#
#..#......#
#.........#
#####.#####

1
0
###########
##.....#.##
#.........#
##...#...##
#.........#
#..#.#.#...
#.........#
##.#...#.##
#.........#
##.#...#..#
#####.#####

3
2
#####.#####
#k........#
#.........#
#.........#
#.........#
...........
#.........#
#.........#
#.........#
#.........#
#####.#####
key : 0

0
1
###########
#.........#
#.........#
#.........#
#.........#
#..........
#.........#
#.........#
#.........#
#.........#
#####.#####

2
1
#####.#####
#.........#
#......#..#
#.......#.#
#.........#
d..........
#.........#
#.........#
#.........#
#.........#
#####.#####

3
0
#####.#####
#.........#
#.........#
#.........#
#...@.....#
#....#.....
#.........#
#.........#
#.........#
#?........#
###########
sign Many have walked this path.

2
0
#####.#####
#.........#
#.........#
#.........#
#.........#
#...###...d
#....s#.#.#
#...#####.#
#.....#...#
#.......#e#
#####.#####
enemies 1
switch 0 : 0 1

