1
5
###########
#.........#
#......#..#
#.....#.#.#
#.........#
..........#
#.........#
#.#.......#
#..#......#
#.........#
###########

4
2
#####l#####
#.........#
#.........#
#.........#
#.........#
#..........
#.........#
#.........#
#.........#
#.........#
###########
locked : 1

1
2
#####l#####
#........k#
#..#..#..##
#.........#
#.........#
......#....
#.........#
#.........#
#..#.....##
#.........#
#####.#####
key : 2

3
4
#####.#####
#.........#
#.........#
#.........#
#.........#
..........#
#.........#
#.........#
#.........#
#........X#
###########

0
2
###########
#.........#
#.........#
#.........#
#.........#
#.........#
#.........#
#.........#
#.........#
#.........#
#####l#####
locked : 2

2
3
#####.#####
#.........#
#.........#
#.........#
#.........#
...........
#.##......#
#.......#.#
##.....#..#
#.........#
#####.#####

1
0
#####.#####
#.........#
#.........#
#.........#
#.........#
#.........d
#.........#
#k#.......#
#..#......#
#.........#
#####.#####
key : 0

3
2
#####.#####
#e........#
#.........#
#.........#
#e........#
#e........l
#?.#..#...#
#...###...#
#...#.#...#
#.........#
#####l#####
enemies 3
sign Seek the matching key before you proceed.

1
1
###########
#......#..#
#.........#
#.........#
#...#.....#
d..........
#.........#
##.....#..#
#.........#
#.........#
#####.#####

2
1
#####.#####
#..#.....##
#.........#
#.........#
#...#..#..#
...........
#.........#
#..#..#...#
#.........#
#.........#
###########

4
3
#####d#####
#.........#
##..#..#..#
#.........#
#.........#
.....#....#
#.........#
#.........#
##..#..#..#
#.........#
###########

1
3
###########
#k#.....#.#
#.........#
#.#.#.#...#
#.........#
......#...d
#.........#
#.#.#.....#
#.........#
#.#.....#.#
#####.#####
key : 4

2
4
#####d#####
#.........#
#.........#
####.#....#
#.###.....#
...#e#....#
#..#......#
#.#.......#
#.........#
#.........#
#####.#####
boss
enemies 1

2
0
#####.#####
#.........#
#.........#
#.........#
#..#......#
#...#@.....
#.###.....#
#...#.....#
#.........#
#.........#
#####.#####

3
0
#####.#####
#.........#
#..#..#..##
#.........#
#.........#
#..#..#...#
#.........#
#.........#
#........##
#.........#
###########

3
3
#####.#####
#.##......#
#.##......#
#.#.......#
#...#.....#
l..........
#.........#
#.........#
#.........#
#.........#
#####d#####
locked : 0

2
2
#####.#####
#k........#
#..##.....#
#.#.......#
#.........#
...........
#.........#
#.......#.#
#......#..#
#.........#
#####.#####
key : 1

1
4
###########
#.........#
#..#...#..#
#.#.....#.#
#.........#
d..........
#.........#
#.........#
#.........#
#.........#
#####d#####

0
0
###########
#.........#
#..#......#
#.#.#.#...#
#....#....#
#.........#
#.##......#
#.........#
#.........#
#.........#
#####.#####

