5
1
#####D#####
#.#.......#
#.........#
#.........#
#..#..#...#
D.........#
#.........#
#.#..#....#
#.........#
#.........#
#####D#####

0
0
###########
##.#...#.##
#.........#
##.#...#.##
#.........#
#..#.#.#..#
#.........#
##.#......#
#.........#
##.#...#.##
#####D#####

7
1
#####D#####
#.........#
#...#.#...#
#.........#
#.........#
D.........D
#.........#
#.........#
#.........#
#....e....#
###########
enemies 1

2
1
#####D#####
#.........#
#...#.#.#.#
#...##..#.#
#....k##..#
D...####..#
#....###..#
#.........#
#...#.#...#
#.........#
#####D#####
key : 3

8
0
#####d#####
#.........#
#...#.#...#
#...#.....#
#.#.##....#
#...##....#
#...#.....#
##..#.....#
#.........#
#.........#
###########

6
2
###########
#.........#
#...#..#..#
#...#...#.#
#...#e....#
d...###...#
#...####..#
#....##...#
#...#.....#
#.........#
#####D#####
boss
enemies 1

7
2
#####D#####
#.##......#
#.........#
##.#......#
#.........#
D.........#
#.........#
#.........#
#.........#
#........X#
###########

7
0
#####D#####
#........##
#.........#
#.........#
#...#..#..#
#.........D
#.........#
#..#..#...#
#.........#
#.........#
#####d#####

2
0
#####l#####
#.........#
#..#......#
#.#.......#
#.........#
#.........D
#.........#
#.......#.#
#......#..#
#.........#
#####D#####

4
2
###########
#.#.....#.#
#.........#
#...#.#.#.#
#.........#
l...#.#...#
#.........#
#.#.#.#.#.#
#.........#
#.......#.#
###########
locked : 0

5
0
#####D#####
#.........#
#.........#
#.........#
#.........#
#....#....D
#.........#
#.........#
#.#.....#.#
#.........#
#####D#####

6
1
#####D#####
#.........#
#..#...#..#
#.#.....#.#
#.........#
d.........d
#.........#
#.........#
#.........#
#.........#
#####D#####

1
1
###########
#.........#
#.........#
#.........#
#.....p...#
d.........#
#.........#
#.........#
#.........#
#.........#
#####D#####

4
1
#####D#####
#k........#
#.........#
#.........#
#..###.#..#
D..###....l
#...##.#..#
#......#..#
#..#..#...#
#.........#
#####D#####
key : 1

4
0
#####D#####
##........#
###.#.....#
#?.###....#
#....#....#
#..#.@....D
#.........#
#.........#
#.........#
#.........#
#####D#####
sign A useful tool lies just ahead.

6
0
#####D#####
#........k#
#.....#..##
#.........#
#.........#
#..#..#...d
#.........#
#.........#
#..#..#...#
#.........#
#####D#####
key : 2

1
0
#####D#####
#.........#
#...#.....#
#.........#
#.........#
#....#....d
#.........#
#.........#
#...#..#..#
#.........#
#####l#####
locked : 3

3
0
#####D#####
#.........#
#k#.......#
#.........#
#.........#
#..#..#...D
#.........#
#.........#
#.#.......#
#.........#
#####D#####
key : 0

3
1
#####D#####
#.........#
#.........#
#.........#
#.........#
D.........#
#.........#
#.......#.#
#......#..#
#.........#
#####D#####

