4
1
###########
#.......#.#
#...#.....#
#.........#
#.........#
l..........
#.........#
#.#.......#
#..#......#
#.........#
#####.#####
locked : 0

2
3
#####.#####
#.........#
#..#...#..#
#.#.....#.#
#.........#
d..........
#.........#
#.........#
#.........#
#.........#
#####.#####

1
3
###########
#k#.....#.#
#.........#
#.#.#.#.#.#
#.........#
#...#......
#.........#
#.#.#.#.#.#
#.........#
#.#.....#.#
#####.#####
key : 5

2
4
#####d#####
#.........#
#.........#
#.........#
#.........#
..........#
#.##......#
###.......#
#.#.......#
#.......?e#
###########
enemies 1
sign Many have walked this path.

0
4
###########
#X........#
#...#.#...#
#...##.#..#
#......#..#
#.........#
#.........#
#.........#
#..#......#
#.........#
#####.#####

5
0
#####.#####
#.........#
#.........#
#.........#
#.........#
#....@.....
#.........#
#.........#
#.........#
#.........#
#####.#####

6
0
#####.#####
#.........#
#......#..#
#....#..#.#
#.........#
#..........
#.........#
#.......#.#
#......#..#
#.........#
#####.#####

7
0
#####.#####
#.........#
#.........#
#.........#
#.........#
#..........
#.........#
####......#
###.......#
#.........#
###########

7
1
#####.#####
#.......#.#
#..#...#..#
#.......#.#
#.........#
..........#
#.........#
#.#.......#
#..#......#
#........k#
###########
key : 1

4
2
#####d#####
#.........#
#.........#
#.#..#..#.#
#.........#
..........d
#.#..#....#
#.........#
#.........#
#.#.....#.#
#####.#####

5
2
#####.#####
#.........#
#..#......#
#.#.#.....#
#.........#
....#.....#
#.........#
#.......#.#
#..#...#..#
#........k#
###########
key : 4

2
2
###########
#e........#
#e........#
#.......#.#
#...#####.#
#...##.#..d
#....#....#
#...####..#
#.........#
#.........#
#####.#####
enemies 2

4
0
###########
#k........#
#......#..#
#.......#.#
#.........#
#.........l
#.........#
#.......#.#
#......#..#
#.........#
#####.#####
key : 0

4
3
#####.#####
#.........#
#.........#
#.........#
#.........#
d.........#
#.........#
#.........#
#.........#
#.........#
###########

3
2
#####.#####
#.........#
#.#.#.#...#
#.........#
#.#.#...#.#
#..........
#.#.#.#.#.#
#.........#
#.#...#.#.#
#.........#
#####d#####

3
3
#####.#####
#.........#
#.........#
#.........#
#.........#
..........#
#.##......#
#.##......#
####......#
#e........#
#####.#####
enemies 1

6
1
#####.#####
#.........#
#.........#
#..#......#
#..#..#...#
....#.....#
#.........#
#.........#
#.........#
#.........#
#####.#####

1
4
#####.#####
#.........#
#.........#
#.........#
#.........#
.....e....#
#.........#
#......#..#
#.........#
#.#.......#
#####d#####
boss
enemies 1

5
1
#####.#####
#e........#
#.........#
#.........#
#.........#
...........
#.........#
#.........#
#.........#
#?........#
#####.#####
enemies 1
sign A locked path — look elsewhere first.

