2
1
#####D#####
#k........#
##.....#..#
#.........#
#.#.#.....#
D.........d
#..#...#..#
#.........#
#.#.#...#.#
#.........#
#####D#####
key : 1

3
2
#####D#####
#.........#
#..#......#
#.#.......#
#.........#
d.........#
#.........#
#.......#.#
#......#..#
#.........#
#####D#####

4
1
#####D#####
#.......#.#
#.........#
#..#.#...##
#.........#
D...#.....D
#.........#
#....#.#.##
#.........#
#.......#.#
#####D#####

4
0
#####D#####
#.........#
#.........#
#.........#
#.........#
#.........D
#...##....#
#...#.#...#
#.........#
#k........#
###########
key : 0

1
0
#####D#####
#..p....#e#
#.....#...#
#...#.e#..#
#...###s#.#
#....#....D
#......#..#
#.........#
#...p.....#
#.........#
#####D#####
enemies 2
switch 0 : 0

6
2
#####d#####
#..#...##.#
#...#..##.#
#...###.#.#
#...#.....#
#....e....#
#.........#
#.........#
#.........#
#.......#.#
#####D#####
boss
enemies 1

2
3
###########
#........e#
#.........#
#..#.....##
#.........#
D.........#
#...#..#..#
#.........#
#.........#
#..#.....e#
###########
enemies 2
door 0 : 0

2
0
#####D#####
#.........#
#..#...#..#
#.#.....#.#
#.........#
#.........D
#.........#
#.........#
#.........#
#.........#
#####d#####

4
2
#####D#####
#k........#
#..#...#..#
#.#.....#.#
#.........#
D.........D
#.........#
#.##....#.#
#..#...#..#
#.........#
#####D#####
key : 5

5
2
#####D#####
#.........#
#.........#
#.........#
#.........#
l..###....D
#..##..#..#
#..#......#
#..#......#
#......#..#
#####d#####
locked : 0

3
1
#####D#####
#.#.....#.#
#.........#
#......#..#
#.........#
D...#.#...d
#.........#
#..#...#.##
#.........#
#.#.....#.#
#####D#####

4
3
###########
#..#e...e##
#........e#
#.........#
#...#.....#
D.........#
#.........#
#.....#...#
#.........#
#.........#
#####D#####
enemies 3

7
2
#####D#####
#.........#
#.........#
#.........#
#.........#
#.........#
#.........#
#.........#
#.........#
#.......#X#
###########

1
1
###########
#.........#
#.........#
#.........#
#.........#
D.........#
#.#.#.....#
#..##.....#
#.#.......#
#.........#
#####D#####

3
0
#####d#####
#.........#
#......p..#
#........p#
#...@..##.#
#....#.#..D
#...#..#..#
#....####.#
#.....#####
#.........#
#####D#####

5
1
#####D#####
#.........#
#......#..#
#.......#.#
#.........#
#...#.....l
#..#......#
#........##
#.........#
#.........#
###########

2
2
###########
#.........#
#.........#
#.........#
#.........#
d..#.#....D
#.#.......#
#...#.....#
#.#.#.....#
#.........#
#####D#####

0
0
###########
##.....#..#
#.........#
#.........#
#.#..#..#.#
#.........#
#.........#
##..#..#..#
#.........#
#.........#
#####D#####

5
3
#####D#####
#.........#
#.....##..#
#....#.#.##
#....#....#
D.........#
#....#.##k#
#.......###
#.........#
#.........#
###########
key : 4

