1
0
###########
#?........#
#.........#
#.........#
#.........#
#....@....#
#.........#
#.........#
#.........#
##........#
#####.#####
sign Many have walked this path.

4
1
#####.#####
#.........#
#.........#
##.....#..#
#.........#
#..........
#.#.....#.#
#.........#
#k........#
##.....#..#
###########
key : 1

3
2
#####d#####
#.........#
#.........#
#.........#
#.........#
d..........
#.........#
#.#.......#
#..#......#
#.........#
#####.#####

3
3
#####.#####
#.#.....#.#
#.........#
#.........#
#..#..#...#
..........#
#.........#
#.#..#..#.#
#.........#
#.........#
#####l#####

3
0
#####d#####
#.........#
#.........#
#.........#
#.........#
#..........
#.........#
#.........#
#.........#
#.........#
###########

1
3
#####.#####
#.........#
#.........#
#.........#
#...#.....#
....#......
#.####....#
#...##....#
#.#.......#
#.#.......#
#####d#####

0
4
###########
#........e#
#.........#
#.........#
#.##.#....#
...#.##...#
#....#....#
#...#.#...#
#.##......#
#.........#
#####.#####
enemies 1
door 0 : 0 1

2
3
#####d#####
#.........#
#.........#
#.........#
#.........#
.........k#
#.........#
#.........#
#.........#
#.........#
#####.#####
key : 4

3
1
#####.#####
#.........#
#.........#
#...#.....#
#..####...#
...####...d
#...#.....#
#.##.##...#
#.........#
#.........#
#####.#####

2
2
#####.#####
#.........#
#.........#
#.........#
#.........#
...........
#..#......#
#.........#
#.........#
#.........#
#####d#####

6
3
#####.#####
#..#......#
#..##.###.#
#.....#####
#...##.#..#
#.........#
#.........#
#.........#
#.........#
#X#.......#
###########

1
2
###########
#k#.......#
#.........#
#...#...#.#
#.........#
#...#.#....
#.........#
#.#.#.#...#
#.........#
#.......#.#
#####.#####
key : 6

0
3
###########
##e....#.##
#e........#
##.#.#.#.##
#e........#
#..#...#...
#.........#
##.#.#....#
#.........#
##.#...#.##
#####.#####
enemies 3

1
4
#####.#####
#.........#
#.........#
#.........#
#.........#
..........#
#.........#
#.........#
#........?#
#.......se#
###########
enemies 1
switch 0 : 0 1
sign The dungeon remembers all who enter.

2
0
#####.#####
#.........#
#.........#
#.......#.#
#......#..#
#.....#....
#.........#
#.........#
#.........#
#.........#
#####d#####

4
3
#####l#####
#.........#
##.#...#.##
#.........#
#..#...#..#
..........#
#..#.#.#..#
#.........#
##.#......#
#.........#
#####l#####
locked : 3

2
1
###########
#.........#
#..#...#..#
#.#.....#.#
#.........#
...........
#.........#
#.........#
#.........#
#.........#
#####.#####

4
2
#####.#####
#.........#
#......#k##
#.......#.#
#.........#
...........
#......#..#
#.........#
#.........#
#.........#
###########
key : 3

5
3
#####l#####
#.........#
#.........#
#.#.......#
#.........#
#....e....#
#.........#
#.........#
#.........#
#.........#
#####.#####
locked : 4
boss
enemies 1

