1
2
#####.#####
#.........#
#.........#
#.........#
#.........#
...##......
#.........#
#...##....#
#.....#...#
#.........#
#####.#####

0
1
###########
#k........#
#..#......#
#.#.......#
#.........#
#..........
#.........#
#.........#
#.........#
#.........#
#####.#####
key : 1

2
2
#####.#####
#.........#
#......#..#
#.......#.#
#.........#
..........d
#.........#
#.........#
#.........#
#.........#
###########

2
0
###########
#?........#
#.........#
#.....##..#
#.......#.#
#....@#...d
#.........#
#.........#
#.........#
#.........#
#####.#####
sign Many have walked this path.

2
5
#####.#####
#.#.....#.#
#.........#
#.#.#...#.#
#.........#
l...#.#...l
#.........#
#.#.#.#...#
#.........#
#.#.....#.#
###########
locked : 2

3
0
#####.#####
##.#...#.##
#.........#
#.#.#.#.#.#
#.........#
#..#...#..#
#.........#
#.#.#.#.#.#
#.........#
##.......##
###########

1
1
#####.#####
#.........#
#.........#
#.#..#..#.#
#.........#
#..........
#..#..#...#
#.........#
#.........#
#k#.....#.#
#####.#####
key : 0

3
3
#####.#####
#.........#
#.......#.#
#.........#
#....#....#
#k.........
#..#......#
#.......#.#
#......#..#
#.........#
#####d#####
key : 2

2
6
###########
#.........#
#..##.....#
#..##.....#
#.#.#.....#
l....e....#
#.##......#
#.........#
#.........#
#.........#
#####.#####
locked : 3
boss
enemies 1

3
4
#####.#####
#.........#
#.........#
#.........#
#.........#
..........#
#..#......#
#..#......#
#.#.#.....#
#.........#
###########

1
5
###########
#.....?#e##
#.....#..##
#.........#
#.....#...#
.....##...#
#.........#
#.........#
#.........#
#.........#
#####.#####
enemies 1
door 0 : 0 1
sign This door will not yield without a key.

3
6
#####.#####
#.........#
#.........#
#.........#
#.........#
#.........#
#.........#
#.........#
#.........#
#X........#
###########

1
3
###########
#.........#
#.##...#..#
#.#.....#.#
#....#....#
...........
#.........#
#.#.......#
#..#......#
#.........#
#####.#####

0
2
###########
#.....?.ee#
#.#...#.#s#
#.........#
#..#...#..#
..........#
#...#.#.#.#
#.........#
#..#.....##
#.........#
#####.#####
enemies 2
switch 0 : 0 1
sign What you seek is close.

4
3
#####d#####
#.........#
#.........#
#...##....#
#.........#
#.........#
#.........#
#.........#
#.........#
#.........#
###########

1
4
###########
#.........#
#.#.#.#.#.#
#.........#
#...#...#.#
...........
#.#.....#.#
#.........#
#.#.....#.#
#.........#
#####d#####

2
3
#####.#####
#.........#
#......#..#
#.......#.#
#.........#
d..........
#.........#
#.......#.#
#......#..#
#.........#
#####.#####

2
1
#####.#####
#.........#
##.....#..#
#.........#
#.........#
d...#..#...
#.........#
#.........#
##..#..#..#
#.........#
###########

2
4
#####d#####
#k........#
#..#...#..#
#.#.....#.#
#.........#
..........l
#.........#
#.......#.#
#......#..#
#.........#
#####.#####
key : 3

