1
4
#####D#####
#.........#
#.....p...#
#.....#...#
#...###...#
D....e....#
#.........#
#.........#
#.........#
#.........#
#####l#####
locked : 4
boss
enemies 1

3
2
#####D#####
#k........#
#.........#
#.........#
#.........#
D.........D
#.........#
#.........#
#.........#
#.........#
#####D#####
key : 4

3
0
###########
#.........#
#.........#
#.........#
#...#####.#
#....@....D
#.....##..#
#...#.##..#
#...#..#..#
#..#......#
###########

3
3
#####D#####
#.........#
#.#.....#.#
#.........#
#.........#
D....#....D
#.........#
#.........#
#.#.....#.#
#.e..e..e.#
###########
enemies 3

4
1
#####D#####
#.........#
#.........#
#.........#
#.........#
#.........D
#.........#
#.......#.#
#......#..#
#.........#
#####l#####

2
5
###########
#.........#
#..#......#
#...#.....#
#...#.....#
d.....##..#
#.......#.#
#.....#.#.#
#.........#
#.........#
###########

3
1
#####D#####
#e........#
#.........#
#.........#
#.........#
D.........D
#.#.......#
#.##......#
#..#......#
#e........#
#####D#####
enemies 2

5
1
#####l#####
#.........#
#..#...#..#
#.#.....#.#
#.........#
#.........D
#.........#
#.......#.#
#.#....#..#
#.........#
#####D#####
locked : 0

3
4
#####d#####
#.........#
#......#..#
#.......#.#
#.........#
D.........#
#.........#
#.........#
#.........#
#.........#
###########

4
2
#####D#####
#.........#
#..#...#.##
#.........#
#.#...#...#
D.........#
#....#.#..#
#.........#
#.#.#.#.#.#
#.........#
#####D#####

5
2
#####D#####
#.........#
#.........#
#.........#
#.........#
D.........#
#.........#
#.........#
#........e#
#......?ee#
###########
enemies 3
sign Turn back; you are not yet ready.

1
1
###########
#.........#
#..#......#
#.#.......#
#.........#
#.........#
#.........#
#.........#
#.........#
#.........#
#####d#####

0
4
###########
#X.......p#
#.........#
#.........#
#.........#
#.........#
#.........#
#.........#
#.........#
#.........#
#####D#####

2
2
###########
#.........#
#.........#
#.........#
#.........#
D.........d
#.........#
#.........#
#.........#
#.........#
#####D#####

1
3
###########
#k........#
##.#...#.##
#.........#
#..#.#....#
#.........D
#..#.#.#..#
#.........#
##.#...#..#
#.........#
#####D#####
key : 3

2
1
#####d#####
#.........#
#......#..#
#.........#
#.........#
#k........D
#.........#
#.......#.#
#......#..#
#.........#
#####D#####
key : 0

6
1
#####D#####
#.........#
#.#.....#.#
#.........#
#.........#
#.........#
#.........#
#.........#
#.#.....#.#
#k........#
###########
key : 1

2
3
#####D#####
#.........#
#......#..#
#.......#.#
#.........#
d.........D
#.........#
#.......#.#
#......#..#
#.........#
#####D#####

2
4
#####l#####
#.........#
##.#...#.##
#.........#
#.#...#.#.#
D.........d
#..#...#..#
#.........#
#.#.#.#...#
#.........#
#####d#####

