1
1
#####.#####
#.........#
#.........#
#.........#
#.###.....#
#..###.....
#..#.#....#
#.........#
#.........#
#.........#
#####l#####
locked : 0

2
1
#####l#####
#..#.....##
#.........#
#.........#
#...#..#..#
..........d
#.........#
#..#.....##
#.........#
#.........#
#####.#####

0
1
###########
#k........#
#......#..#
#.......#.#
#.........#
#.........#
#.#.......#
#.........#
#.......#.#
#.........#
#####.#####
key : 3

5
2
#####.#####
#.........#
#.#.#.#.#.#
#.........#
#..#.#....#
..........#
#...#.#...#
#.........#
#..#...#..#
#.........#
#####d#####

3
2
#####.#####
#.........#
#.........#
#....##...#
#....#..#.#
....####..d
#...k###..#
#...##....#
#.........#
#.........#
#####.#####
key : 2

1
3
###########
#.........#
#..#...#..#
#.#.....#.#
#.........#
..........#
#.........#
#.........#
#.........#
#.........#
#####.#####

3
1
#####.#####
#k........#
#......#..#
#.......#.#
#.........#
...........
#.........#
#.........#
#.........#
#.........#
#####.#####
key : 1

2
3
#####.#####
#.........#
#...#.....#
#...#.#.#.#
#...#.#.#.#
l..........
#.........#
#.....##..#
#.........#
#.........#
#####.#####
locked : 1

7
2
#####.#####
#.........#
#.........#
#.........#
#.........#
#.....##..#
#.....#.#.#
#.....#..##
#.........#
#X........#
###########

5
1
#####.#####
#.........#
#.........#
#.........#
#.........#
#..........
#.###.....#
#.###.....#
#e###.....#
#e?.......#
###########
enemies 2
sign Many have walked this path.

2
4
###########
#........e#
#.........#
#.........#
#....#..#.#
....###...#
#...#.###.#
#...#..##.#
#.........#
#.........#
###########
enemies 1
door 0 : 0 1

4
1
#####.#####
#......##.#
#..##.##..#
#..###.##.#
#....#....#
#..#.#.#..d
#.........#
#.........#
#.........#
#.........#
#####.#####

1
2
###########
#e...e....#
#.........#
#.........#
#.........#
...........
#.........#
#.........#
#.........#
#s........#
#####.#####
enemies 2
switch 0 : 0 1

4
2
#####.#####
#.........#
#.........#
#.........#
#.........#
d.........#
#.##......#
##.#.#....#
##.##.....#
#.........#
#####.#####

3
0
#####.#####
#.........#
##........#
#...###...#
#.#.#.....#
#...##.....
#..#.##...#
#..#..#...#
#..##.....#
#k........#
###########
key : 0

2
2
#####.#####
#.........#
#.........#
#.........#
#.###.....#
d.........l
#.....#...#
#......#..#
#.....#.#.#
#.........#
#####.#####

2
0
###########
#.........#
#.........#
#...##....#
#...##....#
#....@.....
#.........#
#.........#
#.........#
#.........#
#####.#####

3
3
#####.#####
#.........#
#.........#
#.........#
#.........#
d.........#
#.........#
#.........#
#.........#
##........#
###########

6
2
#####d#####
#.........#
#.........#
#.........#
#.........#
#....e....#
#.........#
#.........#
#.........#
#.........#
#####.#####
boss
enemies 1

