0
0
###########
#.........#
#..#......#
#.#.......#
#.........#
#.........D
#.........#
#.#.......#
#..#......#
#.........#
#####D#####

4
2
#####d#####
#..#......#
#.........#
#...#.....#
#.........#
#.........D
#.........#
#.........#
#.........#
#.........#
###########

2
1
#####d#####
#.........#
#.........#
#.........#
#.........#
D.........d
#.........#
#.........#
#.........#
#.........#
#####l#####

4
3
#####D#####
#.........#
#..#......#
#.#......##
#.........#
D.........#
#.........#
#.......#.#
#......#..#
#........k#
###########
key : 8

3
2
#####l#####
#.........#
#..#...#.##
#.#.....#.#
#.........#
D......#..D
#.........#
#.#.......#
#..#......#
#.........#
#####d#####
locked : 0

3
4
#####D#####
#.........#
#.........#
#.####....#
#.#.#.....#
D...##....#
#...##....#
#..##.....#
#.........#
#........X#
###########

1
3
###########
#.......?e#
#.#.....#.#
#.........#
#.........#
D....#....#
#.........#
#.........#
#.#.......#
#.........#
#####D#####
enemies 1
sign Turn back; you are not yet ready.

3
1
#####l#####
#.........#
#.........#
#.........#
#.........#
D.........D
#.........#
#.#.......#
#..#......#
#.........#
###########
locked : 1

3
0
#####D#####
#.........#
#.........#
#.........#
#...#.##..#
#...#.##..D
#.....##..#
#.........#
#.........#
#.........#
#####D#####

4
0
#####D#####
##.#...#..#
#.........#
#.#.#.#.#.#
#.........#
#..#.#....#
#.........#
#...#.#...#
#.........#
##.....#.##
###########

2
4
###########
#.........#
#.........#
#.........#
#...e.....#
d..#.##...#
#....#.#..#
#..###....#
#.....#...#
#..#...#..#
#####D#####
boss
enemies 1

1
1
#####D#####
#k........#
#.........#
#.........#
#.........#
D.........D
#.........#
#.........#
#.........#
#.........#
#####d#####
key : 0

2
2
#####D#####
#.........#
#......#..#
#.......#.#
#.........#
d.........l
#.........#
#.#.......#
#..#......#
#.........#
#####l#####

2
3
#####D#####
#.........#
#.........#
#.........#
#.........#
l.........d
#.........#
#.........#
#.........#
#.........#
#####D#####
locked : 2

1
2
###########
#.........#
#..#...#..#
#.#.....#.#
#.........#
D.........D
#.........#
#.......#.#
#......#..#
#.........#
#####D#####

1
0
#####D#####
#.........#
#.....#.###
#......####
#...@#?##.#
#....##...D
#......##.#
#.........#
#.........#
#.........#
#####D#####
sign A useful tool lies just ahead.

0
1
###########
#........k#
#.#.....#.#
#.........#
#.........#
D....#....#
#.........#
#.........#
#.......#.#
#.........#
#####D#####
key : 2

2
0
#####D#####
#..#.....##
#.........#
#.........#
#...#..#..#
#k........D
#.........#
#..#..#...#
#.........#
#.........#
#####D#####
key : 1

3
3
#####D#####
#e....?#..#
#...#e##..#
#...####..#
#.....###.#
D.........D
#.........#
#.........#
#.........#
#e........#
#####D#####
enemies 3
sign Turn back; you are not yet ready.

