1
0
#####D#####
#.#.......#
#.........#
#..###....#
#..###....#
#....#....D
#.........#
#.........#
#.........#
#.........#
#####D#####

4
5
#####D#####
#.........#
#......#..#
#.......#.#
#.........#
D.........#
#.........#
#.......#.#
#......#..#
#.........#
###########

4
3
###########
#.........#
#.........#
#..#..#..##
#.........#
d.........d
#.........#
#.........#
#.........#
#..#.....##
###########

3
4
#####D#####
#.........#
#.........#
#.........#
#.........#
#....e....D
#.........#
#.........#
#.........#
#.........#
#####d#####
boss
enemies 1

3
1
###########
#.........#
##..#.....#
#.........#
#.........#
D...#..#..D
#.........#
#.........#
##..#..#..#
#.........#
#####D#####

3
5
###########
#........X#
#.........#
#...#.##..#
#..#####..#
D...###...#
#...#.#.#.#
#.#...#...#
#.#.#.#...#
#.........#
#####D#####

1
2
#####d#####
#.........#
#.........#
#...#..#..#
#.........#
l.........#
#...#..#..#
#.........#
#.........#
##........#
#####l#####
locked : 0

5
2
#####D#####
#.........#
#.........#
#..#..#...#
#.........#
#.........#
#...#..#..#
#.........#
#.........#
#k.#.....##
###########
key : 2

0
2
###########
#.........#
#.........#
#.........#
#.........#
#.........#
#.........#
#.........#
#.........#
#.........#
#####d#####

3
0
#####D#####
#.........#
#.........#
#.........#
#.........#
#....@....D
#.........#
#.........#
#.........#
#?........#
###########
sign Beware what lurks ahead.

0
0
###########
#e.......e#
#.........#
#.........#
#.........#
#.........#
#.....#...#
#.....#...#
#.....#...#
#.........#
#####D#####
enemies 2
door 0 : 0

2
2
#####l#####
#.........#
#......##.#
#....#..#.#
#.........#
#.........#
#.........#
#.......#.#
#......#..#
#......#..#
#####D#####
locked : 2

4
2
#####D#####
#........k#
#.....#####
#.....###.#
#.....#...#
D......#..d
#......#..#
#.........#
#.........#
#.........#
#####D#####
key : 1

4
4
#####d#####
#.........#
#.........#
#....#.#..#
#....###..#
d....##...D
#.........#
#.........#
#.........#
#.........#
###########

4
1
#####D#####
#.........#
#.........#
#.........#
#.........#
#.........D
#....###..#
#..#..##..#
#.##..##..#
#.........#
###########

1
1
###########
#....k....#
#.........#
#.........#
#.........#
D.........l
#.........#
#.........#
#.........#
#.........#
###########
key : 0

3
2
#####D#####
#.........#
#..#...#..#
#.#.#...#.#
#.........#
D..#......#
#.........#
#.........#
#.........#
#.........#
#####D#####

2
0
#####D#####
#.........#
#.........#
#.#.......#
#.........#
#.........#
#.......ps#
#.........#
#p........#
#e........#
#####D#####
enemies 1
switch 0 : 0

2
4
###########
#k........#
#......#..#
#.........#
#.........#
#.........#
#.........#
#.........#
##..#.....#
#.........#
#####D#####
key : 5

