3
1
#####.#####
##.#...#.##
#.........#
#.#.#.#...#
#.........#
#..#...#...
#.........#
#.#...#.#.#
#.........#
##.#...#.##
#####d#####

2
1
#####l#####
#.........#
#.........#
#.........#
#.........#
#..#..#....
#..#.##...#
#.#####...#
#..#..#...#
#..#......#
#####.#####
locked : 0

5
2
#####.#####
#.........#
#.........#
#.........#
#.......#.#
......#...d
#....#k##.#
#.#..#.#.##
#.........#
#.........#
#####l#####
key : 4

3
2
#####.#####
#k........#
#.........#
#...#..#..#
#.........#
..........d
#....#....#
#.........#
#.........#
##.....#..#
#####.#####
key : 1

5
1
#####d#####
#.........#
#.........#
#.........#
#.........#
#..........
#.........#
#.....#...#
#.....#...#
#.........#
#####.#####

4
2
#####.#####
#.........#
#.........#
#....#....#
#..#......#
l...#.##..l
#..##.....#
#..#####..#
#.#.......#
#.........#
#####.#####
locked : 1

6
2
#####l#####
#.........#
#.........#
#.........#
#.........#
.....e....#
#..#..#...#
#..#..#...#
#.#...###.#
#.........#
#####.#####
locked : 3
boss
enemies 1

7
2
#####.#####
#.........#
#..#......#
#..##.....#
#.#..#....#
#..#.#....#
#X#.......#
###.##....#
#.........#
#.........#
###########

6
1
#####.#####
#.........#
#..#...#..#
#.#.....#.#
#.........#
#..........
#.........#
#.#.......#
#..#......#
#k........#
###########
key : 3

4
3
#####.#####
#.........#
#..#...#..#
#.#.....#.#
#.........#
l.........#
#.........#
#.#.......#
#..#......#
#.........#
#####.#####
locked : 4

5
3
#####.#####
#.........#
#..#...#..#
#.#.....#.#
#....#....#
d.........#
#.........#
#.........#
#.........#
#.........#
###########

1
0
###########
#?........#
#.....#...#
#........##
#...@#....#
#....#.#...
#....####.#
#.......#.#
#.........#
#.........#
###########
sign The dungeon remembers all who enter.

1
1
#####.#####
#.........#
#.........#
#.........#
#...####..#
...#..##...
#...#..#..#
#..#.#.#..#
#......#..#
#.........#
#####l#####

0
1
###########
#k........#
#.........#
#.........#
#.........#
#..........
#.........#
#.........#
#........##
#.........#
#####.#####
key : 0

2
2
#####.#####
#..#......#
#.........#
#.........#
#...#.....#
..........#
#.........#
#..#.....##
#.........#
#.........#
#####.#####

3
3
###########
#.........#
#..#..#..##
#.........#
#.........#
d...#..#..#
#.........#
#.........#
#..#.....##
#.........#
#####.#####

4
1
#####d#####
#.........#
#.........#
#...#####.#
#...#.#.#.#
#...#.....l
#.....#...#
#...#.###.#
#.........#
#.........#
#####d#####

1
2
#####.#####
#.........#
#.........#
#.........#
#.........#
..........#
#.........#
#.#.....#.#
#..#...##.#
#........##
#####.#####

0
2
###########
#.........#
#..#......#
#.#.......#
#.........#
..........#
#.........#
#.........#
#.........#
#.........#
#####.#####

