1
1
#####D#####
##.#...#.##
#.........#
#.#.#.#...#
#.........#
D..#...#..D
#.........#
#.#...#.#.#
#.........#
##.#...#.##
#####l#####

3
2
#####D#####
#.........#
#.........#
#.........#
#.........#
D..#..#...d
#..#k##...#
#.#####...#
#..#..#...#
#..#......#
#####D#####
key : 1

1
2
#####D#####
#.........#
#.........#
#.........#
#.......#.#
D.....#...#
#....#.##.#
#.p..#.#.##
#.........#
#.........#
#####D#####

2
1
#####l#####
#.........#
#.........#
#...#..#..#
#.........#
#.........D
#....#....#
#.........#
#.........#
##.....#..#
#####D#####
locked : 0

5
2
#####D#####
#k........#
#.........#
#.........#
#.........#
D.........d
#.........#
#.....#...#
#.....#...#
#.........#
#####l#####
key : 4

7
2
#####D#####
#.........#
#.........#
#.........#
#.........#
#.........#
#.........#
#.........#
#.........#
#X........#
###########

3
1
#####D#####
#.........#
#.........#
#....#..#.#
#.........#
#.........D
#.#..#..#.#
#.........#
#.........#
#.#.....#.#
#####d#####

4
3
#####D#####
#..#.....##
#.........#
#.........#
#..#..#...#
l.........#
#.........#
#..#..#..##
#.........#
#.........#
#####D#####
locked : 4

5
3
#####D#####
#.........#
#..#......#
#.#.......#
#.........#
d.........#
#.........#
#.......#.#
#......#..#
#.........#
###########

1
0
###########
#.?#......#
#.#.......#
#.#.......#
#.........#
#....@....D
#.#.......#
#.###.....#
#.........#
#.........#
###########
sign The dungeon remembers all who enter.

5
1
#####d#####
#.........#
#.........#
#.........#
#.........#
#.........D
#.....#.#.#
#.....###.#
#.....#.#.#
#.........#
#####D#####

3
3
###########
#.........#
#........##
#....##.###
#.....##..#
d.....#...#
#....##.#.#
#.........#
#.........#
#.........#
#####D#####

6
1
#####D#####
#.........#
#..#...#..#
#.#.....#.#
#.........#
#.........D
#.........#
#.......#.#
#......#..#
#k........#
###########
key : 3

6
2
#####l#####
#.........#
#.........#
#.#.......#
#..#e.....#
D..#.##...#
#..###....#
#....###..#
#.........#
#......#..#
#####D#####
locked : 3
boss
enemies 1

0
1
###########
#k........#
#.........#
#.........#
#.........#
#.........D
#.........#
#.#.....#.#
#..#...#..#
#.........#
#####D#####
key : 0

2
2
#####D#####
#.........#
#.........#
#.........#
#.........#
D......#..#
#.........#
#......#..#
#.........#
#.........#
#####D#####

0
2
###########
#.........#
#.#...#.#.#
#.........#
#.#.#.#.#.#
D.........#
#...#.#.#.#
#.........#
#.#.#.#.#.#
#.........#
#####D#####

4
1
#####d#####
#.........#
#.........#
#.........#
#.........#
#.........l
#.........#
#.........#
#........p#
#.........#
#####d#####

4
2
#####D#####
#..#......#
#.........#
#.........#
#...#.....#
l.........l
#.........#
#..#.....##
#.........#
#.........#
#####D#####
locked : 1

