4
0
#####D#####
#.........#
#.........#
#.........#
#.###.....#
#..###....D
#?###.....#
#s###.#...#
#e###.....#
#ee.......#
###########
enemies 3
switch 0 : 0 1
sign Something glints behind that door…

2
0
###########
#e........#
#?........#
#.........#
#.........#
#.........D
#.........#
#.........#
#.........#
#.........#
#####D#####
enemies 1
sign The dungeon remembers all who enter.

3
2
#####D#####
#.........#
#...#..#..#
#.........#
#.........#
D....#....D
#.........#
#.........#
##..#..#..#
#.........#
#####D#####

4
3
#####l#####
#.........#
#......#..#
##......#.#
#.##......#
D.........#
#.........#
#.........#
#.........#
#.........#
#####D#####
locked : 2

0
3
###########
#X........#
#.........#
#.........#
#.........#
#.........#
#.#.......#
#.##......#
#.#.......#
#.........#
#####D#####

3
1
#####d#####
#.........#
##.#...#.##
#.........#
#..#.#.#..#
D.........D
#....#.#..#
#.........#
##.#...#.##
#.........#
#####D#####

2
3
#####D#####
#.........#
#.........#
#....#....#
#.........#
D.........#
#.........#
#.#.......#
#..#......#
#........##
#####D#####

5
3
#####D#####
#.........#
#.#.#.#.#.#
#.........#
#.#.......#
D.........#
#.#.#.#.#.#
#.........#
#.....#...#
#........e#
###########
enemies 1
door 0 : 0 1

3
0
#####D#####
#.........#
#.........#
#.........#
#.........#
#?...@....D
#.........#
#.........#
#.........#
#.........#
#####D#####
sign The dungeon remembers all who enter.

2
2
#####d#####
#.........#
#.........#
#.........#
#.........#
D.........D
#.........#
#.........#
#.........#
#.........#
#####D#####

5
2
#####d#####
#.........#
#.#.....#.#
#.........#
#.........#
#.....#...D
#.........#
#.........#
#.#.......#
#.........#
###########

3
3
#####D#####
#k........#
#......#..#
#.......#.#
#.........#
D.........D
#.........#
#.........#
#.........#
#.........#
#####l#####
key : 2

4
1
#####D#####
#.........#
#.........#
#.........#
#.........#
D.........D
#.........#
#.........#
#.........#
#....k....#
###########
key : 0

3
4
###########
#........k#
#.........#
#.........#
#.........#
D.........#
#.........#
#.........#
#.........#
#.........#
###########
key : 3

1
2
###########
#.........#
#.........#
#...##.#..#
#....#.#..#
D...##.#..d
#.....###.#
#...#.#...#
#.........#
#.........#
#####d#####

1
1
###########
#k........#
#.........#
####......#
#.........#
#.........D
#.........#
#..#......#
#......#..#
#.........#
#####D#####
key : 1

1
3
#####D#####
#.........#
#.........#
#.........#
#.........#
d....e....#
#.........#
#.........#
#.........#
#.........#
#####D#####
boss
enemies 1

2
1
#####D#####
###.......#
#.#.#.....#
#.####....#
#.###..#..#
D..#......D
#...#.#...#
#...###...#
#...#.#...#
#.........#
#####d#####

4
2
#####D#####
#.........#
#.........#
#.........#
#.........#
D.........D
#.........#
#.#.......#
#..#......#
#.........#
#####d#####

