1
1
###########
#..#..k#..#
#...#.##..#
#......#..#
#..#...#..#
D.........#
#.........#
#.........#
#.........#
#.........#
#####D#####
key : 1

2
0
#####D#####
###.......#
#.###.....#
#.##......#
#.#####...#
#..####...d
#...@#....#
#.........#
#.........#
#.........#
#####D#####

1
5
###########
#.?#e.....#
#.........#
#.#.#.....#
#.........#
D.........D
#.........#
#.........#
#.........#
#.........#
#####D#####
enemies 1
door 0 : 0
sign The brave are rewarded.

3
1
#####D#####
#.........#
#.........#
#.........#
#.........#
D.........D
#.........#
#.......#.#
#......#..#
#.........#
###########

2
5
#####D#####
#.........#
#.........#
#.........#
#.........#
D.....##..#
#......#..#
#.........#
#.........#
#.......se#
###########
enemies 1
switch 0 : 0

1
3
###########
#.........#
#.........#
#.........#
#.........#
#.........D
#.........#
#.#.......#
#..#......#
#.........#
#####d#####

2
2
###########
#.........#
#.........#
#.........#
#.........#
l.........l
#..#......#
#.#.......#
##.#......#
#.........#
#####D#####
locked : 0

3
4
#####D#####
#.........#
#.........#
#.........#
#..#.#....#
D...#.....#
#.#.###...#
#.##......#
#.#.#.#...#
#........X#
###########

3
0
#####D#####
#.........#
#..##.....#
#..###....#
#..#.###..#
#.........D
#.....##..#
#.....##.##
#........##
#.........#
###########

0
4
###########
#k........#
#.#.#.#...#
#.........#
#..#.#....#
#.........#
#.#.#.#.#.#
#.........#
#......#.##
#.........#
#####D#####
key : 5

1
6
###########
#........k#
#.........#
#.#.......#
#.........#
D.........#
#.........#
#.........#
#.........#
#.........#
###########
key : 8

2
1
#####D#####
#.........#
#.........#
#.....#...#
#....#....#
d...#.....l
#.........#
#.........#
#.........#
#.........#
#####D#####

2
3
#####d#####
#.........#
#..##.....#
#.........#
#...#.....#
l.........d
#.........#
#.........#
#.........#
#.........#
#####D#####
locked : 1

1
0
#####D#####
#.........#
#.......#.#
#.........#
#.........#
#k........D
#.........#
#.........#
#.........#
#.........#
#####D#####
key : 0

1
4
#####D#####
#.........#
#.........#
#..#......#
#..###....#
D..#.e....D
#...#.....#
#.........#
#.........#
#.......#.#
#####d#####
boss
enemies 1

3
3
#####D#####
#.........#
#.........#
#..#..#...#
#.........#
D.........D
#...#..#..#
#.........#
#.........#
#.e#ee...##
###########
enemies 3

2
4
#####d#####
#.........#
#..#...#.##
#.........#
#..#.#.#..#
d.........D
#..#.#.#..#
#.........#
#......#.##
#.........#
#####D#####

3
2
#####D#####
#.........#
#..#......#
#.#.#.....#
#.#.#.....#
D...#.....D
#.........#
#.........#
#.........#
#.........#
###########

0
0
###########
##........#
#.........#
#.........#
#.........#
#.........#
#.........#
#.........#
#.........#
#.........#
#####D#####

