1
0
###########
##.....#..#
#.........#
#.........#
#...#.....#
#.........D
#.........#
##.....#..#
#.........#
#.........#
#####D#####

1
1
#####l#####
#k........#
#......#..#
#.........#
#.#.#.#.#.#
D.........d
#....#.#..#
#.........#
#.#...#.#.#
#.........#
#####D#####
key : 2

0
3
###########
#.....e##e#
#......##.#
#...#####.#
#......##.#
D.........D
#.........#
#.........#
#.........#
#.........#
#####D#####
enemies 2
door 0 : 0

2
1
#####D#####
#.........#
#.........#
#.#.#.#...#
#.........#
D..##.#...#
#.##.#....#
#.....#...#
#.........#
#........k#
###########
key : 0

3
0
#####D#####
#.........#
#.........#
#..#..#..##
#.........#
#.........#
#...#..#..#
#.........#
#.........#
#..#......#
#####d#####

5
0
#####D#####
#.........#
#.........#
#.........#
#.........#
#.........D
#.........#
#.#.......#
#..#......#
#k........#
###########
key : 9

0
4
###########
#.........#
#.........#
##........#
#.........#
D...#.....#
#.........#
#.........#
#...#.....#
#.........#
#####d#####

2
0
#####D#####
#.#.......#
#.#.#.....#
#.###.....#
#.........#
#....@....D
#.........#
#.........#
#.........#
#.........#
#####D#####

2
3
#####D#####
#.........#
#.........#
#.........#
#.#.......#
#..#......D
#..#......#
#.........#
#.........#
#.........#
###########

5
1
###########
#........e#
#.........#
#.#..#..#.#
#.........#
D.........#
#.#..#..#.#
#.........#
#.........#
#.#.....#e#
###########
enemies 2

2
4
#####D#####
#.........#
#..##.#...#
#...##e...#
#.pe#e#...#
D..##.....D
#.........#
#...#.....#
#.........#
#.........#
###########
enemies 3

0
1
###########
#.........#
#.........#
#.........#
#.........#
#.........D
#.........#
#.#.......#
#..#......#
#.........#
#####l#####
locked : 0

1
4
#####d#####
#.........#
#.#.......#
#.........#
#.........#
l.........l
#.......#.#
#.........#
#.........#
#.........#
#####D#####
locked : 3

1
3
#####D#####
#k........#
#..#......#
#.#.......#
#.........#
D.........l
#.........#
#.........#
#.........#
#.........#
#####D#####
key : 3

0
2
###########
#.....e#..#
#.....s#..#
#.....##..#
#.........#
D.........D
#.........#
#.........#
#.........#
#.........#
#####D#####
enemies 1
switch 0 : 0

1
2
#####D#####
#.........#
#.........#
#.#..#..#.#
#.........#
d.........D
#..#......#
#.........#
#.........#
#.#.....#.#
###########

4
0
#####d#####
#.........#
#..#......#
#.#.......#
#.........#
#.........#
#.........#
#.#.....#.#
#..#...#..#
#.........#
#####D#####

1
5
###########
#.##......#
#.##......#
#.........#
#.........#
l....e....#
#.........#
#.........#
#.........#
#.........#
#####D#####
locked : 2
boss
enemies 1

2
5
#####D#####
#.........#
#.........#
#.........#
#.........#
D.........#
#.........#
#.........#
#.........#
#........X#
###########

