2
4
#####.#####
#.........#
#..#...#..#
#.#.....#.#
#.........#
d.........#
#.........#
#.#.......#
#..#......#
#.........#
#####l#####

2
1
#####l#####
#.........#
#.........#
#.........#
#.........#
...........
#.........#
#.......#.#
#......#..#
#.........#
#####.#####
locked : 0

3
3
#####d#####
#........##
#......#..#
#.......#.#
#.........#
...........
#.#.......#
#.#.....#.#
#..#..##..#
#.........#
###########

1
2
###########
#....k....#
#.........#
#......#..#
#.....###.#
.......#...
#.........#
#.........#
#.........#
#.........#
#####.#####
key : 2

1
0
#####.#####
#.........#
#.........#
#.........#
#...@.....#
#...###....
#....##...#
#.#.#.#...#
#.##..#...#
#?##......#
#####.#####
sign What you seek is close.

1
1
#####d#####
#.......#.#
#.........#
#.#.....#.#
#.........#
....#.#....
#.........#
#.#.....#.#
#.........#
#k#.....#.#
#####l#####
key : 0

3
1
#####.#####
#..#...#.##
#.........#
#........##
#.........#
l..#.#.#...
#.........#
##.#...#.##
#.........#
##.#.....##
###########
locked : 2

2
3
#####.#####
#.........#
#.........#
#....#....#
#.........#
..........d
#..#......#
#.........#
#.........#
#.#.....#.#
#####d#####

2
2
#####.#####
#k.....#..#
#.........#
#.........#
#.#..#..#.#
...........
#.........#
##..#..#..#
#.........#
#.........#
#####.#####
key : 3

1
3
###########
#.........#
#..#...#..#
#.#.....#.#
#.........#
...........
#.........#
#.......#.#
#......#..#
#.........#
#####.#####

0
0
###########
#k........#
#.........#
#.........#
#.........#
#..###.....
#.#####...#
#.#.###...#
#...#.#...#
###.......#
#####.#####
key : 1

1
4
###########
#.....?..e#
#.....#...#
#.........#
#.........#
...#......#
#.........#
#.........#
#..#..#..##
#.........#
#####.#####
enemies 1
sign Beware what lurks ahead.

4
2
#####d#####
#.........#
#.........#
#.........#
#.........#
#.........#
#.........#
#.........#
#.........#
#.........#
###########

0
1
###########
#.........#
#........##
#.........#
#..#.#....#
..........#
#....#.#..#
#.........#
#..#...#.##
#.........#
#####d#####

4
4
#####.#####
#.........#
#..##.....#
###.......#
#...#.....#
#...#.....#
#.#.#.....#
#.........#
#.........#
#X........#
###########

3
0
#####.#####
#.........#
#.........#
#.........#
#.###.....#
#..#.#....l
#.##.#....#
#..#......#
###.#.....#
#.........#
###########

3
2
#####.#####
#.........#
#.....#...#
#.........#
#.....#.#.#
...#.......
#.........#
#..#......#
#..#......#
#.........#
#####d#####

2
0
#####.#####
##........#
#.........#
#.........#
#.#..#....#
#..........
#.........#
##..#.....#
#.........#
#.........#
#####.#####

3
4
#####l#####
#..#......#
##.##.....#
#..##.....#
#.#..#....#
....#e....#
#.###.....#
#..#......#
#.........#
#.........#
#####.#####
locked : 1
boss
enemies 1

