1
2
#####d#####
#.........#
#......#..#
#.......#.#
#.........#
#.........#
#.........#
#.........#
#.........#
#.........#
#####l#####
locked : 0

6
2
#####d#####
#.........#
#.#.#.#.#.#
#.........#
#..#......#
D.........#
#.#.#.#.#.#
#.........#
#..#...#..#
#.........#
###########

2
1
###########
#....?....#
#.........#
#.#..#....#
#.........#
D.........d
#..#..#...#
#.........#
#.........#
#e#.......#
#####D#####
enemies 1
sign Something glints behind that door…

3
1
#####D#####
#.........#
#..#......#
#.#.......#
#.#.......#
D........k#
#.........#
#.........#
#.........#
#..#......#
#####D#####
key : 0

5
2
#####d#####
#.........#
#.........#
#.........#
#.........#
D.........D
#.........#
#.#.......#
#..#......#
#.........#
#####d#####

6
1
#####D#####
#.........#
##.#...#.##
#.........#
#.#.#.#.#.#
#.........D
#..#.#.#..#
#.........#
#.#.#.#...#
#.........#
#####D#####

2
0
###########
#.........#
#...#..#..#
#.........#
#.........#
#.........D
#.........#
#.........#
#...#.....#
#.........#
#####D#####

5
3
#####D#####
#.........#
#.........#
#.........#
#.........#
D.........#
#.........#
#.........#
#.........#
#.........#
###########

4
1
#####D#####
#.........#
#.........#
#.........#
#.........#
l.........D
#.........#
#.........#
#.........#
#.........#
#####D#####
locked : 1

2
2
#####l#####
#.........#
#.........#
#...#.....#
#.........#
d....#.#..D
#..#..#...#
#.....#..##
#......#.##
#......#.##
###########

7
1
#####D#####
#.........#
#..#...#..#
#..##.#...#
#..##.#...#
#.........#
#.........#
#....p....#
#.........#
#e.......e#
###########
enemies 2

4
3
#####D#####
#.........#
#.........#
#.........#
#.#.#e....#
l...##.#..#
#.#####...#
#..#...#..#
#.........#
#.........#
#####D#####
locked : 2
boss
enemies 1

4
0
#####D#####
#.........#
#..#......#
#.#...#...#
#.........#
#..#......l
#.........#
#.##......#
#..#......#
#k........#
###########
key : 1

4
2
###########
#.........#
#.....p...#
#.........#
#.........#
D.........l
#.........#
#.........#
#.........#
#.........#
#####d#####

3
0
#####D#####
#.........#
#.........#
#..#.#....#
#.#####.#.#
#..##@....D
#.....#.#.#
#....#....#
#.........#
#.........#
#####D#####

3
3
#####D#####
#.........#
#.........#
#....#.####
#....#.##.#
#....###X.#
#.p..#.##.#
#.p..#..#.#
#.........#
#.........#
#####D#####

0
2
###########
#.........#
#.........#
#.........#
#.........#
#.........#
#.........#
#...#.....#
#.........#
#.........#
#####d#####

5
1
#####D#####
#......#.##
#.........#
##.#...#.##
#k........#
#..#.#....D
#.........#
#..#.#.#..#
#.........#
##.......##
#####D#####
key : 2

2
3
###########
#........k#
#..#...#.##
#.........#
#..#.#....#
D.........#
#..#.#.#..#
#.........#
#......#.##
#.........#
#####D#####
key : 4

