2
0
#####.#####
#.........#
#.......#.#
#...#..#..#
#...##....#
#...###....
#.###@#...#
#..#...#..#
#.........#
#.........#
#####.#####

3
0
#####.#####
#.........#
##.#......#
#k#.....#.#
#.........#
#..........
#.........#
#.......#.#
#......#..#
#.........#
#####.#####
key : 1

3
1
#####.#####
#e.......s#
#.........#
#.........#
#........?#
.........e#
#.........#
#.........#
#.........#
#e........#
#####.#####
enemies 3
switch 1 : 2
sign Those who search shall find.

4
1
#####.#####
#?........#
#.........#
#.##......#
#.#e......#
...#e#.....
#.####....#
#..##.....#
#.........#
#.........#
#####d#####
enemies 2
door 0 : 0 1
sign Beware what lurks ahead.

4
0
#####.#####
#.........#
#.........#
#.........#
#.........#
#..........
#.........#
#.......#.#
#......#..#
#.........#
###########

1
3
###########
#.........#
#..#...#..#
#.........#
#..#...#..#
#.........#
#..#...#..#
#.........#
##.#...#..#
#.........#
#####.#####

5
1
#####d#####
#.........#
#.........#
#.........#
#.........#
#....##...#
#.........#
#.#.....#.#
#..#...#..#
#........##
###########

4
2
###########
#........e#
#.........#
#.........#
#.........#
..........#
#.........#
#.........#
#.......#.#
#......#ee#
###########
enemies 3
door 1 : 2

2
5
#####.#####
#.........#
#.........#
#.........#
#...#.....#
d....e#...#
#...#.#...#
#.........#
#.........#
#.........#
#####.#####
boss
enemies 1

3
5
#####.#####
#.........#
#......#..#
#.......#.#
#.........#
..........#
#.........#
#.......#.#
#......#..#
#........k#
###########
key : 7

1
1
###########
#.#.....#.#
#.........#
#......#.##
#.........#
....#.#...#
#.........#
#..#...#.##
#.........#
#.#.....#.#
#####.#####

0
0
###########
#......#..#
#.........#
#.........#
#.........#
#.........#
#.........#
#.........#
##........#
#.........#
#####l#####
locked : 0

2
4
###########
#..#...#.##
#.........#
#...#.#...#
#.........#
d..#.#.#..d
#.........#
#.#.#.#...#
#.........#
##.....#.##
#####.#####

1
5
###########
#X........#
#.........#
#.........#
#.........#
#.........#
#.........#
#.........#
#.........#
#.........#
#####.#####

2
1
#####.#####
#.........#
#.....#...#
#...#.....#
#...###...#
...........
#.....###.#
#.....#k#.#
#.........#
#.........#
#####.#####
key : 0

1
0
#####l#####
#e.#......#
#.........#
#.....##.##
#s....##..#
#e....##...
#.........#
#.........#
#.........#
#.........#
#####.#####
enemies 2
switch 0 : 0 1

2
3
#####.#####
##.....#..#
#.........#
#.........#
#.#.....#.#
d.........d
#.........#
##.....#..#
#.........#
#.........#
###########

2
2
###########
#.........#
#.........#
#.........#
#.........#
..........d
#.........#
#.........#
#.........#
#.........#
###########

3
4
#####.#####
#.........#
#..#..#..##
#.........#
#.........#
#..#..#....
#.........#
#.........#
#..#..#..##
#k........#
###########
key : 5

