2
4
###########
#k........#
##.....#..#
#.......#.#
#.........#
...........
#.........#
#.......#.#
#......#..#
#.#.......#
#####.#####
key : 4

2
0
#####.#####
#.........#
#..#...#..#
#.#.....#.#
#.........#
#..........
#.........#
#.#.......#
#..#......#
#.........#
#####.#####

3
1
#####.#####
#.........#
#.#.#...#.#
#.........#
#.......#.#
...........
#...#.#.#.#
#.........#
#.#.#.#.#.#
#...k.....#
###########
key : 0

2
1
###########
#.........#
#.........#
#.........#
#.........#
...........
#.........#
#.#.....#.#
#..#...#..#
#.........#
#####.#####

0
6
###########
#........X#
#.........#
#.........#
#.........#
..........#
#.........#
#....#....#
#.........#
#.........#
#####.#####

3
3
#####d#####
#.........#
#.........#
#.#..#..#.#
#.........#
..........d
#....#..#.#
#.........#
#.........#
#.#.....#.#
#####d#####

2
6
#####.#####
#.#....#..#
#...#.....#
#.#...#...#
#.###.....#
..........#
#.........#
#.........#
#.........#
#........e#
###########
enemies 1

1
6
#####.#####
#.........#
#.###.....#
#.##......#
#...#.#...#
l....e....#
#...#.....#
#.........#
#.........#
#.........#
#####.#####
locked : 3
boss
enemies 1

2
3
###########
#.........#
#......#..#
#.......#.#
#.........#
...........
#.........#
#.......#.#
#......#..#
#.........#
#####d#####

3
4
#####.#####
#.........#
#......#..#
#.......#.#
#.........#
d.........#
#.........#
#.........#
#.........#
#.........#
###########

0
5
###########
#ee.......#
#e#.#.....#
#.#.......#
#.##.#....#
#..###.....
#.##......#
#.......#.#
#.........#
#.........#
#####.#####
enemies 3

2
2
###########
#.k.......#
#.#.....#.#
#.........#
#.........#
...........
#.........#
#.........#
#.#.....#.#
#.........#
#####.#####
key : 3

3
2
#####.#####
#k........#
#.........#
#......#..#
#.........#
...........
#.........#
##......#.#
#......#..#
#.........#
#####d#####
key : 1

4
2
#####d#####
##.#...#.##
#.........#
#.#.#.#.#.#
#.........#
#....#.#...
#.........#
#.....#.#.#
#.........#
##.#.....##
###########

1
5
#####.#####
#.........#
#e#.....#.#
#.........#
#.........#
#e...#....l
#.........#
#.........#
#.#.....#.#
#.........#
#####.#####
enemies 2

3
0
#####.#####
#.........#
#.........#
#.........#
#.........#
#....@.....
#.........#
#.........#
#.........#
#.........#
###########

4
3
#####d#####
##........#
#.....###.#
#....#.#..#
#.......#.#
....###...#
#...####..#
#.........#
#.........#
#.........#
###########

1
0
###########
#.........#
#..#......#
#.........#
#...#.....#
#.........#
#.........#
#.#.......#
#..#......#
#.......#.#
#####.#####

2
5
#####.#####
##e#......#
##........#
#####.....#
#.##e#....#
...#.##....
#.##......#
######....#
#.........#
#.........#
###########
enemies 2

