0
3
###########
#.........#
#..#...#..#
#.#..#..#.#
#.........#
#.........#
#.........#
#..#..#...#
#.........#
#.........#
#####.#####

3
2
#####l#####
#.........#
#.........#
#.........#
#.........#
#..........
#.......#.#
#.#.......#
#..#...#..#
#.#.......#
###########
locked : 2

2
5
#####.#####
#.........#
#.........#
#.........#
#....#....#
...........
#.........#
##........#
##........#
#k........#
###########
key : 4

1
6
###########
#.........#
#......##.#
#.....###.#
#.......#.#
d....e....#
#.........#
#.........#
#.........#
#.........#
#####.#####
boss
enemies 1

2
1
#####d#####
#.........#
#.........#
#.#..#..#.#
#.........#
#..........
#.....#...#
#.........#
#.........#
#.#.....#.#
###########

1
0
#####.#####
#.........#
#.........#
#.........#
#.........#
#....@.....
#..#......#
#.........#
##.#......#
#?........#
###########
sign Beware what lurks ahead.

1
5
#####l#####
#.........#
#..#...#..#
#.#.....#.#
#.........#
d.........d
#.........#
#.........#
#.........#
#.........#
#####.#####

1
2
###########
#....k....#
#.........#
#.........#
#...###.#.#
.....##...d
#....####.#
#....##..##
#.........#
#.........#
#####.#####
key : 0

1
3
#####.#####
#.........#
##..#.....#
#.........#
#.........#
d....#.....
#.........#
#.........#
##........#
#.........#
#####.#####

2
3
#####.#####
#.........#
#.........#
#.........#
#.........#
..........l
#.........#
#.#.....#.#
#..#...#..#
#.........#
#####l#####

1
1
#####.#####
#.........#
#........##
#.........#
#....#.#..#
...........
#..#.#....#
#.........#
#..#...#.##
#.........#
#####d#####

1
4
###########
#....k....#
#.........#
#.........#
#...#.....#
......#...d
#...###...#
#.........#
#.........#
#.........#
#####.#####
key : 2

0
0
###########
#.........#
#.........#
#.........#
#.........#
#..........
#.........#
#.#.......#
#..#......#
#.........#
#####.#####

2
4
#####.#####
#.........#
#.........#
#.........#
#.........#
l..........
#.........#
#.......#.#
#......#..#
#.......#.#
###########
locked : 0

0
1
###########
#.........#
##.....#..#
#.......#.#
#.........#
..........#
#.........#
#.........#
#.....#...#
#.........#
#####.#####

2
2
#####.#####
#k........#
#.........#
#.........#
#.........#
...........
#.......#.#
#.........#
#.........#
#.........#
#####l#####
key : 1

0
5
###########
#.........#
#.........#
#..#......#
#.........#
#.........#
#.........#
#.......#.#
#......#..#
#.........#
#####l#####
locked : 4

3
3
#####l#####
#.........#
#......#..#
#.......#.#
#.........#
..........#
#.........#
#.........#
#.........#
#.........#
###########
locked : 1

2
6
#####.#####
#.........#
#.........#
#.........#
#.........#
..........#
#..##.....#
#.#.#.....#
#.........#
#........X#
###########

