6
2
#####d#####
#.........#
#.........#
##..#..#..#
#.........#
#.........#
#...#..#..#
#.........#
#.........#
##.....#..#
###########

3
2
###########
#.........#
#..#......#
#.#.......#
#.........#
D......#..d
#.......#.#
#.#.......#
##.#......#
#.........#
#####D#####

4
3
#####D#####
#.........#
#.........#
#.........#
#.........#
l.........l
#.........#
#.........#
#.........#
#.........#
#####D#####
locked : 1

2
4
###########
#........k#
#.........#
#.........#
#.........#
D.........#
#.........#
#.......#.#
#......#..#
#.........#
#####D#####
key : 3

2
3
#####d#####
#.........#
#.........#
#.........#
#.........#
#.........D
#.........#
#.........#
#.........#
#.........#
#####l#####
locked : 2

3
1
###########
#..#...#k##
#.........#
#...#.#...#
#.........#
D..#.#.#..D
#.........#
#.#.#.#.#.#
#.........#
#..#...#..#
#####D#####
key : 1

3
3
#####l#####
#.#.......#
#.#.......#
#..###....#
#.##......#
d..##.....d
#..##.....#
#.........#
#.#.#.....#
#.........#
#####D#####

4
4
#####D#####
#.........#
#..#......#
#.#.......#
#.........#
l.........#
#.........#
#.#.......#
#..#......#
#.........#
###########
locked : 0

3
0
###########
#e........#
#e.......p#
#.........#
#.........#
#.........D
#.........#
#...p.....#
#.........#
#.........#
#####D#####
enemies 2

1
3
#####D#####
#.........#
#.........#
#.........#
#.........#
#....e....#
#.........#
#.........#
#.........#
#.........#
#####d#####
boss
enemies 1

0
3
###########
#X........#
#.........#
#.........#
#.........#
#.........#
#.........#
#.......#.#
#.....##..#
#.........#
#####D#####

4
0
#####D#####
#.........#
#.....###.#
#....#....#
#...##..#.#
#?...@#...D
#...#.##..#
#.........#
#.........#
#.........#
#####D#####
sign Many have walked this path.

4
1
#####D#####
#.........#
#......#..#
#..#....###
#...#####.#
D...####..D
#..##..##.#
#.........#
#.p.......#
#.........#
#####D#####

5
0
#####D#####
#.........#
#.......#.#
#.........#
#.........#
#.........D
#.........#
#.........#
#.#.....#.#
#e........#
###########
enemies 1

3
4
#####D#####
#.........#
#......#..#
#.......#.#
#.........#
d.........#
#.........#
#.........#
#.........#
#.........#
#####D#####

4
2
#####D#####
#.#.....#.#
#.........#
#.........#
#.#..#....#
D.........l
#.........#
#.#..#..#.#
#.........#
#.........#
#####D#####

5
1
#####D#####
#.........#
#.........#
#.........#
#.........#
D.........D
#.........#
#.........#
#.........#
#....k....#
###########
key : 0

5
2
#####D#####
#.........#
#.........#
#.........#
#.........#
D.........D
#.........#
#.........#
#.........#
#.........#
#####d#####

5
3
#####D#####
#.........#
#.........#
#.........#
#.........#
D.........#
#.........#
#......p..#
#.........#
#........k#
###########
key : 2

