6
2
###########
#.........#
#......#..#
#.......#.#
#.........#
...#......#
#.........#
#...#...#.#
#......#..#
#.........#
#####.#####

3
2
#####.#####
#e........#
#.........#
#.........#
#...s#?...#
....#e#....
#.....#...#
#.........#
#.........#
#e........#
#####.#####
enemies 3
switch 0 : 0
sign The brave are rewarded.

7
1
#####.#####
#.........#
#.........#
#.........#
#.........#
#.........l
#.........#
#.........#
#.........#
#k........#
###########
key : 0

3
0
#####d#####
#......#..#
#.....##..#
#....##...#
#.#.##....#
#...#.#....
#.##..#...#
#.#.#.....#
#...#.....#
##........#
#####d#####

5
1
#####.#####
#.........#
#.........#
#.#..#....#
#.........#
..........#
#.....#...#
#.........#
#.........#
#.#.....#.#
#####.#####

6
1
#####.#####
#e........#
#.........#
#.........#
#s........#
#e.........
#.........#
#.........#
#.........#
#.........#
#####.#####
enemies 2
switch 1 : 1

1
1
#####.#####
#.........#
#.........#
#.........#
#..###.#..#
#..#e#....#
#..#.#.#..#
#..#......#
#..#......#
#.........#
#####d#####
boss
enemies 1

7
2
#####.#####
#.........#
#.........#
#......##.#
#....##...#
l......#..#
#....###..#
#......####
#.........#
#.........#
###########
locked : 0

4
2
#####.#####
#.........#
##..#..#..#
#.........#
#.........#
d...#......
#.........#
#.........#
##.....#..#
#.........#
###########

2
2
###########
#.......?e#
#.........#
#.........#
#.........#
..........#
#.........#
#.........#
#.#.......#
#.........#
#####.#####
enemies 1
door 1 : 1
sign What you seek is close.

4
0
#####d#####
#.........#
#.........#
#.........#
#.........#
#..##.#....
#.#####...#
#..#.##...#
#.##......#
#.........#
#####.#####

3
1
#####.#####
##k#.....##
#.........#
#...#.#...#
#.........#
...#.#.....
#.........#
#.#.#.#...#
#.........#
##.#...#..#
#####.#####
key : 1

2
1
#####d#####
#k........#
#.........#
#.........#
#.........#
...........
#.........#
#.........#
#.........#
#.........#
#####.#####
key : 4

4
3
#####.#####
##.....#..#
#.........#
##.#...#..#
#.........#
...#...#..#
#.........#
##.#...#.##
#........?#
##.#...#e##
###########
enemies 1
door 0 : 0
sign Many have walked this path.

2
0
###########
#.........#
#.........#
#.........#
#.........#
#..........
#.........#
#.........#
#.........#
#.........#
#####d#####

4
1
#####.#####
#........k#
#.....#..##
#.........#
#.........#
....#.....d
#.........#
#.........#
#.....#..##
#.........#
#####.#####
key : 3

3
3
###########
#.........#
#.........#
#.........#
#.........#
..........#
#.........#
#.........#
#.........#
#.........#
#####.#####

0
1
###########
#X........#
#.........#
#.........#
#.........#
#.....#...#
#.#.#.#...#
#..#......#
#.###.....#
#.#.......#
#####.#####

5
0
#####.#####
#.........#
#.........#
#.........#
#.........#
#..##@.....
#.#.##.#..#
##...#.#..#
##..#..#..#
#?........#
###########
sign The dungeon remembers all who enter.

