3
0
#####d#####
#.........#
#......#..#
#.......#.#
#.........#
#..#......D
#.........#
#...#...#.#
#......#..#
#.........#
#####d#####

0
1
###########
#X.#......#
#.....#...#
#..#.##...#
#...#..#..#
#..##.##..#
#.........#
#.........#
#.........#
#.........#
#####D#####

4
0
#####d#####
#.........#
#...#.....#
#.........#
#.........#
#....#....D
#.........#
#.........#
##..#..#..#
#.........#
#####D#####

6
1
#####D#####
###.......#
###.#.....#
##e#...#..#
#..e##....#
#..#s#....D
#.........#
#.........#
#.........#
#.........#
#####D#####
enemies 2
switch 1 : 1

6
2
###########
#.........#
#.........#
#.........#
#.........#
D....#.#..#
#...#..#..#
#...#####.#
#...#.#.#.#
#.......#.#
#####D#####

5
0
#####D#####
#.........#
#.........#
#.........#
#.........#
#....@....D
#.........#
#.........#
#.........#
#?........#
###########
sign The dungeon remembers all who enter.

1
1
#####D#####
#.........#
#.........#
#.#...#...#
#...##....#
#....e#...#
#.#.###...#
#.#...#...#
#.........#
#.........#
#####d#####
boss
enemies 1

2
2
###########
#..#....e##
#........?#
#.........#
#...#..#..#
D.........#
#.........#
#..#......#
#.........#
#.........#
#####D#####
enemies 1
door 1 : 1
sign What you seek is close.

4
1
#####D#####
#k........#
##.#...#..#
#.........#
#.#.#.#.#.#
D.........d
#..#.#....#
#.........#
#.#.#.#...#
#.........#
#####D#####
key : 3

5
1
#####D#####
#.........#
#..#.....##
#.........#
#.........#
D..#..#...#
#.........#
#.........#
#.....#..##
#.........#
#####D#####

3
2
#####D#####
#e......?s#
#.........#
#.#..#....#
#.........#
D.........D
#.#..#..#.#
#.........#
#.........#
#e#.....#e#
#####D#####
enemies 3
switch 0 : 0
sign The brave are rewarded.

4
3
#####D#####
##.#.....##
#.........#
#...#.#...#
#.........#
D..#.#....#
#.........#
#.#.#.#...#
#.........#
##.#...#?e#
###########
enemies 1
door 0 : 0
sign Many have walked this path.

2
1
#####d#####
#k........#
#.........#
#.........#
#.........#
D.........D
#.........#
#.........#
#.........#
#.........#
#####D#####
key : 4

4
2
#####D#####
#.........#
#.........#
#.........#
#.........#
d.........D
#.........#
#.#.......#
#..#......#
#.........#
###########

7
1
#####D#####
#.........#
#.....#...#
#......##.#
#......##.#
#.........l
#.........#
#.........#
#.........#
#k........#
###########
key : 0

3
1
#####D#####
#k#.....#.#
#.........#
#.#.#.#.#.#
#.........#
D...#.#...D
#.........#
#.#.....#.#
#.........#
#.#.......#
#####D#####
key : 1

3
3
###########
##.#.....##
#.........#
#...#.#...#
#.........#
D..#......#
#.........#
#...#.#.#.#
#.........#
#..#......#
#####D#####

2
0
###########
#.........#
#.......#.#
#.........#
#.........#
#..#..#...D
#.........#
#.........#
#.......#.#
#.........#
#####d#####

7
2
#####D#####
#.........#
#.#.#.#.#.#
#.........#
#.....#.#.#
l.........#
#.#.#...#.#
#.........#
#...#...#.#
#.........#
###########
locked : 0

