2
0
#####.#####
#.........#
#......##.#
#.....###.#
#.........#
#...####...
#...###.#.#
#.......#.#
#.....#...#
#.........#
#####.#####

1
2
###########
#e...e....#
#.........#
#.........#
#.........#
..........l
#.........#
#.........#
#.........#
#e........#
#####.#####
enemies 3

1
1
###########
#.........#
#.#...#.#.#
#.........#
#...#...#.#
d..........
#.#.#...#.#
#.........#
#...#.#...#
#.........#
#####.#####

3
4
#####.#####
#.........#
#.........#
#....#.####
#....##...#
d....#.#..l
#......#..#
#.........#
#.........#
#.........#
#####d#####

4
4
#####d#####
#.........#
#.........#
#.........#
#...#.....#
#..........
#.........#
#.........#
#.........#
#.........#
###########

3
5
###########
#.........#
#...#.....#
#..###....#
#.#.......#
l..........
#.........#
#.........#
#.........#
#.........#
#####l#####
locked : 2

1
3
###########
#.........#
#..#......#
#.#..#....#
#.........#
l.........#
#..#......#
#.........#
#.........#
#.........#
#####.#####
locked : 1

2
4
###########
#......##k#
#..#......#
#.#.......#
#.........#
.....#....#
#.........#
#.......#.#
#......#..#
#.........#
#####.#####
key : 4

3
3
#####d#####
#.........#
#.........#
#.........#
#.........#
..........d
#.........#
#.......#.#
#......#..#
#.........#
###########

2
1
#####.#####
#.........#
#..#......#
#.#.......#
#.........#
...........
#.........#
#.#.....#.#
#..#...#..#
#..k......#
###########
key : 0

2
3
#####.#####
#k........#
#.#.#.#...#
#.........#
#.#.#.#.#.#
...........
#...#.#.#.#
#.........#
#.#.#.....#
#.........#
#####d#####
key : 2

3
0
#####.#####
#......#..#
#.........#
#......#..#
#.........#
#....#....#
#.#...#...#
#.....##..#
#.........#
#.........#
###########

3
6
###########
#.......?e#
#......##.#
#...##.e#.#
#.....##..#
..........#
#.........#
#.........#
#.........#
#........e#
###########
enemies 3
sign Seek the matching key before you proceed.

4
5
#####l#####
#.........#
#.........#
#...##.##.#
#...e#....#
.....##...#
#...#..##.#
#....#....#
#.........#
#.........#
#####.#####
locked : 0
boss
enemies 1

5
5
#####.#####
#.........#
#.........#
#.........#
#.........#
#.........#
#.........#
#.........#
#.........#
#X........#
###########

0
0
###########
#.........#
#.........#
#.........#
#.........#
#.........#
#.........#
#...##....#
#...#.#...#
#.........#
#####.#####

3
2
#####.#####
#.........#
#.........#
#.........#
#.........#
#..........
#.........#
#.........#
#.........#
#.........#
###########

2
2
#####.#####
#k........#
#..#...#..#
#.#.....#.#
#.........#
...........
#.........#
#.##......#
#..#...#..#
#..#......#
#####.#####
key : 1

1
0
#####.#####
#.........#
#.........#
#.........#
#.#.......#
#.?#.@....d
#.#.......#
#.........#
#.........#
#.........#
#####.#####
sign Beware what lurks ahead.

