3
0
#####D#####
#.........#
#..#...#..#
#k#.....#.#
#.........#
#.........D
#.........#
#.#.......#
#..#......#
#.........#
#####D#####
key : 0

4
2
#####D#####
#.........#
##.....#..#
#.........#
#..#...#..#
d.........D
#....#.#..#
#.........#
##.#...#.##
#.........#
#####D#####

0
3
###########
#X........#
#.........#
#..##.....#
#.........#
#..##.....#
#.........#
#.........#
#.........#
#.........#
#####D#####

5
1
#####D#####
#.........#
#.........#
#.........#
#...##....#
D..#......d
#..##.....#
#.........#
#.........#
#.........#
#####D#####

1
3
#####D#####
#......#..#
#...#.###.#
#....####.#
#...#.#...#
#...#e.#..#
#.........#
#.........#
#.........#
#.........#
#####d#####
boss
enemies 1

6
1
#####D#####
#k........#
##..#..#..#
#.........#
#.........#
D.........#
#.........#
#.........#
##..#..#..#
#.........#
#####d#####
key : 2

2
3
#####d#####
#..#.....##
#.........#
#.........#
#...#..#..#
#.........#
#.........#
#.....#..##
#.........#
#.........#
#####D#####

2
0
#####l#####
#.........#
#.#.#.#.#.#
#.........#
#.#.#.#.#.#
#.........#
#.#.#.#.#.#
#.........#
#.#.#.#.#.#
#.........#
#####D#####

3
2
###########
#.........#
#..#......#
#.#.......#
#.........#
l.........l
#.........#
#.#.......#
#..#......#
#.........#
#####D#####
locked : 1

3
1
###########
#e...e....#
#.........#
#.........#
#.........#
D.........l
#.........#
#.........#
#.........#
#?........#
#####D#####
enemies 2
sign This door will not yield without a key.

4
1
#####D#####
#.........#
#......#..#
#p...##...#
#....#....#
D.........d
#.........#
#.........#
#.........#
#......p..#
#####D#####

5
2
#####D#####
#.........#
#.........#
#.........#
#...#.....#
d.........#
#.........#
##..#...#.#
#......#..#
#.........#
###########

1
0
###########
#.........#
#......#..#
#.......#.#
#.........#
#.........#
#.........#
#.........#
#.........#
#.........#
#####l#####
locked : 0

4
0
#####D#####
#.........#
#..#......#
#..#.#....#
#.........#
#....@....D
#.........#
#.........#
#.........#
#.........#
#####D#####

5
0
#####D#####
#k........#
##..#.....#
#.........#
#.........#
#....#....D
#.........#
#.........#
##..#.....#
#.........#
#####D#####
key : 1

3
3
#####D#####
#.........#
#.........#
#.........#
#.........#
l.........#
#.........#
#.........#
#.........#
#.........#
#####D#####
locked : 2

4
3
#####D#####
#.........#
#......#..#
#.......#.#
#.........#
D.........#
#.........#
#...#.....#
#.........#
#........k#
###########
key : 4

7
1
#####d#####
#.........#
#.........#
#.........#
#..#......#
#.........#
#.........#
#.......#.#
#......#..#
#.........#
###########

6
0
#####D#####
#........p#
#......#..#
#.....#...#
#......#..#
#.........D
#.........#
#.........#
#?........#
#e........#
###########
enemies 1
sign What you seek is close.

