6
2
#####d#####
#.........#
#.........#
#.........#
#.........#
D.........#
#.........#
#.........#
#.........#
#.........#
###########

1
1
#####D#####
#.........#
#......#..#
#.......#.#
#.........#
#.........D
#.........#
#.........#
#.........#
#.........#
#####d#####

5
2
#####D#####
#.........#
#.........#
#.........#
#.........#
D.........D
#.........#
#.........#
#.........#
#.........#
#####d#####

4
2
#####D#####
#.........#
##.#...#..#
#.........#
#.#.#...#.#
l.........d
#......#..#
#.........#
#.#.#...#.#
#.........#
#####D#####
locked : 0

5
0
###########
#.........#
#.....#...#
#....##...#
#......#..#
#....@....D
#.........#
#.........#
#.........#
#.........#
#####D#####

5
3
#####D#####
#.........#
#.........#
#.........#
#...#..##.#
D....#....#
#...###.#.#
#....##...#
#......#..#
#........k#
###########
key : 2

0
1
###########
#e.......?#
#.........#
#.....#.###
#....#.##.#
#....#....#
#....#..#.#
#.........#
#.........#
#.........#
#####D#####
enemies 1
door 0 : 0 1
sign Beware what lurks ahead.

4
1
#####l#####
#.........#
#......#..#
#.......#.#
#.........#
#.........l
#.........#
#k#.......#
#..#......#
#.........#
#####D#####
key : 1

6
0
#####D#####
#.........#
#..#.....##
#.........#
#..#...#..#
#.........D
#..#.#.#..#
#.........#
##.#......#
#k........#
###########
key : 0

3
3
###########
#.#....e#e#
#.........#
#.........#
#.#.....#s#
D.........#
#.........#
#.#..#..#.#
#.........#
#.........#
#####D#####
enemies 2
switch 0 : 0 1

7
1
#####D#####
#.........#
#.........#
#.........#
#...##....#
#..#.#....#
#..#...##.#
#.......#.#
#......##.#
#.........#
###########

4
3
#####D#####
#.........#
#.#.....#.#
#.........#
#.........#
d....#....#
#.........#
#.........#
#.#.....#.#
#.........#
#####D#####

3
1
#####D#####
#.........#
#.#.#...#.#
#.........#
#..#.#.#..#
#.........d
#...#.#.#.#
#.........#
#..#...#.##
#.........#
#####l#####
locked : 1

2
1
#####d#####
#.........#
#.........#
#.........#
#.........#
#k........l
#.........#
#.........#
#.........#
#.........#
#####D#####
key : 3

3
2
#####D#####
#.........#
#..#...#..#
#.#.......#
#.........#
d.....#...D
#.........#
#..#......#
#.........#
#.........#
#####D#####

2
2
#####D#####
#.........#
#.........#
#.........#
#.........#
l....e....#
#.###.....#
#...##..p.#
#..##.....#
#..#....p.#
#####D#####
locked : 2
boss
enemies 1

1
2
###########
##......pX#
####......#
#####.##..#
#.#.#p....#
D....#.#..#
#...###...#
#..#......#
#.........#
#.........#
#####D#####

5
1
#####D#####
#.........#
#.....#.#.#
#.....###.#
#....#..#.#
D.....#...D
#....##.#.#
#.........#
#.........#
#.........#
#####D#####

6
1
#####D#####
#.........#
#.........#
#.....#..##
#.........#
D.........D
#..#..#...#
#.........#
#.........#
#.........#
#####D#####

