5
2
#####.#####
#.........#
#.........#
#.........#
#.........#
d.........#
#.........#
#.........#
#......#..#
#.........#
#####.#####

3
2
#####.#####
#.........#
#......#..#
#.......#.#
#.........#
.....#....#
#......#..#
#.........#
#.........#
#.........#
#####.#####

1
0
#####.#####
#.........#
#.........#
#.........#
#.........#
#....#.....
#....##...#
#....###..#
#.....##..#
#.........#
#####.#####

4
1
#####.#####
#e.......e#
#.........#
#.........#
#.........#
...........
#.........#
#.........#
#.........#
#e.......?#
#####.#####
enemies 3
sign The brave are rewarded.

7
1
#####.#####
#.......#.#
#.....#...#
#....####.#
#.....#...#
#..........
#.........#
#.........#
#.........#
#X........#
###########

6
2
#####.#####
#.........#
#.........#
#.........#
#.........#
.........k#
#.........#
#.........#
#.........#
#.........#
#####.#####
key : 4

4
2
#####.#####
#.........#
#..#...#..#
#.........#
#..#......#
..........#
#.........#
#.........#
##.#.....##
#.........#
#####.#####

4
0
#####.#####
#.........#
#.........#
#.........#
#.........#
#..........
#..###....#
#...#.....#
#..##.....#
#.........#
###########

2
0
#####.#####
#.........#
#.##...#..#
#.#.....#.#
#.........#
#..........
#.........#
#.........#
#.........#
#.........#
#####d#####

3
0
#####d#####
#.........#
#.........#
#.........#
#..###....#
#..#......d
#...###...#
#.........#
#...#.#...#
#.........#
#####.#####

2
2
###########
#?e..e..s.#
#.#.....#.#
#.........#
#.........#
...#..#...d
#.........#
#.........#
#.#.....#.#
#.........#
#####.#####
enemies 2
switch 0 : 0 1
sign The brave are rewarded.

5
1
#####.#####
#.........#
#.........#
#.........#
#.........#
#k........d
#.........#
#.........#
#.........#
#.........#
#####l#####
key : 3

6
1
#####l#####
#.........#
#..##.....#
#...##..#.#
#.#.#.#.#.#
#...#e##...
#...#...#.#
#......#..#
#.........#
#.........#
#####.#####
locked : 0
boss
enemies 1

2
3
###########
#.........#
##..#..#..#
#.........#
#.........#
d...#..#..#
#.........#
#.........#
##.....#..#
#.........#
###########

1
1
###########
#........k#
#.........#
#.........#
#.........#
..........#
#.........#
#.......#.#
#......#..#
#.........#
#####.#####
key : 0

2
1
#####.#####
#k........#
#.........#
#.........#
#.........#
...........
#.........#
#.........#
#.........#
#.........#
#####.#####
key : 1

3
1
#####.#####
#.........#
#..#...#..#
#.......#.#
#.........#
d..........
#.........#
#.......#.#
#.........#
#.........#
#####.#####

0
0
###########
#?........#
#.........#
#.........#
#..#......#
#..#.@....#
#..##.....#
#.........#
#.###.....#
#.........#
#####.#####
sign The dungeon remembers all who enter.

7
2
#####.#####
#.#.......#
#.........#
#.#.#.#.#.#
#.........#
....#.#...#
#.........#
#.#.#.....#
#........?#
#.#....e#e#
###########
enemies 2
door 0 : 0 1
sign Those who search shall find.

