6
1
#####.#####
#.#.....#.#
#.........#
#..#.#.#.##
#.........#
....#.....#
#.........#
#..#.#.#.##
#.........#
#.#.....#.#
###########

4
2
#####.#####
#.........#
#.........#
#.........#
#.........#
l.........l
#.........#
#.........#
#.........#
#.........#
#####.#####
locked : 1

3
1
#####.#####
#k........#
#.........#
#.........#
#.........#
....#......
#.........#
#......#..#
#.........#
#.........#
#####.#####
key : 2

1
3
###########
#........e#
##..#.....#
#.........#
#.........#
....#.....#
#.........#
#.........#
##..#.....#
#.........#
#####.#####
enemies 1

6
0
#####.#####
#.........#
#.........#
#.........#
#.........#
#..........
#.........#
#.......#.#
#......#..#
#.........#
###########

1
2
#####.#####
#.........#
#...#.....#
#..##..#..#
#...e.#...#
#....#.....
#...#.##..#
#...#..##.#
#..#......#
#.........#
#####d#####
boss
enemies 1

2
1
###########
#.........#
#.........#
#.........#
#.........#
....#.#...d
#...k####.#
#...#.###.#
#.......#.#
#......#..#
#####.#####
key : 3

5
0
#####.#####
#.........#
#.........#
#.........#
#.....#...#
#....@....d
#...#.##..#
#..#.#.#..#
#.........#
#.........#
#####.#####

2
0
###########
#.........#
#.........#
#.........#
#.........#
#..........
#.........#
#.........#
#.........#
#.........#
#####.#####

2
3
#####.#####
#.........#
#......#..#
#.......#.#
#.........#
d.........#
#.........#
#.........#
#.........#
#.........#
###########

4
0
#####.#####
#k##......#
#..#..#...#
#.##.##...#
#.##.#....#
#.....##..l
#....##...#
#.......#.#
#........##
#.........#
#####.#####
key : 0

2
2
#####d#####
#.........#
#.........#
#.........#
#....#.#..#
d......#..d
#..#..#...#
#...#.##..#
#.........#
#.........#
#####.#####

4
1
#####.#####
#.........#
#.....#...#
#..#..#...#
#.........#
l.........l
#.........#
#.........#
#.........#
#.........#
#####.#####
locked : 0

5
1
#####.#####
#.......#.#
#.....###.#
#.....##..#
#....####.#
d....##....
#.........#
#.........#
#.........#
#.........#
#####.#####

3
0
#####.#####
##.....#..#
#.........#
#.........#
#.........#
#..........
#.........#
#k#.......#
#..#......#
#.........#
#####.#####
key : 1

4
3
###########
#......#..#
#..##.#.#.#
#.###...#.#
#...##.##.#
l.....#...#
#...#.#...#
#.........#
#.........#
#.........#
###########
locked : 2

5
2
#####.#####
#.........#
#.#.#.#...#
#.........#
#...#.#.#.#
..........#
#.#.#.#.#.#
#.........#
#...#.#.#.#
#.........#
###########

3
2
#####.#####
#.........#
#.........#
#.........#
#.........#
..........#
#.........#
#.......#.#
#......#..#
#.........#
#####.#####

0
2
###########
#X........#
#.........#
#.........#
#.........#
#.........#
#.........#
#.........#
#.........#
#.........#
#####.#####

