1
3
#####.#####
#.......#.#
#.......#.#
#.....##..#
#.........#
#.........d
#.........#
#.........#
#.........#
#.........#
#####d#####

1
5
###########
#........k#
#.........#
#...#.....#
#...##....#
....##....#
#.........#
#.........#
#.........#
#.........#
#####.#####
key : 4

4
0
#####.#####
#.........#
###.#.##.##
##?.#.###.#
#e#.#.....#
#..#####...
#....#....#
#.........#
#e........#
#e........#
###########
enemies 3
sign Something glints behind that door…

4
2
#####.#####
#..#...#..#
#.........#
##...#.#..#
#.........#
.....#.#...
#.........#
#..#.#...##
#........k#
##.......##
###########
key : 2

2
5
#####.#####
#.........#
#.........#
#...#.....#
#..#.###..#
...#...#..#
#....#....#
#..#.#....#
#.........#
#........e#
###########
enemies 1
door 0 : 0

3
1
###########
#.........#
#.........#
#.........#
#.........#
d..........
#.........#
#.#.......#
#..#......#
#.........#
#####.#####

2
0
###########
#.#.....#.#
#.........#
#.#...#.#.#
#.........#
#...#.....#
#.........#
#.#.#.#.#.#
#.........#
#.#.....#.#
#####.#####

4
3
#####.#####
#.........#
#.........#
#.........#
#.........#
...........
#.........#
#.........#
#.........#
#....e....#
###########
enemies 1

0
3
###########
#s.....##e#
#.......#.#
#.....##..#
#..#.#..#.#
#...#.....#
#.#.#.#...#
###.......#
#...#.....#
#.........#
#####.#####
enemies 1
switch 0 : 0

3
4
#####.#####
#.......#.#
#.......#.#
#.........#
#.........#
..........#
#.........#
#.........#
#.........#
#.........#
#####.#####

3
3
#####.#####
#k........#
#.#.#.#.#.#
#.........#
#..#...#..#
...........
#.#.#...#.#
#.........#
#..#...#..#
#.........#
#####.#####
key : 3

4
1
#####.#####
#.........#
#.........#
##..#..#..#
#.........#
...........
#.#.......#
#.........#
#.........#
##....k#..#
###########
key : 1

4
4
#####.#####
#.........#
#.........#
#.........#
#.........#
....###...#
#...###...#
#....#..#.#
#......#..#
#......##X#
###########

3
2
#####l#####
#.#.....#.#
#.........#
#.........#
#.#..#..#.#
...........
#.........#
#.#.....#.#
#.........#
#.........#
#####.#####

3
0
#####.#####
#.........#
#.........#
#...##....#
#...@?#...#
#..#.#....d
#.....##..#
#.........#
#.........#
#.........#
#####.#####
sign Many have walked this path.

2
2
###########
#.........#
#.........#
#.........#
#.........#
#..........
#.........#
#.........#
#.........#
#.........#
#####l#####
locked : 1

2
3
#####d#####
#.#.......#
#.........#
#.#.#...#.#
#.........#
....#.#....
#.........#
#.#.#.....#
#.........#
#.#.......#
#####.#####

2
4
#####d#####
#.........#
#..#..#...#
#..##.#...#
#.##e#....#
.....##....
#.#.......#
#.........#
#.........#
#.........#
#####.#####
boss
enemies 1

1
4
###########
##.....#..#
#.........#
#.#.#...#.#
#.........#
d......#...
#.........#
#.#.#.#...#
#.........#
##.....#.##
#####d#####

