3
2
#####.#####
#..#.....##
#.........#
#.........#
#..#..#...#
d..........
#.........#
#.....#...#
#.........#
#.........#
###########

5
4
#####.#####
#.........#
#.........#
#.........#
#.........#
#.........#
#.........#
#.........#
#......#..#
#e.......e#
###########
enemies 2
door 0 : 0 1

1
1
#####.#####
##.......##
#e........#
##...#.#.##
#.........#
...#.#.#...
#.........#
##.#.#.#.##
#s........#
##.#...#.##
#####.#####
enemies 1
switch 0 : 0 1

2
2
#####.#####
#k........#
#.........#
#.........#
#.........#
...........
#.........#
#.........#
#.........#
#.........#
#####.#####
key : 1

2
3
###########
#.......#.#
#..#......#
#.#.......#
#.........#
...........
#....#....#
#.#..#....#
#..#......#
#.........#
#####d#####

4
1
#####.#####
#.........#
#.........#
#.........#
#.........#
#.........#
#.........#
#.#.....#.#
#..#...#..#
#.........#
###########

2
0
#####.#####
#.........#
#.....###.#
#.....#...#
#.........#
#?...@.....
#.........#
#.........#
#.........#
#.........#
#####.#####
sign A useful tool lies just ahead.

1
2
#####d#####
#.........#
#.....#...#
#...###...#
#.........#
....###...#
#...#...#k#
#.........#
#.........#
#.........#
#####.#####
key : 3

3
3
#####d#####
#.........#
#..#......#
#.#.......#
#.........#
..........l
#.........#
#.......#.#
#......#..#
#.........#
###########

3
4
#####.#####
##.#......#
#.........#
##.#...#.##
#.........#
l....#....#
#.........#
#..#.....##
#.........#
#..#...#..#
#####d#####
locked : 2

0
1
###########
#k........#
#...#.....#
#.........#
#.........#
#..........
#.........#
#.........#
#.........#
#.........#
#####.#####
key : 2

2
4
###########
#.......ee#
#.........#
#.........#
#.........#
..........#
#.........#
#.........#
#.........#
#.........#
#####.#####
enemies 2

0
2
###########
#.........#
####......#
##..#.....#
#.#.......#
..........#
#.....#...#
#....#....#
#.........#
#.........#
#####d#####

3
1
#####.#####
#.........#
##.....#.##
#.........#
#.....#.#.#
..........d
#..#......#
#.........#
#.#.#.#.#.#
#.........#
#####.#####

4
5
###########
##.......X#
#...#...#.#
#...##.##.#
#...#####.#
....#.....#
#...###...#
#.........#
#.........#
#.........#
###########

1
0
###########
#k......#.#
#.........#
#.......#.#
#.........#
#...#.#....
#.........#
#.#.#.#.#.#
#.........#
#.#.....#.#
#####.#####
key : 0

3
0
#####.#####
#.........#
#..#..#...#
#.###.#...#
#..###....#
#..##.#....
#.##..#...#
#.........#
#.........#
#.........#
###########

4
4
#####d#####
#.........#
#.........#
###.......#
#.##......#
#....e.....
#.........#
#.........#
#.........#
#.........#
#####.#####
boss
enemies 1

2
1
#####.#####
#.........#
#.........#
#.........#
#.........#
....##.....
#...##....#
#.###.....#
#.#...#...#
#..#......#
#####.#####

