2
3
###########
#.........#
#.....#.#.#
#...####..#
#....k##..#
D...###...D
#....###..#
#.........#
#......#.##
#.........#
#####D#####
key : 5

3
3
#####D#####
#.........#
#.........#
#.........#
#.........#
l.........d
#.........#
#.........#
#.........#
#.........#
#####l#####
locked : 1

4
3
#####l#####
#.#.....#.#
#.........#
#.........#
#.#.....#.#
D.........D
#.........#
#....#..#.#
#.........#
#.........#
#####D#####
locked : 5

4
1
#####D#####
#k........#
#......#..#
#.......#.#
#.........#
D.........D
#.........#
#.#.......#
#..#......#
#.........#
#####l#####
key : 0

2
4
###########
#.#?..e#ee#
#.##..##..#
#.###..#..#
#..#.#....#
D.........#
#.........#
#.........#
#.........#
#.........#
#####D#####
enemies 3
sign Something glints behind that door…

3
2
#####D#####
#.........#
#......#..#
#.......#.#
#.........#
D.........l
#.........#
#.#.......#
#..#......#
#.........#
#####D#####

3
1
#####D#####
#.........#
#.........#
#.........#
#.........#
#..##.#...D
#.#k#.#...#
#...#.....#
#..##..#..#
#.##...#..#
#####D#####
key : 1

2
2
#####D#####
#.........#
#..#......#
#.#.......#
#.........#
D.........D
#.........#
#.........#
#.........#
#.........#
#####D#####

0
1
###########
#?.......e#
#.....##.##
#..####..##
#...##.##.#
#....#.#..#
#.........#
#.........#
#.........#
#.........#
#####D#####
enemies 1
door 0 : 0 1
sign Beware what lurks ahead.

4
2
#####D#####
#.........#
#..#......#
#.#.......#
#.........#
D.........D
#.........#
#.....#.#.#
#......#..#
#......?#.#
###########
sign Seek the matching key before you proceed.

1
2
###########
#........k#
#.........#
#..#..#..##
#.........#
D.........#
#..#..#...#
#.........#
#.........#
#.........#
#####D#####
key : 4

5
1
#####l#####
#.........#
#..#......#
#.#.......#
#.........#
#.........#
#.........#
#.#.....#.#
#..#...#..#
#.........#
###########
locked : 0

4
0
###########
#.........#
#.........#
#.........#
#..#@.....#
#...#p....D
#...#.....#
#..#......#
#...#.....#
#.........#
###########

2
1
#####d#####
#.........#
#.........#
#.........#
#?........#
#s...#....D
#e##.#....#
####...#..#
###.......#
#e........#
#####D#####
enemies 2
switch 0 : 0 1
sign A useful tool lies just ahead.

3
4
#####D#####
#.........#
#.#.#...#.#
#.........#
#..#.#.#..#
d.........#
#.#.#.#.#.#
#.........#
#..#...#..#
#.........#
#####l#####

4
4
#####l#####
#.........#
#.........#
#.........#
#...#.....#
D..##e##..#
#..###.#..#
#..##.....#
#..##..#..#
#.........#
#####D#####
locked : 4
boss
enemies 1

5
3
#####D#####
#.........#
#.#.#.#.#.#
#.........#
#..#...#..#
#.........D
#e#.#.#.#.#
#.........#
#?.......##
#e........#
###########
enemies 2
sign Seek the matching key before you proceed.

5
4
#####D#####
#.........#
#.........#
##........#
#.........#
D.........#
#.........#
#.........#
#.........#
#........X#
###########

1
1
#####D#####
##.....#..#
#.........#
#.........#
#...#..#..#
#.........D
#.........#
##.....#..#
#.........#
#.........#
#####d#####

