0
0
###########
#.........#
##.#.....##
#.........#
#.#.#.#.#.#
#.........#
#..#.#.#..#
#.........#
#.#.#.#.#.#
#.........#
#####d#####

2
4
###########
#.........#
#.........#
##.####...#
#.#.......#
d...##....l
#.##......#
#....##...#
#.........#
#.........#
###########

3
3
#####l#####
#.........#
#.........#
#.........#
#.........#
D.........#
#.........#
#.........#
#.........#
#..p....p.#
#####D#####

1
3
###########
#..#.....##
#.........#
#.........#
#...#..#..#
#.........#
#.........#
#.....#...#
#.........#
#.........#
#####d#####

4
4
###########
#.......?e#
###e#.....#
#..#......#
#.##.#....#
D...#.....#
#....##...#
#.........#
#.........#
#........e#
###########
enemies 3
sign Those who search shall find.

5
2
#####D#####
#.........#
#..#......#
#.#.......#
#.........#
#.........#
#.........#
#.........#
#.........#
#k........#
###########
key : 4

1
1
###########
####......#
#...#.#...#
#.####....#
#.#.###...#
l....#....#
#.........#
#.........#
#.........#
#.........#
#####D#####
locked : 0

3
2
#####D#####
#.#.....#.#
#.........#
#.#.#...#.#
#.........#
D...#.#...D
#.........#
#...#.#.#.#
#.........#
#.#.....#.#
#####D#####

2
5
###########
#.........#
#......p..#
#.........#
#.........#
l....e#...#
#.##..p.#.#
#......##.#
#.##..##..#
#..#......#
#####D#####
locked : 4
boss
enemies 1

3
5
#####D#####
#.........#
#.........#
#....##.###
#.....#...#
#...####..#
#....#..#.#
#.......#.#
#.........#
#X........#
###########

2
2
###########
#.........#
#.........#
#.p.......#
#.........#
D..p......D
#.........#
#.........#
#.........#
#.........#
#####D#####

2
1
#####D#####
###.......#
#.........#
#.#.......#
#.........#
D.........D
#.........#
#.........#
#.........#
#.........#
#####D#####

4
1
#####d#####
#..#......#
#.#...#...#
#....#....#
#.#...#...#
#..#......D
#.##......#
#.##..p...#
#......p..#
#.........#
###########

1
0
#####d#####
#.........#
#...#.#...#
#.........#
#k#...#...#
#.........l
#...#.#.#.#
#.........#
#.#.#.#.#.#
#.........#
#####D#####
key : 0

4
2
#####D#####
#k#.......#
#.........#
#.........#
#....#....#
D.........D
#.........#
#....#..#.#
#.........#
#.........#
#####D#####
key : 2

2
3
#####d#####
#.........#
#.....#.###
#....######
#....####.#
D....###..d
#....#.##.#
#.........#
#.........#
#.........#
#####l#####
locked : 2

3
1
#####D#####
#.........#
#......#..#
#.......#.#
#.........#
#.........D
#.........#
#.........#
#.........#
#.........#
#####d#####

4
3
#####D#####
#.........#
#......#..#
#.......#.#
#.........#
D.........D
#.........#
#.......#.#
#......#..#
#......k..#
###########
key : 3

2
0
#####D#####
#.........#
#.........#
#.........#
#.........#
#....@....D
#.#.#.....#
#.###.....#
#...#.....#
#?........#
###########
sign The brave are rewarded.

