5
1
#####.#####
#.......###
#.....#.###
#......####
#.....##..#
...........
#.........#
#.........#
#.........#
#.........#
#####.#####

3
1
#####.#####
#.........#
#..#......#
###.......#
#.........#
...........
#.........#
#.........#
##........#
##........#
#####l#####
locked : 0

5
0
#####.#####
#.........#
#.........#
#.........#
#.........#
#....@.....
#.........#
#.........#
#.........#
#.........#
#####d#####

5
2
#####.#####
#.........#
##.#.....##
#.........#
#.#.#...#.#
..........#
#..#.#.#..#
#.........#
#.#.#...#.#
#........k#
###########
key : 2

6
0
#####d#####
#.......#.#
#.........#
#.#.#.#.#.#
#.........#
#...#.#....
#.........#
#.#.#.#.#.#
#.........#
#.#.....#.#
###########

2
0
###########
#.........#
#..#...#..#
#.#.....#.#
#.........#
#..........
#.........#
#.......#.#
#......#..#
#.........#
#####.#####

4
3
###########
#.#......k#
#.###.....#
#...##....#
#.####....#
...#.#....#
#.........#
#.........#
#.........#
#.........#
###########
key : 3

7
1
#####.#####
#.........#
##.....#.##
#.........#
#.....#.#.#
#.........#
#..#.#.#..#
#.........#
#...#...#.#
#e......?e#
###########
enemies 2
sign Something glints behind that door…

4
1
#####l#####
#e........#
#.........#
#.........#
#.........#
..........d
#.........#
#.........#
#.........#
#.........#
#####.#####
enemies 1

3
0
#####.#####
#.........#
#.........#
#..#..#...#
#.........#
#..........
#...#..#..#
#.........#
#.........#
#........##
#####.#####

4
0
#####.#####
#.........#
#..#..#..##
#.........#
#.........#
#...#..#...
#.........#
#.........#
#.....#..##
#.........#
#####.#####

2
1
#####.#####
#k........#
#.........#
#.........#
#.........#
...........
#.........#
#.......#.#
#......#..#
#.........#
#####.#####
key : 1

2
2
#####.#####
#e.......?#
##.#...#.##
#.........#
#..#.#....#
..........#
#..#...#..#
#.........#
##.#...#.##
#e........#
#####.#####
enemies 2
sign This door will not yield without a key.

0
1
###########
#.........#
#......#..#
#.......#.#
#.........#
#..........
#.........#
#.........#
#.........#
#.........#
#####d#####

1
2
#####.#####
#.........#
#.........#
#.........#
#.........#
d....e##..#
#......#..#
#......##.#
#.........#
#.........#
#####.#####
boss
enemies 1

4
2
#####l#####
#.........#
#.........#
#.........#
#.........#
d..........
#.........#
#.........#
#.........#
#.........#
#####.#####

0
2
###########
#........X#
##.##.....#
#.#..#....#
#.#.#.....#
..........#
#...#.....#
#.........#
#.........#
#.........#
#####.#####

6
1
#####.#####
#.........#
#.........#
#....#....#
#..#......#
.........k#
#.........#
#.........#
#.........#
#.........#
#####.#####
key : 0

1
1
#####d#####
#.........#
#..#..#...#
#.........#
#.........#
#.........d
#.........#
#.........#
#........##
#.........#
#####.#####

3
2
#####.#####
#.........#
#.........#
#.........#
#....#....#
....###...#
#.#..##.#.#
#.#...###.#
#.###.###.#
#......####
#####l#####
locked : 2

