3
3
#####.#####
#.........#
#......##.#
#.......#.#
#...#.....#
d.....#....
#.........#
#.........#
#.........#
#.........#
###########

3
0
#####.#####
#.........#
#...#.#...#
#...#.#...#
#.....##..#
#..##@#....
#..###.#..#
#.........#
#.........#
#.........#
#####l#####

4
1
#####.#####
#.........#
#.........#
#.......#.#
#.........#
d..........
#..#..#...#
#.........#
#.........#
#.......#.#
#####.#####

2
4
#####.#####
#.........#
#.........#
#.........#
#.........#
d....e....#
#.........#
#.#.......#
#.........#
#.........#
#####.#####
boss
enemies 1

5
0
#####l#####
#.#.......#
#.........#
#.........#
#.........#
#..........
#.........#
#.#.....#.#
#..#...#..#
#.........#
###########
locked : 1

2
2
###########
#.........#
#.##......#
##.#......#
#.........#
...........
#.........#
#.........#
#.........#
#.........#
#####.#####

4
2
#####.#####
##........#
#.........#
#.........#
#.#.....#.#
..........#
#.........#
##..#..#..#
#.........#
#........k#
###########
key : 2

0
1
###########
#e.......e#
#?........#
#.........#
#.........#
#....###..#
#..#.#.#..#
#..##.....#
#...#.#...#
#..#......#
#####.#####
enemies 2
door 0 : 0 1
sign Many have walked this path.

2
0
###########
#.........#
###.......#
#.##......#
#..#......#
#..##......
#..##.....#
#.........#
#.........#
#.........#
#####.#####

1
1
#####.#####
#..#......#
#......#..#
#.......#.#
#.........#
#.........#
#.........#
#.#.......#
#.........#
#.........#
#####d#####

3
1
#####.#####
#k........#
#......#..#
#.......#.#
#.........#
...........
#.........#
#.........#
#.........#
#.........#
#####.#####
key : 0

4
0
#####l#####
#.........#
#........##
#.........#
#.........#
#.........d
#.........#
#.........#
#.........#
#.........#
#####l#####
locked : 0

1
3
###########
#k........#
#.........#
#.........#
#.........#
#..........
#.........#
#.......#.#
#......#..#
#.........#
#####.#####
key : 8

3
4
#####.#####
####...##.#
###.#.##..#
###....##.#
#..#.#..#.#
....#.....#
#.........#
#.........#
#.........#
#........e#
###########
enemies 1

1
4
###########
#........X#
#.........#
#...#.#...#
#....##...#
..........#
#..#...#..#
#..#.##...#
##........#
#.........#
#####.#####

3
2
#####.#####
#.........#
#.........#
#....#....#
#...#.#...#
......#...d
#.........#
#.........#
#.........#
#.........#
#####.#####

2
3
#####.#####
#.........#
#.........#
#.......#.#
#.........#
..........d
#.........#
#.#.....#.#
#..#...#..#
#.........#
#####.#####

2
1
#####d#####
#k........#
#..#...#..#
#.#.....#.#
#.........#
...........
#.........#
#.......#.#
#......#..#
#.........#
#####.#####
key : 1

5
1
#####.#####
#.........#
#.....#..##
#......#.##
#.......#?#
...#...#s.#
#.##.#..#.#
#.###.....#
#.........#
#........e#
###########
enemies 1
switch 0 : 0 1
sign This door will not yield without a key.

