1
2
#####D#####
#.........#
#.........#
#.........#
#.........#
D....e....#
#.........#
#.........#
#.........#
#.........#
#####l#####
locked : 3
boss
enemies 1

5
1
#####D#####
#.........#
#.........#
#.........#
#.........#
#.........#
#.........#
#.........#
#.........#
#e.......?#
###########
enemies 1
door 0 : 0
sign The dungeon remembers all who enter.

0
1
###########
#.........#
#.....#...#
#.........#
#......#..#
D.........D
#.#.......#
#.......#.#
#......#..#
#.........#
#####D#####

3
1
#####d#####
#.........#
#......#..#
#.......#.#
#.........#
d.........D
#.........#
#.#.......#
#..#......#
#.........#
#####D#####

4
1
#####D#####
#.........#
#.........#
#.........#
#.........#
#.........D
#.........#
#.........#
#.........#
#.........#
#####D#####

2
2
#####l#####
#.........#
#.......#.#
#.....##..#
#.........#
D.........D
#.#.......#
####......#
###.......#
#k........#
#####D#####
key : 1

0
0
###########
#?#.......#
#..#......#
#...#.....#
#.........#
#..##@....D
#.........#
#.........#
#.........#
#.........#
#####D#####
sign The ceiling is higher than it looks.

3
0
#####d#####
#.........#
###.......#
#.........#
#.........#
#.........d
#.........#
#.........#
#.........#
#.........#
###########

1
0
#####D#####
#.........#
#..#...#..#
#.#.......#
#.........#
#.........D
#.........#
#.........#
#......#..#
#.........#
#####D#####

1
1
#####D#####
#.........#
#.#.#.....#
#.k##.....#
#.#.......#
D.........D
#.#.#.....#
#..##.....#
#..#......#
#.........#
#####D#####
key : 0

3
4
###########
###.......#
#...#.....#
#.#.#.....#
#.#.......#
l..##.....#
#.#.......#
#..##.....#
#.........#
#.........#
###########
locked : 1

4
2
#####D#####
#.........#
#.#.#.#...#
#.........#
#.#.#...#.#
D.........D
#.#.....#.#
#.........#
#.#...#.#.#
#.....k...#
###########
key : 2

2
1
#####D#####
##.#...#..#
#.........#
#.#.#.#...#
#.........#
D..#......D
#.........#
#.#.#.#.#.#
#.........#
##.#...#.##
#####d#####

3
3
#####D#####
#.........#
#.........#
#.........#
#.p...###.#
d.....##..l
#....####.#
#....##.###
#.....#.#.#
#.........#
#####D#####

2
0
#####D#####
#.........#
#......#..#
#......##.#
#.........#
#.........D
#.....#...#
#.......#.#
#......#..#
#.........#
#####d#####

3
2
#####D#####
#s.......?#
#.........#
#.#.....#.#
#.........#
D.........d
#..#..#...#
#.........#
#.........#
#e#.....#e#
#####D#####
enemies 2
switch 0 : 0
sign A useful tool lies just ahead.

2
3
###########
#.........#
#......#..#
#.......#.#
#.........#
D.........#
#.........#
#.........#
#.........#
#.........#
#####D#####

0
2
###########
#.....X#..#
#.....#...#
#.....#.#.#
#.........#
D....#....#
#....#....#
#.....##..#
#.........#
#.........#
#####D#####

4
3
#####D#####
#.........#
#.........#
#.........#
#...#.....#
D...##....#
#..###....#
#....#....#
#...#.....#
#........k#
###########
key : 3

