3
0
#####d#####
#.........#
#..##.....#
#.#.......#
#.###.....#
#...#.....d
#.........#
#.........#
#.........#
#.........#
###########

2
3
###########
#.#.....#.#
#.........#
#..#.#.#.##
#.........#
......#...#
#.........#
#..#.#.#.##
#.........#
#.#.....#.#
#####.#####

2
2
#####l#####
#k........#
#.........#
#.........#
#.........#
...........
#.........#
#.......#.#
#......#..#
#.........#
#####.#####
key : 1

4
3
#####.#####
#.........#
#.#.#...#.#
#.........#
#.#...#.#.#
..........#
#.#.#.#.#.#
#.........#
#.#...#...#
#........k#
###########
key : 3

1
2
#####.#####
#.........#
#.........#
#..###....#
#...##....#
....##....#
#...e#....#
#.....##..#
#.....##..#
#..#......#
#####l#####
locked : 3
boss
enemies 1

3
3
#####.#####
####......#
#.##......#
#..##.....#
#...#.....#
d..#......l
#..#......#
#..#......#
#.........#
#.........#
#####.#####

3
4
###########
#.........#
#.........#
#.........#
#.........#
l..#..#...#
#.#.#.#...#
#.........#
#.#.#.#...#
#.#.......#
###########
locked : 1

0
2
###########
#........X#
#.........#
#...#.....#
#.........#
..........#
#....#....#
#.........#
#.....#...#
#.........#
#####.#####

5
1
#####.#####
#.........#
#.........#
#.........#
#.........#
#.........#
#.........#
#.........#
#.........#
#e.......?#
###########
enemies 1
door 0 : 0
sign The dungeon remembers all who enter.

3
1
#####d#####
#.........#
#.........#
#.........#
#..##.....#
d...#......
#.##......#
####......#
#.##......#
#.........#
#####.#####

1
0
#####.#####
#.........#
#.........#
#.........#
#.........#
#..........
#.........#
#.........#
#.........#
#.........#
#####.#####

1
1
#####.#####
#k........#
#.........#
#.........#
#.........#
...........
#.........#
#.........#
#.........#
#.........#
#####.#####
key : 0

3
2
#####.#####
#e.......s#
##?#...#.##
#.........#
#.........#
..........d
#..#.#.#..#
#.........#
##.#......#
#e........#
#####.#####
enemies 2
switch 0 : 0
sign A useful tool lies just ahead.

4
2
#####.#####
#.........#
#.........#
#.........#
#.........#
...........
#.........#
#.......#.#
#......#..#
#......k..#
###########
key : 2

0
1
###########
#..#.....##
#.........#
#.........#
#..#..#...#
...........
#.........#
#.....#..##
#.........#
#.........#
#####.#####

0
0
###########
#?........#
#...#.#...#
#...#.#...#
#.........#
#....@.....
#.........#
#.........#
#.........#
#.........#
#####.#####
sign The ceiling is higher than it looks.

4
1
#####.#####
#.........#
#......#..#
#.......#.#
#.........#
#..........
#.........#
#.........#
#.........#
#.........#
#####.#####

2
1
#####.#####
#.........#
#..#...#..#
#.#.....#.#
#.........#
...........
#.........#
#.........#
#.........#
#.........#
#####d#####

2
0
#####.#####
#.........#
#.#...#...#
#.........#
#...#.#.#.#
#..........
#.#.#.#.#.#
#.........#
#.#.#...#.#
#.........#
#####d#####

