2
0
#####.#####
#.........#
#.........#
#.........#
#.........#
#..........
#.........#
#.........#
#.........#
#.........#
#####.#####

2
3
#####.#####
#........e#
#..#..#..##
#.........#
#.........#
....#..#..#
#.........#
#.........#
#..#..#..##
#.........#
#####.#####
enemies 1

1
2
#####.#####
##.....#e##
#e.......?#
##...#.#.##
#.........#
...#.#.#...
#.........#
##...#...##
#e........#
##.....#..#
#####l#####
enemies 3
sign A locked path — look elsewhere first.

5
4
#####.#####
#.........#
#..#......#
#.#.......#
#.........#
#.........#
#.........#
#.........#
#.........#
#.........#
#####.#####

1
0
###########
#?........#
#.....#...#
#...###...#
#.#####...#
#..###.....
#...@#....#
#.........#
#.........#
#.........#
#####.#####
sign Those who search shall find.

6
4
#####.#####
#.##......#
#...#.#...#
#....##...#
#.##.##...#
#..##.#...#
#.........#
#.........#
#.........#
#X........#
###########

3
3
#####.#####
#.........#
#.........#
#.........#
#.........#
#k........l
#.........#
#.........#
#.........#
#.........#
#####d#####
key : 2

4
0
#####d#####
#.........#
##..#..#..#
#.........#
#.........#
#...#..#..#
#.........#
#.........#
##..#..#..#
#.........#
###########

2
2
#####l#####
#.........#
#..#...#..#
#.#.....#.#
#.........#
...........
#.........#
#.......#.#
#......#..#
#.........#
###########
locked : 0

4
4
#####l#####
#.........#
#.........#
##........#
#.........#
.....e.....
#.........#
#...#.#...#
#.........#
#.........#
#####.#####
locked : 2
boss
enemies 1

1
1
#####.#####
#k........#
#......#..#
#.......#.#
#.........#
...........
#.........#
#.........#
#.........#
#.........#
#####d#####
key : 0

2
1
#####d#####
#.........#
#.........#
#.........#
#...##....#
....#......
#...###.#.#
#...#...#.#
#.....###.#
#.........#
###########

0
1
###########
#.........#
#.........#
#.........#
#.........#
#..........
#.........#
#.......#.#
#......#..#
#.........#
#####.#####

0
2
###########
#.#.......#
#.........#
#..#...#.##
#.........#
......#...#
#.........#
#..#.#...##
#.........#
#.#.....#.#
#####.#####

3
4
###########
#.......#.#
#......#..#
#.......#.#
#.........#
l.........#
#.........#
#.........#
#.........#
#.........#
#####l#####
locked : 1

3
0
#####.#####
#.........#
#.........#
#....######
#....###..#
#.....#...#
#....###..#
#......##.#
#.........#
#.........#
#####d#####

1
3
###########
#........k#
#.........#
#.........#
#.........#
..........#
#.........#
#.......#.#
#......#..#
#.........#
#####.#####
key : 1

4
3
#####d#####
#.........#
#.........#
#.........#
#.........#
#..........
#.........#
#.#.......#
#..#......#
#.........#
###########

4
5
###########
#........k#
#.........#
#.........#
#.........#
....#.#...#
#...##..#.#
#....#.#..#
#.....##..#
#.........#
###########
key : 3

