2
3
###########
#.........#
#.........#
#.........#
#.........#
D.........#
#.........#
#.........#
#.........#
#.........#
#####D#####

3
2
#####l#####
#.........#
#..#......#
#.#.......#
#.........#
D.........D
#.........#
#.........#
#.........#
#.........#
#####D#####

1
2
###########
#........k#
##..#..#..#
#.........#
#.........#
D....#....#
#.........#
#.........#
##.....#..#
#.........#
#####D#####
key : 6

2
2
#####D#####
#.........#
#......#..#
#.......#.#
#.........#
D.........D
#.........#
#.#.......#
#..#......#
#.........#
#####l#####
locked : 3

4
0
#####D#####
#.........#
#.........#
#.........#
#.........#
#.........D
#.........#
#.........#
#.........#
#.........#
###########

1
1
###########
#k#.....#.#
#.........#
#...#.#.#.#
#.........#
D...#.#...D
#.........#
#...#.#...#
#.........#
#.......#.#
#####D#####
key : 3

3
3
#####D#####
#.........#
#.........#
#.........#
#.........#
D.........#
#.........#
#.........#
#.........#
#.........#
#####d#####

3
0
#####D#####
#.........#
#.........#
#.........#
#..#@#....#
#..#.#....D
#..#.##...#
#..##.....#
#..##.....#
#.........#
#####D#####

4
2
#####D#####
#.........#
#.........#
#...#..#..#
#.........#
D.........D
#.#..#..#.#
#.........#
#.........#
##e..e....#
###########
enemies 2

3
1
#####D#####
#.........#
#.........#
#..#..#..##
#.........#
D.........D
#...#..#..#
#.........#
#.........#
#..#.....##
#####d#####

4
1
#####d#####
#.........#
#.........#
#..##.....#
#...#.....#
D..##.##..D
#.....###.#
#.......#.#
##........#
#.........#
#####D#####

7
1
#####D#####
#.........#
#.......p.#
#.........#
#.........#
#.........#
#.........#
#........p#
#.........#
#X........#
###########

6
1
#####d#####
#.........#
#.........#
#.........#
#...e#....#
#..#.#....#
#....#....#
#.........#
#.........#
#.........#
#####D#####
boss
enemies 1

5
1
#####D#####
#.........#
#.........#
#.........#
#....#....#
#...##....#
#e#..#....#
######....#
#e#.#.....#
#.........#
#####d#####
enemies 2

4
3
#####d#####
#.........#
#.........#
#.........#
#.........#
D.........#
#.........#
#.......#.#
#......#..#
#.........#
###########

0
0
###########
#.........#
#.........#
#.........#
#.........#
#.........#
#.........#
#.......#.#
#......#..#
#.........#
#####l#####
locked : 1

2
1
#####D#####
#.........#
#.........#
#....#..#.#
#.........#
D.........D
#..#..#...#
#.........#
#.........#
#k#.....#.#
#####D#####
key : 1

2
0
#####d#####
#.........#
#.....#...#
#k#..#.#..#
#......##.#
#.....##..D
#.........#
#.........#
#.........#
#.........#
#####D#####
key : 0

1
0
#####l#####
#.........#
##.....#..#
#.........#
#.........#
#....#....D
#.........#
#.........#
##..#.....#
#.........#
#####d#####

