2
2
###########
#.........#
#......#..#
#......##.#
#.....#...#
D.........D
#.........#
#.........#
#.........#
##........#
###########

5
0
#####D#####
#.........#
#.........#
#.........#
#.#.......#
#.........#
#.........#
#.........#
#........##
#.........#
###########

4
0
#####D#####
#k#.....#.#
#.........#
#..#...#.##
#.........#
#.........#
#.........#
#..#.#.#.##
#.........#
#.......#.#
#####D#####
key : 1

1
3
###########
#.........#
#..#...#..#
#.#.....#.#
#.........#
#.........D
#.........#
#.........#
#.........#
#.........#
#####l#####
locked : 1

3
4
#####l#####
#.........#
#.........#
#.........#
#.........#
D.........D
#.........#
#.#.....#.#
#..#...#..#
#.........#
###########
locked : 2

3
6
###########
#.........#
#.........#
#.........#
#.........#
D....#.#..#
#..##..#..#
#....#.#..#
#...#.#...#
#......#..#
###########

2
0
#####D#####
#.........#
#..##.....#
#..#?#....#
#....#....#
#....@....l
#.........#
#.........#
#.........#
#.........#
#####D#####
sign Turn back; you are not yet ready.

0
5
###########
#X.#...#..#
#...#.#...#
#...#.....#
#..#......#
#..##.#...#
#.........#
#..#####..#
#.....#...#
#..#...#..#
#####D#####

3
0
#####D#####
#.........#
#.........#
#.........#
#....#....#
#..###....#
#.###.....#
#.##..#...#
#..#..#...#
#.........#
#####D#####

2
1
###########
#.........#
#..##.....#
#...##....#
#..#......#
l.........D
#.........#
#.........#
#.........#
#.........#
###########
locked : 0

2
5
#####d#####
#.......#.#
#.........#
#..#...#.##
#.........#
d...#.....#
#.........#
#..#...#.##
#.........#
#.#.......#
#####D#####

2
4
#####D#####
#k........#
#.........#
#.........#
#.........#
D.........d
#.........#
#.........#
#.........#
#.........#
#####l#####
key : 2

2
3
#####l#####
#.........#
#.........#
#.........#
#.........#
D.........D
#.........#
#.........#
#.........#
#.........#
#####d#####

1
4
###########
#....k....#
#.........#
#.........#
#.........#
D...##.#..D
#.........#
#.........#
#.....##..#
#......#..#
#####D#####
key : 3

4
5
#####D#####
#.........#
#.........#
#.........#
#.........#
#....#.#..#
#..##..#..#
#...##....#
#...#.#...#
#e.....#..#
###########
enemies 1
door 0 : 0 1

1
0
###########
#k........#
##.#...#..#
#.........#
#.#.#.#.#.#
#.........#
#..#.#.#..#
#.........#
#.#.#...#.#
#.........#
#####D#####
key : 0

3
5
#####D#####
#e........#
#.........#
#..###.#..#
#..e#.....#
D..##.##..D
#..#..##..#
#..#.#....#
#.........#
#s........#
#####D#####
enemies 2
switch 0 : 0 1

1
5
#####D#####
#.........#
#.........#
#.........#
#.........#
D....e....#
#.........#
#.........#
#.........#
#.........#
#####d#####
boss
enemies 1

3
3
#####d#####
#.........#
#.#.#...#.#
#.........#
#....#....#
#.........D
#.#...#.#.#
#.........#
#..#.....##
#.........#
###########

