4
0
#####D#####
#.##......#
#.....#...#
#..#.##...#
#.#..#....#
#.........D
#.#.......#
#.........#
#.........#
#.........#
#####D#####

3
0
#####D#####
#.........#
#.........#
#.........#
#.#...#...#
#....@#...D
#.........#
#.........#
#.........#
#.#.......#
#####D#####

5
0
#####D#####
#.........#
#.........#
#.........#
#.........#
#k........D
#.........#
#.........#
#.........#
#.........#
#####l#####
key : 1

4
1
#####D#####
#k#.....#.#
#.........#
#.#.#.#.#.#
#.........#
D...#.#...l
#.........#
#.#.#.#.#.#
#.........#
#.......#.#
#####D#####
key : 0

6
0
#####l#####
#.........#
#.........#
#.........#
#....#.#..#
#..###....#
#..#####..#
#.....##..#
#..#......#
#.........#
###########
locked : 3

2
2
###########
#.........#
#.........#
#.........#
#.........#
l.........#
#.........#
#.#.......#
#..#......#
#.........#
###########
locked : 1

5
1
#####D#####
#......##.#
#......#k.#
#......##.#
#......#..#
D.....#...D
#.........#
#.........#
#.........#
#.........#
###########
key : 3

4
2
###########
#.........#
#......#..#
#.......#.#
#.....#...#
l.........d
#.........#
#.........#
##........#
#.........#
#####D#####
locked : 0

5
4
#####D#####
#.........#
##.....#.##
#.........#
#..#.#.#..#
#.........#
#..#.#....#
#.........#
#..#...#..#
#k........#
###########
key : 4

1
1
#####d#####
#.........#
#..#......#
#.#.......#
#.........#
D.........#
#.........#
#.#.......#
#..#......#
#.........#
#####d#####

2
1
#####d#####
#e.......s#
##.#.....##
#.........#
#.#...#...#
D.........l
#......#..#
#.........#
#.#.#.#.#.#
#.........#
#####D#####
enemies 1
switch 0 : 0 1

3
1
#####D#####
#.#.....#.#
#.........#
#.....#.#.#
#.........#
D.........#
#.........#
#.#.#.#.#.#
#.........#
#.#.....#.#
#####D#####

4
4
#####D#####
#.........#
#.........#
#.........#
#.........#
d....e....#
#.........#
#.........#
#.........#
#.........#
#####D#####
boss
enemies 1

0
1
###########
#.......#.#
#.........#
#...#...#.#
#.........#
#.....#...#
#.........#
#.#.#.#.#.#
#.........#
#.#.....#.#
#####d#####

3
4
###########
#X........#
#.........#
#.........#
#.........#
#.........#
#.........#
#.........#
#.........#
#.........#
#####D#####

2
0
#####D#####
#.#.......#
#.........#
#..#.#...##
#.........#
#...#.#...D
#.........#
#..#.#.#.##
#.........#
#.#.......#
#####D#####

5
2
#####D#####
##.#...#..#
#.........#
#.#...#.#.#
#.........#
D......#..#
#.........#
#.#.#.#...#
#.........#
##e#....?e#
###########
enemies 2
door 0 : 0 1
sign A locked path — look elsewhere first.

1
0
###########
#.........#
#......#..#
#.......#.#
#.........#
#.........D
#.........#
#.........#
#.........#
#.........#
#####D#####

4
3
###########
#.........#
#..#...#.##
#.#.....#.#
#.........#
d.........d
#......#..#
#.......#.#
#...#..#..#
#.........#
###########

