5
1
#####d#####
#.........#
#.......#.#
#.........#
#.##.#.#..#
#.e#.##...D
#e#..#.##.#
##........#
#?###.....#
#.........#
#####D#####
enemies 2
sign Turn back; you are not yet ready.

9
2
#####D#####
#.........#
#.........#
#.........#
#.........#
l.........#
#.........#
#.........#
#.........#
#.........#
###########
locked : 1

6
1
#####D#####
#.........#
#.........#
#.#..#....#
#.........#
D.........d
#.......#.#
#.........#
#.........#
#.......#.#
#####l#####
locked : 0

4
2
#####D#####
#.........#
#.........#
#........##
#....#....#
D...#.....#
#.........#
#.........#
#.........#
#.........#
#####D#####

8
1
#####D#####
#.........#
#..#......#
#.#.......#
#.........#
#.........d
#.........#
#.#...#...#
#..#......#
#.........#
#####D#####

7
1
#####l#####
#.........#
#.........#
##..#.....#
#.........#
D.........D
#...#.....#
#.........#
#.........#
##........#
#####D#####

4
1
#####D#####
#......##.#
#.....#.#.#
#.....#...#
#.....###.#
#.........D
#.........#
#.........#
#.........#
#.........#
#####d#####

6
2
#####D#####
#.........#
#.........#
#.........#
#.........#
d.........#
#.........#
#.........#
#.........#
#.........#
#####D#####

1
1
#####D#####
#.........#
#.........#
#.....#...#
#.........#
#....e....#
#..#......#
#.........#
#..#......#
#.#.......#
#####l#####
locked : 2
boss
enemies 1

3
1
#####d#####
#.........#
#..#......#
#k#.......#
#.........#
#.........D
#.........#
#.#.......#
#..#......#
#.........#
#####D#####
key : 2

9
1
#####D#####
#.........#
#.........#
#.........#
#.........#
#.........l
#.........#
#.........#
#.........#
#epp......#
###########
enemies 1

8
2
#####D#####
#.........#
#.........#
#.........#
#.........#
d.........#
#.........#
#.........#
#.........#
#.........#
#####D#####

7
0
#####D#####
#......#..#
#.........#
#....#....#
#.........#
#....@....D
#.........#
#.........#
#.........#
#?........#
###########
sign Scratched into the stone: 'Do not open the red chest.'

5
2
#####D#####
#k#.....#.#
#.........#
#..#.#.#.##
#.........#
D...#.....#
#.........#
#..#.#.#.##
#.........#
#.#.....#.#
#####D#####
key : 1

2
1
#####l#####
#.........#
#.#.......#
#..#......#
#.##....p.#
#.....p...#
#..#......#
#.##......#
#.###.....#
#.........#
#####d#####

3
2
###########
#........k#
#.........#
#.........#
#.........#
D.........#
#.........#
#.........#
#.........#
#.........#
#####D#####
key : 3

6
0
###########
#k#.......#
#.........#
#..#.#.#..#
#.........#
#.....#...D
#.........#
#....#.#.##
#.........#
#.#.....#.#
#####D#####
key : 0

0
1
###########
#X........#
#.........#
#####.....#
#...#.....#
#..##.....#
#.#.......#
#...#.....#
#.........#
#.........#
#####D#####

7
2
#####D#####
#.........#
#.........#
#.........#
#.........#
D.........#
#.........#
#.........#
#.........#
#.........#
#####D#####

