1
1
#####.#####
#.........#
#..#......#
#.#.......#
#.........#
..........l
#.........#
#.......#.#
#......#..#
#.........#
#####.#####

8
1
#####.#####
#.........#
#.........#
#.........#
#.........#
#.........#
#.......#.#
#.....###.#
#.........#
#X........#
###########

2
1
#####.#####
#.........#
#..#...#..#
###.....#k#
#...#.#...#
..........#
#.........#
#.......#.#
#......#..#
#.........#
#####.#####
key : 0

0
0
###########
#e........#
#.........#
#e#..#..#.#
#.........#
#..........
#.#.......#
#.........#
#.........#
#.#.....#.#
#####.#####
enemies 2
door 0 : 0 1

6
2
#####d#####
#.........#
#.#...#.#.#
#.........#
#....#.#..#
..........#
#.#.#.#.#.#
#.........#
#..#...#.##
#.........#
###########

5
2
#####.#####
#......##k#
#.....#...#
#.........#
#.........#
..........l
#.........#
#.........#
#.........#
#.........#
#####d#####
key : 4

1
0
#####.#####
#........k#
#.....#..##
#.........#
#.........#
#..#..#....
#.........#
#.........#
#.....#..##
#.........#
#####.#####
key : 1

1
2
#####d#####
##.....#..#
#.........#
#.........#
#.#..#..#.#
l.........#
#.........#
##..#..#..#
#.........#
#.........#
###########
locked : 1

4
2
###########
#........e#
#.........#
#...#.###.#
#.........#
....###...#
#....####.#
#...###...#
#.....#...#
#.......#.#
#####.#####
enemies 1

0
2
###########
#.........#
#..#......#
#.#.......#
#.........#
..........#
#.........#
#.#.......#
#..#......#
#.........#
#####d#####

6
1
#####.#####
#......#..#
#..#......#
#k#.......#
#.........#
#..........
#.........#
#.#.....#.#
#..#...#..#
##........#
#####d#####
key : 5

4
1
#####.#####
#.........#
#.........#
#.........#
#.........#
#..........
#.........#
#.........#
#.........#
#.........#
#####d#####

5
1
#####d#####
##.#...#.##
#.........#
#.#.#.#.#.#
#.........#
#..#...#...
#.........#
#.#.#.#.#.#
#.........#
##.#.....##
#####.#####

5
3
###########
#.........#
#.........#
#.........#
#...#.....#
l.........#
#.........#
#.......#.#
#......#..#
#.........#
###########
locked : 5

3
0
#####.#####
#..#...#..#
#.....#...#
#..#.##...#
#....###..#
#..##@#....
#.........#
#.........#
#.........#
#.........#
###########

0
1
###########
#.........#
#..#...#..#
#.#.....#.#
#.........#
...........
#.........#
#.........#
#.........#
#.........#
#####.#####

2
0
#####.#####
#.........#
#?#.#...#.#
#.........#
#..#.#....#
#..........
#e#.#...#.#
#.........#
#..#...#.##
#........s#
#####.#####
enemies 1
switch 0 : 0 1
sign Something glints behind that door…

3
1
#####.#####
#.........#
##.#...#.##
#.........#
#....#.#..#
..........#
#....#....#
#.........#
##.#...#.##
#.........#
#####.#####

7
1
#####d#####
#.........#
#.........#
#.........#
#.........#
#....e....#
#.........#
#.........#
#.........#
#.........#
#####.#####
boss
enemies 1

