1
3
###########
#.........#
##.#...#.##
#.........#
#...#...#.#
d.........D
#..#.#....#
#.........#
#.#.#.#.#.#
#.........#
#####D#####

2
3
#####D#####
#.........#
#.........#
#.........#
#.........#
l....##...D
#....#..#.#
#.......###
#......####
#.......###
#####D#####
locked : 2

3
1
#####D#####
#.........#
#.........#
#.........#
#.........#
d.........D
#.........#
#.........#
#.........#
#.........#
#####D#####

0
4
###########
#X........#
#.........#
#.........#
#.........#
#.........#
#.........#
#.........#
#.........#
#.........#
#####D#####

2
2
#####D#####
#.........#
#.........#
#....##...#
#.........#
D....#.#..l
#.........#
#.........#
#.........#
#.........#
#####l#####
locked : 1

3
2
#####l#####
#e.......e#
#.........#
#.........#
#......p..#
D.........D
#.........#
#.........#
#.........#
#e.......?#
#####D#####
enemies 3
sign Seek the matching key before you proceed.

3
3
#####D#####
#.........#
#..#...#..#
#.##....#.#
#.........#
D.........#
#.........#
#.........#
#.........#
#..#.....k#
###########
key : 1

2
0
#####D#####
#.........#
#.........#
#..##.....#
#...#.....#
#..###....D
#.........#
#.........#
#.........#
#.........#
#####D#####

4
2
#####D#####
#.........#
#......#..#
#.......#.#
#.........#
D.........#
#.........#
#.#.......#
#..#......#
#.........#
#####d#####

5
2
#####d#####
#.........#
#.........#
#......#..#
#.........#
#.........#
#.........#
#.........#
#.........#
#.........#
###########

3
0
#####D#####
####......#
#...#.....#
###.......#
#...#.....#
#....@....d
#.........#
#.........#
#.........#
#.........#
#####D#####

1
0
###########
#.........#
##.....#..#
#.........#
#.........#
#...#..#..#
#.........#
#.........#
##..#..#..#
#.........#
#####D#####

4
1
#####D#####
#.#.......#
#......#..#
#.......#.#
#.........#
d.........D
#.........#
#.#.....#.#
#..#...#..#
#.........#
###########

4
0
#####D#####
#.........#
#.........#
##........#
#.........#
#.........d
#....#..#.#
#.........#
#.........#
##.....#..#
###########

0
2
###########
#k........#
##..#..#..#
#.........#
#.........#
#....#....#
#.........#
#.........#
##..#..#..#
#.........#
#####D#####
key : 3

2
4
#####l#####
#.........#
#.........#
#..#......#
#......#..#
D.........#
#.........#
#.........#
#.........#
#........e#
###########
enemies 1

1
2
#####D#####
#.........#
#k#.....#.#
#.........#
#.........#
#..#......d
#.........#
#.........#
#.......#.#
#.........#
#####D#####
key : 2

1
4
#####D#####
#.........#
#.....##..#
#......##.#
#....##...#
D....e.#..#
#......#..#
#.........#
#.........#
#.........#
#####l#####
locked : 3
boss
enemies 1

2
1
###########
#...k.....#
#.###.....#
##.###.#..#
#..#.#.#..#
D.....##..D
#.#.#.##..#
#.........#
#.........#
#.........#
#####D#####
key : 0

