3
1
#####l#####
#k........#
#.........#
##.....#..#
#.........#
D.........D
#....#..#.#
#.........#
#.........#
##........#
#####D#####
key : 1

2
3
###########
#........e#
#.........#
#.........#
#.........#
D.........#
#.........#
#.........#
##........#
#........?#
###########
enemies 1
sign Many have walked this path.

6
1
#####d#####
#.........#
#.........#
#.........#
#.........#
#.....##..#
#.....#.#.#
#....##.#.#
#.......#.#
#......####
###########

3
2
#####D#####
##.#...#.##
#........e#
##.....#.##
#........?#
D..#.#.#..#
#.........#
##.#.#.#..#
#.........#
##.#...#.##
#####D#####
enemies 1
sign This door will not yield without a key.

5
3
###########
#.........#
#.........#
#.........#
#.........#
d....e....#
#.........#
#.........#
#.........#
#.........#
#####D#####
boss
enemies 1

4
0
#####d#####
##.....#..#
#.........#
#.........#
#.#..#..#.#
#.........D
#.........#
##..#..#..#
#.........#
#.........#
#####d#####

2
1
#####D#####
#.........#
##.#.....##
#.........#
#.#...#.#.#
D.........D
#..#...#..#
#.........#
#.#.#.#.#.#
#.........#
#####l#####
locked : 0

2
2
###########
#.........#
#.....##..#
#......#..#
#..#####..#
D.........D
#...#.#...#
#.........#
#.........#
#.........#
#####D#####

2
0
#####D#####
#.........#
#.........#
#.........#
#.........#
#?...@....D
#.........#
#.........#
#.........#
#......#..#
#####D#####
sign Seek the matching key before you proceed.

1
0
#####D#####
#.........#
#.........#
#..#..#...#
#.........#
#.........D
#...#.....#
#.........#
#.........#
#..#.....##
#####D#####

1
1
###########
#.......k##
#.......###
#....##.#.#
#....#....#
D.........#
#.......p.#
#.........#
#.........#
#........p#
#####D#####
key : 2

3
0
#####D#####
#.........#
#..#......#
#k#.......#
#.........#
#....#....D
#.........#
#.......#.#
#......#..#
#.........#
#####d#####
key : 0

6
3
#####D#####
#.........#
#......#..#
#.........#
#.......#.#
#.........#
#.........#
#.........#
#.........#
#X........#
###########

0
0
###########
#.........#
#.........#
#.........#
#.........#
#.........#
#.......#.#
#.........#
#.........#
##.....#..#
#####D#####

5
0
#####d#####
#.........#
#......#..#
#.......#.#
#.........#
#.........D
#.........#
#.........#
#.........#
#.........#
###########

4
2
#####D#####
#.........#
#.........#
##........#
#.........#
l.........#
#.........#
#.........#
#.........#
#.........#
#####D#####
locked : 1

5
2
#####D#####
#k........#
##.#...#.##
#.........#
#...#.#.#.#
D.........d
#....#.#..#
#.........#
#.#.#.#...#
#.........#
###########
key : 3

5
1
#####D#####
#e........#
#.........#
#..#......#
#.##......#
D..##.....D
#...#.....#
#........##
#.........#
#e........#
#####d#####
enemies 2

4
1
#####D#####
#.........#
#......#..#
#..#.#..#.#
#.........#
D.........l
#.........#
#.#.......#
#..#......#
##........#
#####D#####

