1
0
###########
#.........#
#.........#
#.........#
#..##.....#
#..##......
#..#......#
#..###....#
#..##.....#
#.........#
#####d#####

4
0
#####.#####
##.....#.##
#k........#
##.#...#.##
#.........#
#..#.......
#.........#
#..#.#.#.##
#.........#
##.#.....##
#####.#####
key : 0

2
0
#####d#####
#.........#
#......#..#
#.......#.#
#.........#
#..........
#.........#
#.......#.#
#......#..#
#.........#
#####d#####

3
2
#####.#####
#e........#
#.........#
#.....#...#
#.....#...#
....#....e#
#....#....#
#....##...#
#.....##..#
#.........#
#####.#####
enemies 2

5
2
#####.#####
#..#......#
#.........#
#......#..#
#.........#
l..........
#.........#
#.........#
#.........#
#.........#
#####.#####
locked : 0

1
1
#####.#####
#.........#
#...#.###.#
#...##.##.#
#...##..#.#
....###...#
#...e#....#
#.........#
#.........#
#.........#
#####d#####
boss
enemies 1

2
1
#####d#####
#k#.....#.#
#.........#
#....#.#.##
#.........#
....#......
#.........#
#..#.#.#.##
#.........#
#.......#.#
#####.#####
key : 5

5
1
#####.#####
#.........#
#.....#...#
#...###...#
#.........#
..........l
#.........#
#.........#
#.........#
#.........#
#####.#####

5
0
#####.#####
#.........#
#.........#
#.........#
#..#......#
#....@.....
#.........#
##........#
#.........#
#?........#
###########
sign The brave are rewarded.

3
1
#####.#####
#.........#
#...#..#..#
#.........#
#.........#
....#..#...
#.........#
#.........#
##..#..#..#
#.........#
#####.#####

7
1
#####l#####
#.........#
#.........#
#.........#
#.........#
#.........#
#.........#
#.........#
#.........#
#.........#
###########
locked : 1

5
3
###########
#.....e####
#.....##e##
#....#.#.##
#.........#
...##.....#
#..##.##..#
#...##....#
#.....##..#
#.....e#.?#
###########
enemies 3
door 0 : 0
sign A locked path — look elsewhere first.

4
2
#####.#####
#.........#
#.........#
#.........#
#.........#
..........#
#.........#
#.#.......#
#..#......#
#.........#
#####.#####

0
1
###########
#X........#
#.........#
####.#....#
#....#....#
#..#.#....#
#..#......#
##.###....#
#.........#
#.........#
#####.#####

4
1
#####.#####
#.........#
#.........#
#.........#
#.........#
...........
#.........#
#.........#
#.........#
#.........#
#####.#####

6
1
#####.#####
#.........#
#.........#
#.........#
#e#.......#
#.es#.....d
#e###.....#
#.........#
#.........#
#.........#
#####l#####
enemies 3
switch 0 : 0

6
2
#####.#####
#..#.....##
#.........#
#.........#
#......#..#
d.........#
#.........#
#.....#..##
#.........#
#.........#
###########

3
0
#####d#####
##.....#..#
#k........#
#.........#
#.........#
#..........
#.........#
#...#..#..#
#.........#
#.........#
#####.#####
key : 1

2
2
###########
#........k#
#..#......#
#.#.......#
#.........#
..........#
#.........#
#...#.....#
#.........#
#.........#
#####.#####
key : 6

