10
0
#####D#####
#.#.......#
#.#.......#
#.###.#...#
#.##......#
#...###...#
#.........#
#.........#
#.........#
#X........#
###########

1
1
#####l#####
#.........#
#.........#
#.....#...#
#.........#
d.........#
#......#..#
#.........#
#.........#
#.........#
#####D#####

7
0
#####D#####
#.........#
#......#..#
#.......#.#
#.........#
#.........D
#.........#
#.#.......#
#..#.....##
#........k#
#####d#####
key : 2

8
0
#####d#####
#.........#
#.........#
#.........#
#.........#
#.........D
#.........#
#.........#
#.........#
#.........#
#####l#####

8
1
#####D#####
#.........#
#.........#
#...###.#.#
#...#.#...#
D.....#...#
#...#.##..#
#.......#.#
#.........#
#........k#
###########
key : 4

0
1
###########
##.#...#.##
#.........#
##.....#.##
#.........#
D..#.#.#..#
#.........#
##.#.#.#.##
#.........#
##.....#.##
#####l#####
locked : 2

3
0
#####D#####
#?.#......#
##.##.#...#
##..#.#...#
#..##..#..#
#...#@#...D
#.........#
#.........#
#.........#
#.........#
#####D#####
sign Those who search shall find.

0
0
###########
#.#.....#.#
#.........#
#..#.#.#..#
#.........#
#...#.#...D
#.........#
#..#.#...##
#.........#
#.#.....#.#
#####l#####
locked : 1

9
0
#####l#####
#.........#
#.......#.#
#...##....#
#..###....#
#....e....#
#.....##..#
#.....#.###
#.........#
#......##.#
#####D#####
locked : 0
boss
enemies 1

2
0
#####d#####
#.........#
#.........#
#.........#
#.........#
#.........D
#.........#
#.#.....#.#
#..#...#..#
#.........#
#####D#####

2
1
#####D#####
#.........#
#..#......#
#.#.......#
#.........#
D.........#
#.........#
#.#.....#.#
#..#...#..#
#.........#
#####D#####

7
1
###########
#.......ee#
#........?#
#.........#
#.........#
D.........#
#.........#
#.........#
#........##
#.........#
#####D#####
enemies 2
sign Something glints behind that door…

1
0
#####l#####
#.#.....#.#
#.........#
#..#.....##
#.........#
#...#.....d
#.........#
#..#.#.#.##
#.........#
#.......#.#
#####d#####

5
0
#####D#####
#........##
#.........#
#.........#
#..#......#
#.........D
#.........#
#.....#..##
#.........#
#.........#
#####D#####

4
1
#####D#####
#.........#
#..#......#
#.#.......#
#.........#
d.........#
#.........#
#.......#.#
#......#..#
#.........#
#####D#####

4
0
#####D#####
#.........#
#.........#
#.........#
#.........#
#.........d
#.........#
#k#.......#
#..#......#
#.........#
#####D#####
key : 0

3
1
#####D#####
#.......#.#
#.........#
#.........#
#.#.....#.#
D.........#
#.........#
#.#..#..#.#
#.........#
#.........#
#####D#####

5
1
#####D#####
#.........#
#.........#
#.........#
#.#..#....#
D.........#
#.........#
#.........#
#.........#
#........k#
###########
key : 1

6
0
#####D#####
#e.......e#
##.#...#.##
#.........#
#..#.#....#
#.........#
#....#.#..#
#.........#
##.....#.##
#e........#
#####D#####
enemies 3

