4
2
#####D#####
#k........#
#..#......#
#.#.......#
#.........#
D.........l
#.........#
#.........#
#.........#
#.........#
#####D#####
key : 2

0
3
###########
#X........#
####..#..##
#.#......##
#.#...###.#
#....#....#
#.........#
#.........#
#.........#
#.........#
#####D#####

5
3
#####D#####
##........#
#.##......#
#.#.......#
#.#.##....#
D....#....#
#.........#
#.........#
#.........#
#.........#
#####D#####

7
2
#####d#####
#.........#
#......#..#
#.......#.#
#.........#
D.........#
#.........#
#.......#.#
#......#..#
#.........#
###########

6
1
#####D#####
#..#.....##
#.........#
#.........#
#...#.....#
#.........d
#.........#
#..#..#...#
#.........#
#.........#
#####D#####

6
2
#####D#####
#.#.....#.#
#.........#
#.#.#.#.#.#
#.........#
d.....#...D
#.........#
#.#.#.#.#.#
#.........#
#.#.......#
#####d#####

4
3
#####D#####
#.........#
##.#...#..#
#.........#
#.#.#.#.#.#
l.........#
#....#.#..#
#.........#
#.#...#.#.#
#.........#
#####D#####
locked : 3

5
0
###########
#..#......#
#..##.....#
##........#
#..#......#
#....@##..D
#.....###.#
#.......#.#
#.........#
#.........#
###########

5
1
#####D#####
#k........#
#.........#
#.........#
#.........#
D.........l
#.........#
#.........#
#.........#
#.........#
#####D#####
key : 0

3
3
#####D#####
#.........#
#......#..#
#.......#.#
#.........#
D.........#
#.........#
#.........#
#.........#
#.........#
#####D#####

2
2
###########
#e#e...##.#
#e###.#.#.#
#?###...#.#
#.....###.#
#.........d
#.........#
#.........#
#.........#
#.........#
#####D#####
enemies 3
sign Turn back; you are not yet ready.

7
1
#####D#####
#.........#
#.........#
#.........#
#...#.....#
#.........D
#.........#
##.....#..#
#.........#
#.........#
###########

6
3
#####D#####
#.........#
#..#......#
#.#.......#
#.........#
D.........#
#.........#
#.........#
#.........#
#........k#
###########
key : 3

2
3
#####d#####
#.........#
#.........#
#..#......#
#.........#
d.........#
#..#......#
##........#
#.........#
#.........#
#####D#####

1
3
#####D#####
#.........#
####......#
#..#......#
#.####....#
#..#e#....#
#.##.#....#
#.##......#
#...#.....#
#.........#
#####d#####
boss
enemies 1

4
1
#####D#####
#.........#
#......#..#
#.......#.#
#.........#
#.........D
#.........#
#.#.......#
#..#......#
#.........#
#####D#####

5
2
#####D#####
#.........#
#.........#
#.........#
#.........#
l.........D
#.........#
#.#.....#.#
#..#...#..#
#.........#
#####D#####
locked : 0

3
1
###########
#k........#
#.........#
#.#..#..#.#
#.........#
#.........l
#..#..#...#
#.........#
#.........#
#.#.....#.#
#####D#####
key : 1

3
2
#####D#####
#.........#
#.........#
#..#.#.#.##
#.........#
l...#.....D
#.........#
#..#.#....#
#.........#
#.#.....#.#
#####D#####
locked : 1

