6
1
#####.#####
#......#..#
#.##..#...#
#....#.#..#
#..#......#
...#.......
#.........#
#.........#
#.........#
#.........#
###########

6
0
#####.#####
#......#..#
#......#.##
#....#....#
#....#....#
#..........
#.........#
#.........#
#.........#
#.........#
###########

7
2
#####.#####
#.........#
#.........#
#.........#
#.........#
#.........#
#.....###.#
#....#..###
#.....#...#
#.......###
###########

4
0
###########
#k........#
#......#..#
#.......#.#
#.........#
#..........
#.........#
#.#.......#
#..#......#
#.........#
#####.#####
key : 0

6
2
#####d#####
#.........#
#.........#
#.........#
#.........#
...##.#...#
#.##......#
#.###.....#
#####.....#
###.......#
#####.#####

2
2
#####d#####
#k#.....#.#
#.........#
#..#.#.#.##
#.........#
#.....#....
#.........#
#......#.##
#.........#
#.........#
#####.#####
key : 3

3
1
###########
#.........#
#####.....#
###..#....#
#.##.#....#
#..#.......
#.##......#
#.........#
#.........#
#.........#
#####.#####

5
0
#####.#####
#.........#
#.........#
####......#
#?........#
#..#.@.....
#.........#
#.........#
#.........#
#.........#
#####.#####
sign Only the prepared may pass.

1
2
#####.#####
#.........#
#.........#
#.........#
#.......#.#
#....e....#
#...#..#..#
#..#......#
#.........#
#.........#
#####d#####
boss
enemies 1

0
2
###########
#X........#
#.........#
#.....#...#
#...#.....#
#...##....#
#....##...#
#.....#...#
#.....#...#
#.........#
#####.#####

5
3
#####.#####
#.........#
#.........#
#####.....#
#.#.#.....#
....#.....#
#.........#
#.........#
#........e#
#......?ee#
###########
enemies 3
sign What you seek is close.

3
2
#####.#####
#.........#
#.#.....#.#
#.........#
#.........#
.....#....d
#.........#
#.........#
#.......#.#
#.........#
#####l#####
locked : 2

5
2
#####d#####
#.........#
##..#.....#
#.........#
#.........#
...........
#.........#
#.........#
#...#..#..#
#.........#
#####d#####

4
3
#####.#####
#.........#
#.........#
#.........#
#.........#
..........#
#.........#
#.#.....#k#
#..#...#..#
#.........#
#####.#####
key : 2

5
1
#####l#####
#.#.....#.#
#.........#
#.#.#.#.#.#
#.........#
....#.#....
#.........#
#.#.#.#.#.#
#.........#
#.#.....#.#
#####.#####
locked : 0

3
3
#####.#####
#.........#
#..#......#
#.#.......#
#.........#
d.........#
#.........#
##........#
#...#.....#
#.........#
#####.#####

4
2
#####l#####
#.........#
#...#.##..#
#.....###.#
#...##....#
l....#.#...
#.........#
#.........#
#.........#
#.........#
#####d#####
locked : 1

2
3
###########
#.........#
#..#......#
#.#.......#
#.........#
..........#
#......#..#
#.#.......#
#..#......#
#.........#
#####.#####

4
1
#####.#####
#..#...#..#
#.........#
#..#.#.#.##
#.........#
...#.#.#..l
#.........#
##...#.#.##
#k........#
##.....#.##
#####l#####
key : 1

