0
1
###########
#.........#
#.........#
#.........#
#.........#
D.........#
#.........#
#.......#.#
#......#..#
#.........#
#####D#####

0
0
###########
#.........#
#.........#
#.....#p#.#
#.....#...#
#....@#...D
#.........#
#.........#
#.........#
#.........#
#####D#####

3
2
#####D#####
#.........#
#..#..#...#
#.........#
#.........#
d.........D
#.........#
#.........#
#..#..#..##
#.........#
#####D#####

4
2
#####D#####
#..#......#
#.........#
#.........#
#.....#...#
D.........D
#.........#
#..#..#...#
#.........#
#.........#
###########

2
0
#####D#####
#.........#
#.........#
#.........#
#.........#
#.........D
#.........#
#.........#
#.......p.#
#p........#
#####D#####

1
1
#####D#####
#e........#
##.#.....##
#.........#
#.......#.#
D.........#
#......#..#
#.........#
#.#.#.#.#.#
#.........#
#####D#####
enemies 1

1
3
###########
#X........#
#.........#
#.........#
#.........#
#..##.#...#
#.##..#...#
#.#.###...#
#.#...#...#
#.#.......#
#####D#####

2
3
#####D#####
#.........#
#.........#
#.........#
#.........#
D..#.e....#
#.........#
#.##......#
#.........#
#.........#
#####d#####
boss
enemies 1

3
3
#####d#####
#.........#
#.#.....#.#
#.........#
#.........#
D.........d
#.........#
#.........#
#.#.....#.#
#.........#
#####d#####

2
2
###########
#..#k.....#
#..#......#
#..#..#...#
#...#.#...#
D.........D
#.........#
#.........#
#.........#
#.........#
#####D#####
key : 4

4
4
#####D#####
#.........#
#.........#
#.........#
#.........#
D.........#
#.........#
#.........#
#.........#
#........k#
###########
key : 10

5
1
#####l#####
#.........#
#.........#
#....#....#
#.........#
#.........#
#.........#
#.......#.#
#......#..#
#.........#
###########
locked : 4

4
1
#####D#####
#e........#
#.........#
#..#..#..##
#?........#
#e........D
#..#......#
#.........#
#.........#
#..#.....##
#####l#####
enemies 2
sign Seek the matching key before you proceed.

3
0
#####D#####
#.........#
##.....#.##
#.........#
#.#...#...#
#.........D
#..#.#.#..#
#.........#
#.#.#...#.#
#k........#
###########
key : 1

3
4
###########
#.........#
#.........#
#....#....#
#.........#
d.........#
#.#..#....#
#.........#
#.........#
#.#.....#.#
#####D#####

1
0
#####D#####
#.........#
#.........#
#.#..#..#.#
#.........#
#.........D
#e#..#..#.#
#.........#
#.........#
#?#.....#.#
#####D#####
enemies 1
sign The dungeon remembers all who enter.

2
1
#####D#####
##.#......#
#..##.....#
#.#k#.....#
#.#.......#
D..#......D
#.........#
#.........#
#.........#
#.........#
#####l#####
key : 0

3
1
#####l#####
#.........#
#..#......#
#.#.......#
#......#..#
D.........d
#.........#
#.#.......#
#..#......#
#..#......#
#####D#####
locked : 1

4
3
#####d#####
#.........#
#..#...#..#
#.#.....#.#
#.........#
D.........D
#.........#
#.........#
#.........#
#.........#
###########

