1
3
###########
#........k#
#.........#
#.........#
#.........#
D.........#
#.........#
#..###....#
#..#......#
#.........#
#####D#####
key : 4

1
2
###########
#e.#...#..#
#..##.....#
#...#..#..#
#...####..#
#.........D
#.........#
#.........#
#.........#
#.........#
#####D#####
enemies 1

4
2
#####d#####
#.##......#
#.##......#
#.##......#
#.........#
D.........#
#.........#
#.........#
#........e#
#.......ee#
###########
enemies 3
door 0 : 0

2
2
#####D#####
#.#.......#
#..##.....#
#.##...#..#
#.......#.#
D......#..D
#.........#
#.........#
#.........#
#.........#
#####D#####

0
1
###########
#..#.....##
#.........#
##.#...#.##
#.........#
d..#.#.#..#
#.........#
##...#.#.##
#.........#
##.#...#.##
###########

4
4
#####d#####
##.#......#
#.........#
#..#......#
#.....#.#.#
#....e##..#
#.....###.#
#.........#
#.........#
#.........#
#####D#####
boss
enemies 1

3
0
#####d#####
#.........#
#.........#
#.........#
#....##...#
#......#..D
#....#....#
#.........#
#.........#
#.........#
#####D#####

3
4
###########
#.........#
#.........#
#.........#
#.........#
l.........#
#.........#
#.#.......#
#..#......#
#.........#
#####d#####
locked : 2

2
1
###########
#.#.......#
#.........#
#.........#
#..#..#...#
D.........D
#.........#
#.#..#....#
#.........#
#.........#
#####D#####

2
0
#####D#####
#.........#
#.###.....#
#.#?#.....#
#...#.....#
#..#.@....D
#.........#
#.........#
#.........#
#.........#
#####d#####
sign The dungeon remembers all who enter.

1
0
#####D#####
#s........#
#?........#
#.........#
#.........#
#e.......e#
#.........#
#.........#
#.........#
#.........#
#####D#####
enemies 2
switch 0 : 0
sign Something glints behind that door…

4
1
#####l#####
#.........#
#.........#
#.........#
#.........#
D.........D
#.#.......#
#.##......#
##........#
#.........#
###########
locked : 0

5
4
#####D#####
#........##
#.........#
#......#..#
#....#.#..#
#....#....#
#...#.....#
#.........#
#.........#
#X........#
###########

2
3
#####D#####
#.......#.#
#.........#
#........##
#.........#
D...#.#...#
#.........#
#....#.#..#
#.........#
#k#.......#
#####D#####
key : 3

0
0
###########
#k##......#
#.##......#
#..#.#....#
#.........#
#.........d
#.........#
#.........#
#.........#
#.........#
#####D#####
key : 0

3
1
#####D#####
#.........#
#..#...#..#
#.#.....#.#
#.........#
D.........D
#.........#
#.#.......#
#..#......#
#.........#
#####l#####

3
3
#####D#####
##.....#..#
#.........#
#.........#
#....#..#.#
D.........l
#.........#
##.....#..#
#.........#
#....k....#
###########
key : 2

4
0
#####D#####
#.......#.#
#.........#
#..#.#.#.##
#.........#
#...#.....D
#.........#
#..#.#.#.##
#.........#
#.......#.#
###########

3
2
#####D#####
#.........#
#.........#
#.........#
#.........#
D.........D
#.........#
#.......#.#
#......#..#
#.........#
#####d#####

