4
3
#####D#####
#.........#
#.........#
#.........#
#.........#
D........k#
#.........#
#.........#
#.........#
#.........#
#####d#####
key : 2

5
3
#####d#####
#.........#
#.........#
#......#..#
#.........#
D..#......#
#.........#
#.#.......#
#..#......#
#.........#
###########

2
0
#####D#####
#.#.....#.#
#.........#
#..#.#.#.##
#.........#
#...#.#...l
#.........#
#..#.#...##
#.........#
#.#.....#.#
#####d#####

2
3
###########
#.......ee#
#.........#
#.........#
#.........#
D.........#
#.........#
#.........#
#.........#
#.........#
#####D#####
enemies 2

3
1
#####D#####
#.........#
#.........#
#.........#
#.........#
D....#.#..D
#......#..#
#....##...#
#.........#
#.........#
#####D#####

2
1
#####D#####
#.........#
#.........#
#...#..#..#
#.........#
l.........D
#...#..#..#
#.........#
#.........#
#......#..#
#####D#####
locked : 1

0
2
###########
#X........#
#.........#
#..##.....#
#....#....#
#.........#
#.........#
#......##.#
#.....#...#
#.........#
#####D#####

3
0
#####d#####
#.........#
#..#...#..#
#.#.....#.#
#.........#
#.........D
#.........#
#.#.......#
#..#......#
#.........#
#####D#####

1
1
###########
#...e.....#
#..##?....#
#..###....#
#..####...#
D....##...D
#.....##..#
#....####.#
#......####
#.........#
#####D#####
enemies 1
sign A locked path — look elsewhere first.

5
2
#####D#####
#..#...#.##
#.........#
#.#.....#.#
#.........#
D......#..D
#.........#
#.#.#k#.#.#
#.........#
##........#
###########
key : 3

3
3
#####D#####
#.........#
#.........#
#.........#
#.........#
d.........#
#.........#
#.........#
#.........#
#.........#
#####D#####

2
2
#####d#####
#.........#
#.........#
##..#.....#
#.........#
D.........D
#....#..#.#
#.........#
#.........#
##.....#..#
#####D#####

4
0
#####D#####
#.........#
#.........#
#.........#
#.........#
#....@....D
#.........#
#.........#
#.........#
#?........#
###########
sign The dungeon remembers all who enter.

4
2
#####D#####
#k........#
#..#......#
#.#.......#
#.........#
D.........D
#.........#
#.......#.#
#...#..#..#
#.........#
#####D#####
key : 0

4
1
#####D#####
#..#...#.##
#.........#
##.....#.##
#.........#
D....#....D
#.........#
##.#.#.#.##
#.........#
##.....#.##
#####D#####

1
0
###########
#e........#
#e....#...#
#...#e#...#
#...###...#
#.........D
#.........#
#.........#
#.........#
#.........#
#####D#####
enemies 3

3
2
#####D#####
#e.......?#
#.........#
#...#.....#
#...p.....#
D...#.....d
#.....###.#
#.....#e..#
#.........#
#e........#
#####D#####
enemies 3
sign The brave are rewarded.

5
1
#####D#####
#.........#
#..#......#
#.#.......#
#.........#
#.........D
#.........#
#.......#.#
#......#..#
#k........#
###########
key : 1

1
2
#####D#####
#.........#
#.........#
#.........#
#.........#
D..#.e....#
#.........#
#.###.....#
#.........#
#.........#
#####d#####
boss
enemies 1

