5
2
#####D#####
#.........#
#.........#
#.........#
#.p.......#
D.........#
#.........#
#.........#
#......p..#
#........k#
###########
key : 4

1
4
#####D#####
#.........#
#.........#
#.........#
#.........#
#....e....D
#.........#
#.........#
#.........#
#.........#
#####l#####
locked : 0
boss
enemies 1

0
4
###########
#X........#
#.........#
#.........#
#.........#
#.........#
#.........#
#.........#
#.........#
#.........#
#####D#####

2
1
###########
##.....#..#
#.........#
#.#.#...#.#
#.........#
#..#.#.#..D
#.........#
#.#.#.#...#
#.........#
##.#...#.##
#####D#####

1
5
###########
#......?ee#
#........e#
#.........#
#.........#
D.........#
#.........#
#.........#
#.........#
#.........#
#####D#####
enemies 3
sign Turn back; you are not yet ready.

3
0
###########
#?........#
#.........#
#.........#
#.........#
#....@....D
#.........#
#.........#
#.........#
#.........#
#####D#####
sign Something glints behind that door…

6
1
#####D#####
#.........#
#......#..#
#.......#.#
#.........#
#.........#
#.........#
#.#.......#
#..#......#
#.........#
###########

2
5
#####D#####
#.........#
#......#..#
#.......#.#
#.........#
D.........#
#.........#
#.........#
#.........#
#.........#
###########

5
1
#####D#####
#.........#
#..#......#
#k#.......#
#.........#
#.........D
#.........#
#.......#.#
#......#..#
#.........#
#####D#####
key : 2

4
1
#####D#####
#k........#
##.#...#..#
#.........#
#.#.#...#.#
D.........D
#..#...#..#
#.........#
#.#.#...#.#
#.........#
#####D#####
key : 1

4
2
#####D#####
#.........#
#.#.#.#.#.#
#.........#
#..#.#.#..#
D.........#
#.#.#.#...#
#.........#
#........##
#.........#
#####D#####

2
3
###########
##.#...#.##
#.........#
##...#.#.##
#.........#
D..#.#.#..d
#.........#
#..#.#...##
#.........#
##.#.....##
#####l#####
locked : 1

4
0
#####D#####
#.........#
#......#..#
#.......#.#
#.........#
#.........D
#.........#
#.......#.#
#......#..#
#k........#
###########
key : 0

3
2
#####d#####
#......#..#
#.#.#..#..#
#.......#.#
#.........#
D.........D
#.........#
#.......#.#
#......#..#
#.........#
#####D#####

2
2
###########
#.........#
#.........#
#.........#
#.........#
D.........D
#.........#
#.......#.#
#......##.#
#.........#
#####d#####

2
4
#####l#####
#.........#
##.#...#..#
#.........#
#.#.#.#.#.#
d.........D
#..#.#....#
#.........#
#.#...#...#
#.........#
#####D#####

3
1
#####D#####
#e........#
#.........#
#.........#
#.........#
D.........D
#.........#
#.........#
#.........#
#e........#
#####D#####
enemies 2

3
4
#####D#####
#.......#.#
#.....##..#
#.......#.#
#....##.#.#
d..pp.....#
#.........#
#.........#
#.........#
#.........#
###########

3
3
#####l#####
#.........#
##.#......#
#.........#
#.#...#...#
D.........d
#....#.#..#
#.........#
#.#...#...#
#.........#
###########

