3
0
#####D#####
###.......#
#e###.....#
#.###.....#
#?###.....#
#.e#......l
#.#.......#
#.........#
#.........#
#.........#
#####D#####
enemies 2
sign Only the prepared may pass.

2
3
###########
#.........#
#.#.....#.#
#.........#
#....#.#..#
D.........d
#.#.#.#.#.#
#.........#
#......#.##
#.........#
#####d#####

1
4
###########
#X........#
#.........#
#.........#
#....##...#
#.....##..#
#....####.#
#.........#
#.........#
#.........#
#####D#####

4
1
#####D#####
#.........#
#.........#
#.......#.#
#......#..#
D....#.#..D
#....#..#.#
#.......#.#
#.....#.#.#
#.......###
#####D#####

5
2
#####D#####
#.........#
#......#..#
#.......#.#
#.........#
D.........#
#.........#
#.........#
#.........#
#.........#
###########

4
2
#####D#####
#e........#
#.........#
#.........#
#...#..#..#
D.........D
#.........#
#...#..#..#
#.........#
#?........#
#####D#####
enemies 1
sign Those who search shall find.

3
1
#####d#####
#.........#
#.........#
##.....#..#
#.........#
l.........D
#.#..#..#.#
#.........#
#.........#
##.....#..#
#####D#####
locked : 0

2
1
###########
#.........#
#.........#
#...#..#..#
#.........#
D.........D
#.#..#..#.#
#.........#
#.........#
##........#
#####d#####

4
0
#####D#####
#.........#
#.........#
#.....##..#
#....#....#
#....@....D
#.........#
#..#......#
#.........#
#?........#
###########
sign Many have walked this path.

5
1
#####D#####
#.........#
#.........#
#.........#
#.........#
#.........D
#.........#
#.........#
#.........#
#k........#
###########
key : 2

3
2
#####d#####
##e#...#e##
#.........#
#...#.#.#.#
#.........#
D..#...#..D
#.........#
#.#.#.#.#.#
#.........#
#..#...#.##
#####D#####
enemies 2

4
3
#####D#####
#.#.....#.#
#.........#
#.........#
#..#..#...#
D.........#
#.........#
#.#..#....#
#.........#
#........k#
###########
key : 4

3
4
#####D#####
#.........#
#..#......#
#.........#
#.........#
D.........#
#.........#
#.......#.#
#......#..#
#.........#
###########

3
3
#####d#####
#.........#
#.........#
#.........#
#.........#
D.........D
#....##...#
#....###..#
#.........#
#.........#
#####D#####

2
2
###########
#.........#
#.........#
#.........#
#.#.#.....#
D..#......D
#..#......#
##........#
####......#
#.........#
#####d#####

2
0
#####D#####
#.........#
#..#..#...#
#...####..#
#...k##...#
#...###...D
#..#.##...#
#.........#
#.........#
#.........#
#####D#####
key : 0

1
0
#####D#####
##.#.....##
#.........#
#....#.#.##
#.........#
#..#.#.#..#
#.........#
##...#.#.##
#k........#
##.#...#.##
#####D#####
key : 3

2
4
#####D#####
#.##......#
#.#.#.....#
#.#.......#
#....#....#
d....e....#
#....#....#
#.........#
#.........#
#.........#
#####D#####
boss
enemies 1

0
0
###########
#.......e##
#.....#.#e#
#...##.##.#
#.......#.#
#...#.##..#
#....#..#.#
#...#.#...#
#.........#
#.........#
#####D#####
enemies 2

