1
3
#####D#####
#.........#
#......#.##
##.....#..#
#...e#.##.#
D....##...#
#....####.#
#.........#
#.........#
#.........#
#####l#####
locked : 3
boss
enemies 1

6
2
#####D#####
#e.#......#
#.........#
#.........#
#s........#
#e.......e#
#.........#
#.........#
#.........#
#.........#
#####D#####
enemies 3
switch 0 : 0 1

4
3
#####D#####
##.#...#..#
#.........#
##.#.#.#.##
#.........#
D..#.#.#..#
#.........#
#..#.#.#.##
#.........#
#..#......#
#####D#####

4
1
#####D#####
#.........#
#.........#
#.........#
#.........#
D.........D
#..#......#
#.........#
###.......#
#k........#
###########
key : 0

4
2
#####D#####
#......#..#
#......#..#
#...#p##..#
#..#####..#
D.........D
#.........#
#.........#
#.........#
#.........#
#####l#####

3
1
#####D#####
#.........#
#.........#
#...##....#
#..#.#....#
#..#.#.#..D
#.....###.#
#.........#
#.........#
#.........#
#####D#####

1
2
###########
#.........#
#.......#.#
#......#..#
#.........#
D.........D
#.........#
#.........#
#.........#
#.........#
#####d#####

2
1
#####l#####
#.........#
#..#...#..#
#k#.....#.#
#.........#
#.........D
#.........#
#.......#.#
#......#..#
#.........#
#####D#####
key : 1

2
2
#####d#####
#k........#
#.........#
#.........#
#.........#
D.........d
#.........#
#.........#
#.........#
#.........#
#####D#####
key : 2

2
3
#####l#####
#.........#
#......#..#
#.......#.#
#.........#
d.........#
#.........#
#.#.......#
#..#......#
#.........#
#####D#####

3
2
#####D#####
#k........#
##.#...#.##
#.........#
#..#...#..#
D.........D
#..#.#.#..#
#.........#
#......#.##
#.........#
#####D#####
key : 3

1
1
###########
#.........#
#.........#
#......##.#
#...##..#.#
#...#..#..D
#....#..#.#
#...##.##.#
#.........#
#.......#.#
#####l#####
locked : 2

5
2
#####l#####
#.........#
#.........#
#.#..#..#.#
#.........#
#.........d
#.....#...#
#.........#
#.........#
#.#.....#.#
#####D#####
locked : 0

4
0
###########
#?........#
#.........#
#.........#
#.........#
#....@....D
#.........#
#.........#
#.........#
#.........#
###########
sign Something glints behind that door…

7
2
#####D#####
#.........#
#..#...#..#
#.#.....#.#
#..#......#
#.........#
#.........#
#.........#
#.........#
#.........#
###########

0
3
###########
#X........#
#.........#
#...##.##.#
#...#..##.#
#..p##....#
#...#...#.#
#.....##..#
#.........#
#.........#
#####D#####

5
3
#####D#####
###.......#
#.#.#.#...#
#....#.#..#
#..#.#.#..#
d.........#
#.........#
#.........#
#.........#
#.........#
###########

3
3
#####D#####
#.........#
#.....#...#
#.....#...#
#.........#
D.........D
#.##......#
#..#......#
##........#
#.........#
#####D#####

3
4
###########
#........e#
##.#...#.##
#.........#
#..#.#.#..#
D.........#
#....#.#..#
#.........#
##.#.....##
#.........#
###########
enemies 1
door 0 : 0 1

