2
1
#####d#####
#.........#
#..#......#
#.#.......#
#.........#
#..........
#.........#
#.......#.#
#......#..#
#.........#
#####.#####

0
1
###########
#e.#...#..#
#.........#
#....#.#.##
#.........#
#..#.#.#..#
#.........#
##.#.#.#..#
#.........#
##.#...#.##
#####.#####
enemies 1
door 0 : 0 1

3
2
#####.#####
#.........#
#.........#
#.........#
#.........#
d..........
#.........#
#.........#
#.........#
#.........#
#####d#####

2
4
#####.#####
#.........#
#.........#
#.........#
#.........#
.....e....#
#.........#
#.........#
#.........#
#.........#
#####l#####
locked : 0
boss
enemies 1

4
0
#####.#####
#.........#
#...#..#..#
#.........#
#.........#
#......#...
#.........#
#.........#
#...#..#..#
#.........#
###########

4
2
#####d#####
#.........#
#.........#
#....#....#
#.........#
...........
#.#..#..#.#
#.........#
#.........#
#.#.......#
#####d#####

3
4
#####l#####
#.........#
#.........#
#.........#
#.##......#
...#.......
#.........#
#.........#
#.........#
#....k....#
###########
key : 2

3
3
#####.#####
#k........#
#..#......#
#.#.......#
#.........#
...........
#.........#
#.........#
#.........#
#.........#
#####l#####
key : 0

5
2
#####d#####
#.........#
#.........#
#.........#
#.........#
#.........#
#.........#
#.........#
#.........#
#.........#
###########

3
1
#####.#####
#.........#
#..#...#..#
#.#.....#.#
#.........#
..........d
#.........#
#.........#
#.........#
#.........#
#####.#####

4
3
#####l#####
#.........#
#.........#
#.........#
#.........#
..........#
#.........#
#.........#
#.........#
#.........#
###########
locked : 2

1
4
###########
#X........#
#.........#
#.........#
#.........#
#.........#
#.........#
#.........#
#.........#
#.........#
#####.#####

3
0
###########
##?#......#
##........#
##........#
#.........#
#....@.....
#...###...#
#...###...#
#.....#...#
#.........#
#####.#####
sign Beware what lurks ahead.

2
2
#####.#####
#k........#
#.........#
#####.....#
#.#.......#
....##.....
#..#......#
#.........#
#.........#
#.........#
#####.#####
key : 1

1
1
#####.#####
#.........#
#......#..#
#.......#.#
#.........#
#..........
#.........#
#....#....#
#.........#
#.........#
#####d#####

2
3
###########
##k#.....##
#.........#
#...#.#...#
#.........#
...#.#.#...
#.........#
#.......#.#
#.........#
##.....#.##
#####.#####
key : 3

3
5
###########
##.......##
#.........#
##.#......#
#.........#
.....#....#
#.........#
##.#...#.##
#........e#
##.#...#e##
###########
enemies 2

1
2
###########
##.....?ee#
#........s#
#...#...#e#
#.........#
...#.#.#..#
#.........#
#.#.#.#...#
#.........#
##.#...#..#
#####.#####
enemies 3
switch 0 : 0 1
sign What you seek is close.

4
1
#####.#####
#..#......#
#...#.....#
#...#.....#
#.###.....#
...........
#.##......#
#.#.#.....#
###.......#
#.........#
###########

