1
0
###########
#.........#
##.#.....##
#.........#
#.#.#.#...#
#.........l
#..#.#.#..#
#.........#
#.#...#...#
#.........#
#####.#####

1
2
###########
#........e#
#.........#
#.........#
#....#....#
......#...#
#.....#...#
#.........#
#.........#
#.........#
#####.#####
enemies 1
door 0 : 0

2
0
#####.#####
#e........#
#.........#
#.........#
#s........#
#e.........
#.....#...#
#...#.....#
#.........#
#.........#
#####.#####
enemies 2
switch 0 : 0

2
2
#####.#####
#.........#
#.........#
#.........#
#.........#
.........k#
#......#..#
#.#.......#
#..#......#
#.........#
#####.#####
key : 1

5
2
#####d#####
#.........#
#......#..#
#.......#.#
#.........#
#.........#
#.........#
#.........#
#.........#
#.........#
#####.#####

1
1
#####.#####
#.........#
#..#......#
#.#.......#
#.........#
l....#.....
#....#....#
#.....#.#.#
#......#..#
#.........#
#####d#####
locked : 1

4
3
#####.#####
#.........#
#.........#
#.........#
#.........#
..........d
#.........#
#.........#
#.........#
#.........#
###########

4
4
###########
#.........#
#.........#
#.........#
#.........#
d....e....#
#.........#
#.........#
#.........#
#.........#
#####.#####
boss
enemies 1

5
0
#####.#####
##.#...#..#
#.........#
##.#.#.#.##
#.........#
#......#..#
#.........#
##.#.#....#
#.........#
##.....#..#
###########

2
1
#####d#####
##.....#..#
#.........#
#.........#
#....#....#
...........
#.........#
##..#..#..#
#.........#
#.........#
#####.#####

0
1
###########
#k#.......#
#.........#
#.#.#.#...#
#.........#
#...#.....#
#.........#
#.#.#.....#
#.........#
#.#.....#.#
#####.#####
key : 2

6
2
#####.#####
#.........#
#.........#
#.........#
#..####...#
#....#....#
#....###..#
#..##..#..#
#.....##..#
#k........#
###########
key : 3

3
0
#####.#####
#.........#
#.........#
#.........#
#.........#
#..........
#.........#
#...#.....#
#.....#...#
#.........#
#####d#####

4
0
#####d#####
#.........#
#.........#
#.........#
#.........#
#....@....#
#.........#
#.........#
#.........#
#.........#
#####.#####

4
2
#####.#####
#.........#
#.........#
#.........#
#......#..#
#..........
#...#.....#
#.........#
#.........#
#.........#
#####d#####

5
4
#####.#####
##........#
#.......###
#.....#####
#....##...#
#......#..#
#....##...#
#.........#
#.........#
#X........#
###########

3
1
#####.#####
#k#.......#
#.........#
#..#.#.#.##
#.........#
....#.#...l
#.........#
#..#.#.#.##
#.........#
#.........#
###########
key : 0

3
2
#####.#####
#.........#
#..#...#..#
#.........#
#..#......#
l..........
#..#......#
#.........#
##.#.....##
#.........#
#####.#####
locked : 0

3
3
###########
#.......ee#
#........?#
##..#..#..#
#.........#
..........#
#.......#.#
#.........#
#.........#
##.....#..#
#####.#####
enemies 2
sign A locked path — look elsewhere first.

