2
6
#####.#####
#.........#
#.........#
##.....#..#
#.........#
d.........d
#.#..#....#
#.........#
#.........#
##.....#..#
###########

2
2
#####.#####
##.#......#
#.........#
#.#.#...#.#
#.........#
.....#.#..#
#.........#
#.#...#.#?#
#........e#
#......#e##
###########
enemies 2
sign Those who search shall find.

0
0
###########
#?........#
#.........#
#.........#
#.........#
#....@....#
#.........#
#.........#
#.........#
#.........#
#####.#####
sign What you seek is close.

0
4
###########
#.........#
#.........#
#.........#
#.........#
#.........d
#.........#
#.........#
#.........#
#........##
#####.#####

2
7
###########
#.........#
#.........#
#.........#
#.........#
d....e....#
#.........#
#.........#
#.........#
#.........#
#####.#####
boss
enemies 1

1
5
#####.#####
#.........#
#.........#
#.........#
#.#.......#
l..#......d
#.........#
##.##.....#
#.##......#
#.........#
#####.#####
locked : 1

1
1
###########
#......k..#
#......#..#
#.......#.#
#.........#
...........
#.........#
#.........#
#.........#
#.........#
#####.#####
key : 1

1
0
#####.#####
#......#..#
#.........#
#.........#
#..##.....#
#..##......
#...#.....#
####......#
###.......#
##k.......#
###########
key : 0

1
4
#####.#####
#.........#
#.........#
#....##...#
#....e##..#
.....##...l
#.........#
#.....##..#
#.........#
#.........#
#####.#####
enemies 1

2
4
#####.#####
#.........#
#.........#
#.........#
#.#.....#.#
#..........
#.........#
#.#..#....#
#.........#
#.........#
###########

3
7
#####.#####
#..#......#
#.##......#
#.###.#...#
#.#####...#
#.........#
#.........#
#.........#
#.........#
#X........#
###########

1
2
#####l#####
#.........#
#.........#
#.#..#....#
#.........#
..........l
#.........#
#.........#
#.........#
#k#.....#.#
#####.#####
key : 3

0
5
###########
#.........#
#..#......#
#.#.......#
#.........#
d.........#
#.........#
#.......#.#
#......#..#
#.........#
#####.#####

3
5
#####.#####
#.........#
#.....#...#
#....##...#
#.........#
#.........#
#...##....#
#.........#
#...#.#...#
#.........#
###########

2
5
#####.#####
#.........#
#.........#
#.........#
#.........#
..........d
#.........#
#.......#.#
#......#..#
#.........#
#####.#####

0
2
###########
#.........#
#.........#
#.........#
#.........#
#.........#
#.........#
#.......#.#
#......#..#
#.........#
#####l#####
locked : 3

1
6
###########
#.........#
#.....#...#
#......#..#
#....#.#..#
d.........#
#.........#
#.........#
#.........#
#.........#
#####.#####

1
3
###########
#......#..#
#.........#
##..#.#...#
#.#####...#
l.....##...
#.#####...#
#.####....#
#......#..#
#.........#
###########
locked : 0

2
1
#####.#####
#.........#
#.#...#.#.#
#.........#
#.#.#.#...#
#..........
#.#.#.#.#.#
#.........#
#.#.#.#.#.#
#k........#
###########
key : 2

