3
0
###########
#.......#?#
#.....#...#
#.....#####
#...@.##..#
#....##...#
#.##......#
#..##.....#
##.#......#
#.........#
#####D#####
sign A useful tool lies just ahead.

5
3
#####D#####
#..#.....##
#.........#
#.........#
#......#..#
D.........#
#.........#
#..#..#..##
#.........#
#.........#
#####D#####

6
2
#####l#####
#.........#
#..#......#
#.#.......#
#.........#
D.........D
#.........#
#.........#
#.........#
#.........#
#####D#####
locked : 3

5
1
#####l#####
##.#...#.##
#.........#
##...#...##
#.........#
D......#..D
#.........#
#....#.#.##
#.........#
#..#...#.##
#####D#####
locked : 1

2
2
#####d#####
#.........#
#.........#
#.........#
#.........#
#.........#
#.........#
#.........#
#.........#
#.........#
#####d#####

4
3
#####d#####
#.........#
#.........#
#.........#
#.........#
D.........D
#.........#
#.......#.#
#.........#
#.........#
#####D#####

6
1
#####D#####
#.........#
#.###.....#
#.........#
#.#.......#
#.........D
#.........#
#.........#
#.........#
#.........#
###########

0
2
###########
###......X#
###.#.....#
#...##....#
#.##.#....#
#.........#
#.........#
#.........#
#.........#
#.........#
#####D#####

4
1
###########
#.........#
#.........#
#.........#
#.#..#....#
D....#....D
#...##....#
#.#..#....#
##e#......#
#e........#
#####l#####
enemies 2

3
3
###########
#.......#.#
#.........#
#.........#
#.#.....#.#
D.........#
#.........#
#.#..#..#.#
#.........#
#.........#
#####d#####

4
2
#####D#####
#..#......#
#..##.##..#
#..k##....#
#..###....#
D.........D
#.........#
#.........#
#.........#
#.........#
#####d#####
key : 1

6
3
#####D#####
#.........#
#.....##..#
#....##...#
#.........#
D.........#
#.........#
#.........#
#.........#
#.........#
###########

4
0
#####D#####
#.........#
#..#...#k##
#.#.....#.#
#.........#
#.........D
#.........#
#.......#.#
#......#..#
##.#......#
#####l#####
key : 0

3
2
#####d#####
#.........#
#.........#
#.........#
#.#..#..#.#
#.........D
#.........#
#.#..#..#.#
#.........#
#.........#
#####D#####

5
0
#####l#####
#.#.....#.#
#.........#
#.#.#.#.#.#
#.........#
#...#.#...D
#.........#
#.......#.#
#.........#
#.#.....#.#
###########
locked : 0

4
4
###########
#..#.....k#
#.##......#
#.#.......#
#.........#
D.........#
#.........#
#......#..#
#.........#
#.........#
###########
key : 3

7
2
#####D#####
#.........#
#.........#
#...#.....#
#....##...#
#.....#...#
#.........#
#.........#
#.........#
#k........#
###########
key : 5

1
2
#####D#####
#.........#
#...#.#...#
#....#....#
#.###.....#
#..#.e....#
#.####....#
##..#.....#
#...#.#...#
#.........#
#####d#####
boss
enemies 1

5
2
#####d#####
#.........#
#..#..#..##
#.........#
#.........#
D...#..#..D
#.........#
#.........#
#..#..#...#
#.........#
#####l#####

