4
2
###########
#.........#
##.#...#.##
#.........#
#.#...#...#
l.........l
#..#...#..#
#.........#
#.#.#.#.#.#
#.........#
#####.#####
locked : 0

0
0
###########
#.........#
##........#
#.........#
#.........#
#.........#
#.........#
#.#.......#
#..#......#
#.........#
#####.#####

1
0
#####.#####
#.........#
#.........#
#....##...#
#...#e....#
#e..e##...#
#.........#
#.........#
#.........#
#.........#
#####.#####
enemies 3

2
5
###########
#X........#
#.........#
#.........#
#.........#
#.........#
#.........#
#.........#
#.........#
#.........#
#####.#####

3
0
#####.#####
#.........#
#.........#
#.........#
#.........#
#..........
#.........#
#k#.......#
#.........#
#........##
#####.#####
key : 0

5
2
#####.#####
#.#.....#.#
#.........#
#..#.#...##
#.........#
....#.#....
#.........#
#....#.#..#
#.........#
#.#.....#.#
###########

2
0
#####.#####
#.........#
#......#..#
#.......#.#
#.........#
#k........d
#.........#
#.......#.#
#......#..#
#.........#
#####.#####
key : 2

5
3
#####.#####
#.........#
#..#......#
#.#.......#
#.........#
..........#
#.........#
#.#.......#
#..#......#
#.........#
###########

4
1
#####.#####
#.........#
#.#.....#.#
#.........#
#.........#
...#..#...l
#.........#
#.........#
#.#.....#.#
#.........#
#####l#####

5
1
#####l#####
#.........#
#.........#
#.........#
#.#.....#.#
#..........
#.........#
#.#..#..#.#
#.........#
#.........#
###########
locked : 1

3
1
#####.#####
#.........#
#.........#
#....#....#
#.........#
..........#
#....#..#.#
#.........#
#.........#
#k#.......#
#####.#####
key : 1

3
3
###########
#k........#
#.....#...#
#...###...#
#.........#
#.........#
#.........#
#.........#
#.........#
#.........#
#####.#####
key : 3

4
6
###########
#.........#
#.........#
#.........#
#.........#
d.........#
#.........#
#.......#.#
#......#..#
#.........#
###########

2
1
###########
#.........#
#.........#
#.........#
#.........#
d.........#
#.........#
#.........#
#.........#
#.........#
#####.#####

4
3
#####.#####
#.........#
#.........#
#..#..#..##
#.........#
l..........
#...#.....#
#.........#
#.........#
#..#......#
#####.#####
locked : 2

4
4
###########
#.........#
#.........#
#.#..#..#.#
#.........#
..........d
#..#......#
#.........#
#.........#
#.......#e#
###########
enemies 1

4
5
#####l#####
##.....#..#
#.........#
#.........#
#.#..#..#.#
d.........d
#.........#
#...#..#..#
#.........#
#.........#
###########

4
0
#####.#####
#.........#
#.....###.#
#.....###.#
#.......#.#
#....@.....
#.........#
#.........#
#.........#
#?........#
###########
sign What you seek is close.

3
5
#####.#####
#.........#
#.........#
#.........#
#.........#
#....e....#
#.........#
#.........#
#.........#
#.........#
#####l#####
locked : 3
boss
enemies 1

