2
4
#####.#####
#.........#
#.........#
#.........#
#.........#
d.........#
#.........#
#.........#
#.........#
#.........#
#####.#####

1
4
###########
#........k#
#.........#
#.........#
#..##.....#
...####...#
#..#..#...#
#.....#...#
#..##.....#
#.........#
#####.#####
key : 3

4
4
#####.#####
#.......#.#
#.........#
#.........#
#.........#
..........#
#.........#
#...#.....#
#.........#
#........X#
###########

4
1
#####d#####
#k........#
#..#...#..#
#.#.....#.#
#.........#
...........
#.........#
#.........#
#.........#
#.........#
#####.#####
key : 0

2
2
#####l#####
#.........#
#..#...#..#
#.......#.#
#.........#
#..........
#.........#
#.........#
#.........#
#.........#
#####l#####
locked : 1

5
1
#####.#####
#e........#
#.........#
#.........#
#s........#
#e.........
#.........#
#.........#
#.........#
#.........#
#####.#####
enemies 2
switch 0 : 0 1

1
3
#####l#####
#e........#
#.........#
#.........#
#.........#
...........
#.........#
#.....#...#
#.......#.#
#?........#
#####.#####
enemies 1
door 0 : 0 1
sign Seek the matching key before you proceed.

4
3
#####.#####
#.........#
#.##...#..#
#.#.....#.#
#.........#
d....#.....
#.........#
#.........#
#.#.......#
#.........#
###########

4
0
###########
#?##......#
#.###.....#
#.##......#
#.#.......#
#....@.....
#.........#
#.........#
#.........#
#.........#
###########
sign A useful tool lies just ahead.

5
2
#####.#####
#.........#
#.#.#.#.#.#
#.........#
#.#.#.#.#.#
..........#
#...#.#.#.#
#.........#
#.#.#.#.#.#
#.........#
###########

3
4
#####.#####
#.........#
#.........#
#.........#
#..##.....#
d..##e....#
#.###.....#
###.#.....#
#...#.....#
##........#
#####.#####
boss
enemies 1

4
2
#####.#####
#.........#
#.........#
##.....#..#
#.........#
..........d
#.#..#....#
#.........#
#.........#
##.....#..#
#####.#####

3
2
#####l#####
#.........#
#.........#
#.#.....#.#
#.........#
...........
#.#.....#.#
#.........#
#.........#
#k#.....#.#
#####.#####
key : 1

1
2
###########
#.........#
#.#...#.#.#
#.........#
#..#.#....#
#..........
#.#.#.#.#.#
#.........#
#..#.....##
#.........#
#####l#####
locked : 2

2
3
#####.#####
#k.....#..#
#...#.##..#
#....##...#
#.........#
......##..d
#.........#
#.........#
#.........#
#.........#
#####.#####
key : 2

3
3
#####.#####
#.........#
#.#.#.#.#.#
#.........#
#....#.#..#
..........d
#.#.#.#...#
#.........#
#..#...#.##
#.........#
#####.#####

6
1
#####.#####
##.....#..#
#.........#
#...#.#...#
#.........#
#..#.#.#..#
#.........#
#.#.#.#...#
#.........#
##.....#.##
###########

0
3
###########
#.........#
#.........#
#.........#
#.........#
#....#.#..#
#....#....#
#....#...##
#......####
#......####
#####l#####
locked : 3

3
1
###########
#.........#
#.........#
#.##......#
#..##.#...#
#..###.....
#....##...#
#.........#
#.........#
#.........#
#####d#####

