7
2
#####.#####
#.........#
#.........#
#.........#
#......#..#
#.........#
#.........#
#.........#
#.........#
#X........#
###########

6
0
#####d#####
#.........#
#..#.....##
#.#.......#
#.........#
#...#......
#.........#
#.#.......#
#..#......#
#.........#
#####.#####

2
0
###########
#.........#
#......#..#
#.......#.#
#.........#
#..........
#.........#
#.......#.#
#......#..#
#.........#
#####.#####

4
1
#####.#####
#.........#
#.........#
#.........#
#.........#
...........
#.........#
#.........#
#.........#
#.........#
#####.#####

5
0
#####.#####
#......#..#
#.........#
#...###...#
#.##..###.#
#...#.#....
#.#.#.....#
#.........#
#...#.....#
#.........#
#####d#####

3
2
#####.#####
##.#...#.##
#.........#
#.#...#.#.#
#.........#
d....#.#..#
#.........#
#.#.#...#.#
#.........#
##.#...#.##
#####.#####

6
1
#####.#####
#.........#
#..#......#
#.........#
#.........#
....#......
#.........#
#.........#
#.....#..##
#.....e...#
###########
enemies 1

6
2
#####l#####
#.........#
#.#.#.#...#
#.#e......#
#...####..#
....###...#
#.#.###...#
#.........#
#.........#
#.........#
#####.#####
locked : 4
boss
enemies 1

0
1
###########
#e.......?#
#.........#
#.........#
#.###.....#
#..#......#
#..##.....#
####......#
##.#......#
#.........#
#####.#####
enemies 1
door 0 : 0 1
sign What you seek is close.

4
2
#####.#####
#.........#
#.........#
#.........#
#.........#
.........k#
#.........#
#.#.......#
#..#......#
#.........#
#####.#####
key : 4

5
1
#####.#####
#........k#
#...#....##
#.........#
#.........#
..........d
#.........#
#.......#.#
#......#..#
#..#......#
#####.#####
key : 1

3
0
#####.#####
#......#..#
#...#.#...#
#...###.#.#
#.......#.#
#?...@.#..l
#.........#
#.........#
#.........#
#.........#
#####.#####
sign A locked path — look elsewhere first.

3
1
#####d#####
#.#.....#.#
#.........#
#.#...#.#.#
#.........#
l...#.#...d
#.........#
#.....#.#.#
#.........#
#.......#.#
#####.#####
locked : 0

2
1
#####.#####
#.........#
#.........#
#.........#
#.........#
...........
#.........#
#.........#
#.........#
#.........#
#####d#####

5
2
#####.#####
#.........#
#.........#
#.........#
#.........#
d.........#
#.........#
#.#.....#.#
#..#...#..#
#.........#
#####l#####

7
0
#####.#####
#.........#
#.........#
#.........#
#.........#
#.........#
#......##.#
#......##.#
#.....##..#
#e.....?.s#
###########
enemies 1
switch 0 : 0 1
sign Beware what lurks ahead.

1
1
#####.#####
#k........#
##.#.....##
#.........#
#..#...#..#
#.........#
#..#.#.#..#
#.........#
#..#...#.##
#.........#
#####.#####
key : 2

4
0
#####.#####
#.........#
#.........#
#.#..#....#
#.........#
#..........
#..#..#...#
#.........#
#.........#
#k#.....#.#
#####.#####
key : 0

2
2
###########
#.........#
#.........#
#.........#
#..#......#
..........#
#.#.......#
#.........#
#.........#
#.........#
#####.#####

