1
3
###########
#..#......#
#...#.....#
#.###.....#
#.####....#
D..#......#
#.........#
#.........#
#.........#
#.........#
#####l#####
locked : 2

3
1
#####D#####
##.....#..#
#.........#
#.#.....#.#
#.........#
d....#.#..#
#.........#
#.#.#.....#
#.........#
##.#.....##
#####D#####

3
3
#####D#####
#.........#
#..##.....#
#..#......#
#.........#
#.........d
#.........#
#.........#
#.........#
#k........#
###########
key : 2

2
3
#####l#####
#.........#
#.........#
#.........#
#.........#
D.........D
#.........#
#.......#.#
#......#..#
#.........#
#####D#####

4
1
#####D#####
#.........#
#.........#
#.#..#..#.#
#.........#
D.........#
#..#......#
#.........#
#.........#
#........k#
###########
key : 0

1
1
#####d#####
#e........#
#.......#.#
#.........#
#?........#
#e...#....D
#.........#
#.........#
#e#.......#
#.........#
#####D#####
enemies 3
sign Many have walked this path.

5
0
#####D#####
#.........#
#..#.....##
#.........#
#.........#
#..#......#
#.........#
#.........#
#.....#...#
#.........#
###########

2
0
###########
#.........#
#.........#
##..#.....#
#.........#
#.........D
#....#....#
#.........#
#.........#
##.....#..#
#####l#####
locked : 0

2
1
#####D#####
#.........#
#.........#
#.#..#..#.#
#.........#
D.........D
#..#..#...#
#.........#
#.........#
#.#.....#.#
#####D#####

1
2
#####D#####
#.#.....#.#
#.........#
#.#.#...#.#
#.........#
D.....#...D
#.........#
#.#.#.#.#.#
#.........#
#.......#.#
#####d#####

2
4
###########
#.......ee#
#........e#
#.........#
#.........#
D.........#
#.........#
#.........#
#.........#
#.........#
#####D#####
enemies 3

0
2
###########
#.........#
#..#......#
#.#.......#
#.........#
D.........#
#.........#
#.........#
#.........#
#.........#
#####D#####

3
0
#####l#####
##.....#..#
#.........#
#.........#
#.#..#..#.#
#.........d
#.........#
#...#..#..#
#.........#
#.........#
#####D#####

2
2
#####d#####
#.........#
#.........#
#.........#
#.........#
D.........D
#.........#
#.......#.#
#......#..#
#.....k#..#
###########
key : 1

4
0
#####D#####
#.#.......#
#.###.....#
#..###....#
#....##...#
#...#@....D
#.........#
#.........#
#.........#
#.......#.#
#####D#####

0
1
###########
#........##
#.....###.#
#.......#.#
#......#..#
#..#.###..D
#.#.......#
#.........#
#.........#
#.........#
#####d#####

3
5
###########
#........X#
#.........#
#.........#
#.........#
D.........#
#.........#
#.##......#
##........#
#.........#
###########

4
4
#####D#####
##.#...#.##
#.........#
##.....#.##
#.........#
#..#...#..#
#.........#
##.#.#.#.##
#k........#
##.....#.##
###########
key : 4

3
4
#####D#####
#......##.#
#......##.#
#.....###.#
#.........#
d....e....D
#...#.....#
#.#.......#
#.#.#.....#
#.........#
#####D#####
boss
enemies 1

