2
4
#####l#####
#.........#
#..#......#
#.#.......#
#.........#
d.........d
#.........#
#.#.......#
#..#......#
#.........#
#####.#####

4
1
#####.#####
##k#...#.##
#.........#
#.#.#...#.#
#.........#
...#.#.#...
#.........#
#.#.#.#...#
#.........#
#......#.##
#####.#####
key : 0

3
5
#####.#####
#.........#
#.........#
#.##.#....#
#.#.#.#...#
l...#.....#
#...#.#.#.#
#.#..##...#
#.........#
#.........#
###########
locked : 4

4
3
#####.#####
#.........#
#.........#
#.........#
#.........#
l..........
#.........#
#.......#.#
#......#..#
#.........#
#####.#####
locked : 0

3
4
#####.#####
#.........#
#......#..#
#.......#.#
#.........#
..........l
#.........#
#.........#
#.........#
#.........#
#####.#####

1
4
#####.#####
#.........#
###.......#
##.#......#
#...e.....#
#....###..#
#....##...#
#....##...#
#.........#
#.........#
#####l#####
locked : 1
boss
enemies 1

5
3
#####.#####
#e........#
#.........#
#.........#
#.........#
.........e#
#.........#
#.........#
#.........#
#.........#
#####d#####
enemies 2

4
2
#####d#####
#.........#
#.........#
#.........#
#.........#
..........l
#.........#
#.........#
#.........#
#.........#
#####.#####

4
4
#####.#####
#.........#
#.........#
#.........#
#.........#
..........#
#.........#
#.......#.#
#......#..#
#........k#
###########
key : 1

3
3
#####.#####
#........k#
#..#..#..##
#.........#
#.........#
....#..#...
#.........#
#.........#
#..#......#
#.........#
#####.#####
key : 2

2
5
###########
##........#
##.#......#
###.#.....#
#....#....#
d..###....#
#.........#
#.........#
#.........#
#.........#
#####.#####

0
4
###########
#X........#
#...#.###.#
#...#.#.#.#
#...##..#.#
#...#.....#
#......#..#
#.........#
#.........#
#.........#
#####.#####

5
1
#####.#####
#.........#
#.#.#.#.#.#
#.........#
#...#.#.#.#
#..........
#.#.#.#.#.#
#.........#
#.#.#.#.#.#
#.........#
###########

5
2
#####.#####
#.........#
##.#.....##
#.........#
#..#.#....#
...........
#..#.#.#..#
#.........#
##.#...#.##
#.........#
###########

2
3
###########
#k........#
#.........#
#.........#
#.........#
#.........d
#.........#
#.........#
#.........#
#.........#
#####.#####
key : 4

6
3
#####d#####
#.........#
#.#.......#
#.........#
#.........#
#....#....#
#.........#
#.........#
#.......#.#
#.........#
###########

3
2
###########
#.........#
#.....#.#.#
#.........#
#..#.#.#..#
...........
#.......#.#
#.........#
#..#...#.##
#.........#
#####d#####

3
1
###########
#ee....#..#
#e........#
#?....##..#
#...###...#
#..........
#.........#
#.........#
#.........#
#.........#
#####.#####
enemies 3
sign Those who search shall find.

4
0
###########
#?........#
#..#......#
#.........#
#.........#
#....@.....
#..###....#
#..###....#
#..##.....#
#.........#
###########
sign Something glints behind that door…

