2
1
#####D#####
#.........#
#.........#
#..##.....#
#.###.....#
D..##.....D
#.#.#.....#
#.#.......#
#.........#
#.........#
#####D#####

4
3
#####D#####
#.........#
#.........#
#.........#
#.........#
#.........#
#.........#
#.........#
#.........#
#.........#
###########

0
1
###########
#.........#
#.........#
#.........#
#.........#
#.........#
#.........#
#.........#
#.........#
#.........#
#####d#####

2
0
#####D#####
#.........#
#.........#
#.........#
#.........#
#k........D
#...#.....#
#.........#
#.###.....#
#.........#
#####D#####
key : 0

3
0
#####D#####
#.........#
#......#..#
#.....##..#
#.........#
#.........D
#.........#
#.........#
#e........#
#ee.......#
###########
enemies 3

3
3
#####l#####
#......#..#
#.........#
#.........#
#...#..#..#
D.........D
#.........#
#......#..#
#.........#
#.........#
#####D#####
locked : 2

5
5
#####D#####
#..#......#
#.........#
#.........#
#.........#
#..##.....#
#..##.#...#
##.###....#
##.#......#
#X........#
###########

2
2
#####l#####
#.#.....#.#
#.........#
#..#...#.##
#.........#
D.....#...D
#.........#
#..#.#.#.##
#.........#
#.......#.#
#####l#####

3
5
#####D#####
#.........#
#..#...#..#
#.........#
#.#.#.#.#.#
d.........#
#..#...#..#
#.........#
#.#.#...#.#
#.........#
#####d#####

2
3
#####d#####
#......#..#
#...#.....#
#.....###.#
#....####k#
D.........#
#.........#
#.........#
#.........#
#.........#
#####l#####
key : 3

3
4
###########
#.........#
#...#.....#
#.........#
#.........#
D....#....d
#.........#
#.........#
##..#..#..#
#.........#
###########

1
2
###########
#.........#
#.........#
#.........#
#.........#
D.........D
#.........#
#.........#
#.........#
#.........#
#####l#####
locked : 3

3
1
#####D#####
#..#.....k#
#..#.....##
#..#....#.#
#.........#
D.........D
#.........#
#.........#
#.........#
#.........#
###########
key : 1

4
5
#####d#####
#.........#
#.........#
#....##...#
#...e#....#
#....#....#
#.........#
#.........#
#.........#
#.........#
#####D#####
boss
enemies 1

3
2
#####l#####
#......#.##
#......#.##
#....#...##
#.....##..#
D.........D
#.........#
#.........#
#.........#
#.........#
###########
locked : 0

1
0
###########
#.........#
#.........#
#.........#
#.........#
#....@....D
#.........#
#.........#
#.........#
#.........#
#####D#####

2
5
###########
#e.......e#
#e........#
#.........#
#.........#
#.........#
#.........#
#.....#...#
#.........#
#.........#
#####D#####
enemies 3

1
3
###########
#.........#
#.#...#.#.#
#.........#
#..#.#.#..#
D.........#
#.....#.#.#
#.........#
#..#...#.##
#.........#
#####d#####

1
1
#####d#####
#k........#
#.........#
#.........#
#.........#
D.........D
#.........#
#....##...#
#.........#
#.........#
#####D#####
key : 2

