6
0
#####.#####
#.........#
#...#.#.#.#
#.........#
#....#.#..#
#..........
#.#.#.#...#
#.........#
#..#......#
#.........#
###########

5
1
#####.#####
#.........#
#.........#
#.........#
#.#.#.#...#
...........
#....#.#..#
#.........#
#.#.#.#.#.#
#.........#
#####.#####

3
1
#####.#####
#.........#
#.........#
#.........#
#.........#
d.........l
#.........#
#.........#
#.....#...#
#.........#
#####.#####

1
1
#####.#####
#.........#
#.........#
#.........#
#...#.....#
#..##e....#
#..#......#
###.......#
#.........#
#.........#
#####d#####
boss
enemies 1

4
0
#####l#####
#.........#
#.........#
#.........#
#.........#
#k.........
#......##.#
#.....##..#
#.....#...#
#.........#
#####.#####
key : 0

3
2
###########
#.........#
#......#..#
#.......#.#
#.........#
l.........#
#.........#
#.#.......#
#..#......#
#.........#
###########
locked : 3

5
3
###########
#.......ee#
#.........#
#.........#
#.........#
..........#
#.........#
#.........#
#.........#
#.........#
#####.#####
enemies 2

8
1
#####d#####
#.#.....#.#
#.........#
#.#.#.#.#.#
#.........#
#...#.#...#
#.........#
#.#...#.#.#
#.........#
#.#.....#.#
###########

3
0
###########
#.........#
#.........#
#.........#
#....#.#..#
#..#.#....d
#..#.##...#
#...#..#..#
#..##.....#
#.........#
#####l#####
locked : 0

4
1
#####.#####
#e........#
#.........#
#..##.....#
#..#......#
.........e#
#.........#
#.........#
#.........#
#e........#
#####.#####
enemies 3

6
3
#####.#####
#.........#
#.....#...#
#.....###.#
#..#.###..#
d...#.....#
#.####....#
###.#.....#
#.#.#.....#
#.........#
###########

2
1
#####d#####
#..#......#
#...#.....#
#...###...#
#..##e....#
#?.e###...#
#e#.......#
#..#......#
#.........#
#.........#
#####.#####
enemies 3
sign Beware what lurks ahead.

7
2
#####.#####
#.........#
#.........#
###..#....#
#.##......#
...#......#
#.........#
#.#.##....#
#.........#
#.........#
###########

6
2
#####.#####
#k........#
##.....#.##
#.........#
#.#.#.#.#.#
..........d
#..#.#.#..#
#.........#
#.#.......#
#.........#
#####.#####
key : 2

5
0
#####.#####
#.........#
#.........#
#.........#
#.........#
#....@.....
#.........#
#.........#
#.........#
#.........#
#####.#####

6
1
#####.#####
#k........#
#......#..#
#.......#.#
#.........#
...........
#.........#
#.......#.#
#......#..#
#.........#
#####.#####
key : 1

5
2
###########
#.#.......#
#.........#
#.........#
#.#..#..#.#
...........
#.........#
#.#..#....#
#.........#
#.........#
#####.#####

7
1
#####.#####
#.........#
#.........#
#.........#
#.........#
#k.........
#.........#
#.........#
#.........#
#.........#
#####d#####
key : 3

0
1
###########
#......##X#
#...#.#...#
#.....#.#.#
#.###..##.#
#..##.....#
#...#.....#
#.........#
#.........#
#.........#
#####.#####

