5
1
#####D#####
#.........#
#.........#
#.........#
#.........#
D.........D
#.........#
#.........#
#.........#
#.........#
###########

6
2
#####l#####
#.........#
#...#.....#
#...#.....#
#.##e.....#
#...##....#
#.........#
#..##...p.#
#.........#
#.........#
#####D#####
locked : 3
boss
enemies 1

0
1
###########
#k.#......#
#......#..#
#.......#.#
#.........#
#.........#
#.........#
#.......###
#......#..#
#..#......#
#####D#####
key : 2

2
1
#####d#####
#k........#
##..#..#..#
#.........#
#.........#
D....#....D
#.........#
#.........#
##........#
#.........#
#####D#####
key : 1

4
0
#####D#####
#.........#
#.........#
###.#.....#
#?##@#....#
#....#....d
#...#.....#
##..##....#
#.........#
#.........#
#####D#####
sign Many have walked this path.

1
1
#####D#####
#.........#
#.........#
#..#..#..##
#.........#
#.........#
#...#.....#
#.........#
#.........#
#........##
#####d#####

2
2
###########
#......?ee#
#........e#
#.........#
#.........#
D.........#
#.........#
#.........#
#.........#
#.........#
#####D#####
enemies 3
door 0 : 0
sign Something glints behind that door…

3
1
#####D#####
#e.......e#
#.........#
#.........#
#.........#
D.........D
#.........#
#.........#
#.........#
#e......?s#
#####D#####
enemies 3
switch 0 : 0
sign Those who search shall find.

3
2
#####D#####
##.....#.##
#.........#
#.#...#...#
#.........#
D..#...#..d
#.........#
#.#.#.#.#.#
#.........#
#......#.##
#####l#####

6
0
#####D#####
#.........#
#.........#
#.........#
#.........#
#.........#
#.........#
#........p#
#.........#
#k........#
###########
key : 0

5
0
#####D#####
#.........#
#.........#
#.........#
#..#.#....#
#..#.#....D
#.###.....#
####......#
#.##......#
#........##
#####D#####

4
2
#####l#####
#.........#
#.........#
#.........#
#.........#
D.........d
#.........#
#.#.....#.#
#..#...#..#
#.........#
#####D#####
locked : 1

3
3
###########
#.........#
#.....#..##
#.........#
#.........#
d...#..#..#
#.........#
#.........#
#..#..#..##
#.........#
#####D#####

3
0
#####l#####
#.........#
#.........#
#.........#
#.........#
#.........D
#......#..#
#.........#
#......#..#
#.........#
#####D#####

2
0
###########
#.........#
#......#..#
#.......#.#
#.........#
#.........D
#.........#
#.........#
#.........#
#.........#
#####l#####
locked : 0

4
1
#####D#####
#.........#
#.........#
#.....#...#
#.........#
d.........D
#.........#
#.........#
#.........#
#.........#
#####D#####

4
3
#####D#####
#.........#
#.........#
#......#..#
#...##....#
d...##....#
#.....#...#
#.........#
#.........#
#.........#
###########

5
2
#####D#####
#........k#
#..#..#..##
#.........#
#.........#
D...#..#..#
#.........#
#.........#
#..#..#...#
#.........#
#####l#####
key : 3

7
2
#####D#####
#.........#
#.....#.#.#
#...#.....#
#......##.#
#.........#
#.........#
#.........#
#.........#
#X........#
###########

