0
0
###########
#.........#
#.........#
#.........#
#.........#
#..........
#.........#
#.........#
#.........#
#.........#
#####.#####

1
4
###########
#.........#
#.........#
#.#.......#
#.........#
d..##.....#
#...#.....#
##.##.....#
#.........#
#.........#
###########

2
2
#####.#####
#.........#
#.........#
#.........#
#...#.#...#
....##.....
#..###....#
#...##....#
#.........#
#.........#
#####.#####

3
3
#####.#####
#........##
#.........#
#.........#
#.........#
..........#
#.........#
#.......#.#
#...#..#..#
#k#.......#
#####.#####
key : 10

0
1
###########
#e..se....#
#.........#
#.........#
#.........#
...........
#.........#
#.........#
#.........#
#e........#
#####.#####
enemies 3
switch 0 : 0

4
2
#####d#####
#.........#
#.........#
#....##.#.#
#...#.#...#
#...#e.....
#....####.#
#.......#.#
#.........#
#.........#
#####.#####
boss
enemies 1

2
1
#####.#####
#.........#
#.#.#.#.#.#
#.........#
#.#.#...#.#
...........
#.#.#.....#
#.........#
#.#.#.#.#.#
#.........#
###########

1
3
#####.#####
#........e#
#..#..#..##
#.........#
#.........#
....#..#..d
#.........#
#.........#
#..#..#..##
#........?#
#####.#####
enemies 1
sign Something glints behind that door…

0
3
###########
#........k#
#.........#
#...##....#
#..##..#..#
...##.....#
#.........#
#.........#
#......#..#
#.........#
#####.#####
key : 4

2
3
#####.#####
#k#.......#
#..##.....#
#..####...#
#.##.##...#
..........#
#.....#...#
#.........#
#.........#
#.........#
#####.#####
key : 3

0
2
###########
#e..?e....#
#.........#
#..#.....##
#.........#
...........
#.....#...#
#.........#
#.........#
#e.#.....##
#####.#####
enemies 3
door 0 : 0
sign Something glints behind that door…

3
0
#####d#####
#......#..#
#..#......#
#.#.......#
#.........#
#.........#
#.........#
#.#.....#.#
#..#...#..#
#.........#
###########

3
2
#####.#####
#.........#
#.#.#.#.#.#
#.........#
#...#...#.#
#..........
#k#.#.....#
#.........#
#...#.#.#.#
#.........#
#####d#####
key : 6

1
2
#####.#####
#.........#
#.........#
#.........#
#.........#
d..........
#.........#
#.........#
#.........#
#.........#
#####.#####

1
0
#####.#####
#.........#
#.........#
#.........#
#.........#
#....@.....
#.........#
#.........#
#.........#
#.........#
#####.#####

2
0
#####.#####
#.........#
#####.....#
###.#.....#
#.........#
#..........
#.........#
#.........#
#.........#
#.......#.#
#####d#####

4
3
#####.#####
#.#.....#.#
#.........#
#.#.#.#.#.#
#.........#
....#.#...#
#.........#
#.#.#...#.#
#.........#
#.#.....#.#
###########

1
1
#####.#####
#.........#
#.........#
#.........#
#.........#
..........d
#.........#
#.#.......#
#..#......#
#.........#
#####.#####

5
2
#####.#####
#.........#
#.........#
###.......#
#.........#
#..##.#...#
#.##..#...#
#.#.......#
#.##..#...#
#X........#
###########

