4
3
#####d#####
#.........#
#..#...#..#
#.#.....#.#
#.#.......#
#..##.....#
#.........#
#.........#
#.........#
#.........#
###########

1
1
#####l#####
#.........#
#..#..##..#
#.#.....#.#
#.........#
#.........D
#.........#
#.........#
#.........#
#..#......#
#####D#####

2
1
#####D#####
#k#.....#.#
#.........#
#.#...#...#
#.........#
D...#.#...D
#.........#
#.#.#.#.#.#
#.........#
#.........#
###########
key : 0

2
3
#####l#####
#.........#
#.........#
#.#..#....#
#.........#
D.........D
#.........#
#.........#
#.........#
#.#.....#.#
#####D#####

0
4
###########
#.........#
#..#..#..##
#.........#
#.........#
#..#..#...#
#.........#
#.........#
#.....#..##
#.........#
#####D#####

3
3
#####D#####
#k........#
#......#..#
#.......#.#
#.........#
D.........d
#.........#
#.........#
#.........#
#.........#
#####d#####
key : 2

1
4
#####D#####
#.........#
#.........#
#.........#
#.........#
D.........d
#.........#
#.........#
#.........#
#.........#
#####l#####
locked : 0

3
4
#####D#####
#.........#
#.........#
#...#..#..#
#.........#
d.........D
#...#..#..#
#.........#
#.........#
#......#..#
###########

2
0
###########
#.........#
#.........#
#...#.....#
#..##.....#
#...#@....D
#.........#
#.........#
#.........#
#.........#
###########

2
4
#####l#####
#.........#
#.........#
#...###...#
#..###k#..#
D....#....D
#..###.#..#
#.####....#
#.........#
#.........#
#####D#####
key : 3

2
5
#####l#####
#......#.##
#......#.##
#......#..#
#.....#.#.#
D....e#...#
#.....##..#
#.......#.#
#..p..#...#
#.........#
#####D#####
locked : 3
boss
enemies 1

1
6
###########
#.#.......#
#.........#
#.#.......#
#.........#
D.....#...#
#.........#
#.#.#.....#
#.........#
#.#.....#.#
###########

1
2
###########
#k#.......#
#...#.....#
#.#.#..#..#
#.#...###.#
D..##.....D
#....#.#..#
#....####.#
#.........#
#.........#
#####D#####
key : 1

0
1
###########
#.........#
#.......#.#
#.........#
#.......#.#
#.........#
#.......#.#
#.......#.#
#......#..#
#.........#
#####l#####
locked : 1

3
5
#####D#####
#.........#
#.........#
#.........#
#.........#
D.........#
#.........#
#.........#
#.........#
#........X#
###########

1
5
###########
#.........#
#.........#
##..#..#..#
#.........#
d.........D
#.#..#....#
#.........#
#.........#
##........#
#####l#####

1
3
###########
#.........#
#...#.#.#.#
#.........#
#.#...#.#.#
D.........D
#.#.#.#...#
#.........#
#...#...#.#
#.........#
#####l#####
locked : 2

3
2
#####d#####
#.........#
#.........#
#.........#
#.........#
#.........D
#.........#
#.#.......#
#..#......#
#.........#
###########

2
2
#####D#####
#.........#
#..#......#
###.......#
#.........#
D.........D
#.........#
#.#.......#
#..#......#
#......#..#
#####d#####

