1
4
###########
#.........#
#..#......#
#.#.......#
#.........#
...........
#.........#
#.......#.#
#......#..#
#.........#
###########

1
1
#####.#####
##.......##
#.........#
##.#.#...##
#.........#
#..#.#.#...
#.........#
##.......##
#.........#
##.#...#.##
#####.#####

1
6
#####.#####
#.........#
#.........#
#.........#
#.........#
d....e....#
#.........#
#.........#
#.........#
#.........#
#####.#####
boss
enemies 1

2
0
###########
#?........#
#.........#
#.........#
#.........#
#....@.....
#.........#
#.........#
#.........#
#.........#
###########
sign The dungeon remembers all who enter.

0
3
###########
#.........#
#.........#
#.###.....#
#..#......#
....#.....#
#.........#
#.....#...#
#.....#.#.#
##........#
#####d#####

2
1
#####.#####
#.........#
#......#..#
#.......#.#
#.#.......#
..........d
#.........#
#.#.......#
#..#......#
#.........#
#####.#####

1
5
#####l#####
#.........#
#.......#.#
#.....#.###
#....#k##.#
..........d
#......##.#
#.........#
#.........#
#.........#
#####d#####
key : 4

2
5
#####d#####
#.........#
#..#......#
#.#.......#
#.........#
#..........
#.........#
#.......#.#
#......#..#
#.........#
###########

0
6
###########
#........X#
#.........#
#.........#
#...#.....#
...###....#
#.#.#.....#
##...#....#
##........#
####......#
#####.#####

0
2
###########
#.........#
#.........#
#.........#
#.........#
...........
#.........#
#.........#
#.........#
#.........#
#####.#####

0
1
###########
#ee?......#
#e........#
#s........#
#.........#
#..#####...
#...#.....#
#...#..#..#
#.....#...#
#..#...#..#
#####.#####
enemies 3
switch 0 : 0 1
sign Many have walked this path.

2
2
#####.#####
#.........#
##..#..#..#
#.........#
#.........#
d......#..#
#.........#
#.........#
##..#..#..#
#.........#
#####.#####

3
1
#####.#####
##........#
#...#.....#
#...#...#.#
#.....###.#
#....##....
#...#.....#
#.........#
#.........#
#.........#
#####.#####

1
3
#####d#####
#k........#
##.#......#
#.........#
#..#.#.#..#
...........
#..#.#.#..#
#.........#
##.#...#.##
#.........#
###########
key : 1

2
6
#####.#####
#.........#
#......#..#
#.......#.#
#.........#
..........#
#.........#
#.#.....#.#
#..#...#..#
#........k#
###########
key : 6

1
2
#####.#####
#k#.......#
#..#......#
#.#......##
#.........#
...........
#.........#
#.......#.#
#......#..#
#.........#
#####.#####
key : 0

0
5
###########
#.........#
#......#..#
#.......#.#
#.........#
#..........
#.........#
#.......#.#
#......#..#
#.........#
#####l#####
locked : 4

3
2
#####.#####
#.........#
#.........#
#.........#
#.........#
..........#
#.........#
#.........#
#........e#
#......?ee#
###########
enemies 3
door 0 : 0 1
sign The dungeon remembers all who enter.

4
1
#####.#####
##.#...#..#
#.........#
##.#.....##
#.........#
#....#....#
#.........#
#..#.#.#.##
#.........#
##e#...#..#
###########
enemies 1

