2
0
#####.#####
#.........#
#.........#
#.........#
#.........#
#....@.....
#.........#
#.........#
#.........#
#?........#
###########
sign The brave are rewarded.

3
3
###########
##.#...#.##
#.........#
##...#.#.##
#.........#
l..#.#.#..#
#.........#
##.#.#.#..#
#.........#
#..#.....##
###########
locked : 2

3
1
#####l#####
##.#...#..#
#.........#
##.#.#.#.##
#.........#
#..#.#.#..l
#.........#
##.#.#.#.##
#.........#
##.....#.##
#####.#####
locked : 1

7
2
#####.#####
#.........#
#.........#
#.........#
#.....#...#
#....###..#
#....####.#
#......#.##
#.....##.##
#........X#
###########

6
1
#####d#####
#.........#
#......#..#
#.......#.#
#.........#
#..........
#.........#
#.......#.#
#......#..#
#.........#
###########

2
1
#####.#####
#k........#
#..#......#
#.#.......#
#.........#
...........
#.........#
#.........#
#.........#
#.........#
#####l#####
key : 0

3
2
#####.#####
#.......#.#
#.........#
#....#.#.##
#.........#
l...#.#...l
#.........#
#....#...##
#.........#
#.#.....#.#
#####.#####
locked : 0

6
2
#####.#####
#.........#
#.........#
#..#......#
#.........#
.........e#
#.........#
#.........#
#.........#
#.........#
#####.#####
enemies 1

5
2
#####.#####
#.........#
#.........#
#.........#
#.........#
d....e.....
#.........#
#.........#
#.........#
#.........#
#####.#####
boss
enemies 1

2
2
#####.#####
#.........#
#..#..#..##
#.........#
#.........#
....#..#..#
#.........#
#.........#
#..#..#..##
#.........#
#####.#####

5
3
###########
#.......###
#.....#.k##
#.....#.###
#....#..#.#
......#...#
#.........#
#.........#
#.........#
#.........#
###########
key : 3

4
2
#####.#####
#..#...#e##
#.........#
##.#.#.#..#
#.........#
.....#.#..#
#........e#
#..#.#.#.##
#........e#
#..#...#?##
#####.#####
enemies 3
sign This door will not yield without a key.

1
0
###########
##k#...#..#
#.........#
#.#.#.#.#.#
#.........#
#..#.#.#...
#.........#
#.#.#.....#
#.........#
#..#......#
#####.#####
key : 1

1
1
#####d#####
#.........#
#.........#
#....#....#
#...#.....#
...#.......
#.........#
#.........#
#.........#
#.........#
#####.#####

4
1
#####.#####
#k#.....#.#
#.........#
#.#...#.#.#
#.........#
#...#.#....
#.........#
#.#.#.....#
#.........#
#.#.....#.#
#####d#####
key : 2

0
1
###########
#.........#
#......#..#
#.......#.#
#.........#
#..........
#.........#
#.........#
#.........#
#.........#
#####d#####

1
2
#####.#####
#..#......#
#...#.....#
#..#......#
#.........#
..........#
#.........#
#.........#
#.........#
#.........#
#####.#####

5
1
#####d#####
#.........#
#.........#
#.........#
#.........#
#.........d
#.........#
#.........#
#.........#
#.........#
#####d#####

0
2
###########
#..#...#..#
#..##.....#
#..##.#...#
#..#..#...#
....###...#
#.........#
#.........#
#.........#
#.........#
#####.#####

