0
1
###########
#.........#
#.........#
#.##......#
#.###.....#
D...#.....D
#.###.....#
#####.....#
#.........#
#.........#
#####D#####

3
2
#####d#####
#.........#
#..#......#
#.........#
#.........#
D.........D
#.........#
#.........#
#..#..#..##
#.........#
#####D#####

4
0
#####D#####
#.........#
#.........#
#.....#..##
#.........#
#.........#
#...#..#..#
#.........#
#.........#
#..#.....##
#####D#####

1
0
#####l#####
#.........#
#.........#
#.........#
#.........#
#.........D
#.....#...#
#....###..#
#.........#
#.........#
#####D#####

1
1
#####D#####
#k........#
#.#.....#.#
#.........#
#.........#
D..#......D
#.........#
#.........#
#.........#
#.........#
#####D#####
key : 1

1
2
#####D#####
#k........#
#.#.....#.#
#.........#
#.#...#.#.#
D.........D
#.#.#...#.#
#.........#
#...#.#.#.#
#.........#
#####D#####
key : 2

2
3
#####D#####
#.........#
#.p.#..#..#
#..####...#
#..#e.##..#
l..#.#.#..#
#......#..#
#.....p...#
#.........#
#.........#
#####D#####
locked : 2
boss
enemies 1

3
0
#####D#####
#.........#
#.........#
#.........#
#.....###.#
#k....##..d
#.....##..#
#.....#...#
#...#.#.#.#
#.........#
#####D#####
key : 0

3
1
#####D#####
#.........#
#.........#
#.........#
#.........#
d.........D
#.........#
#.......#.#
#......#..#
#.........#
###########

4
2
#####D#####
#.##......#
#.##......#
#.##......#
#.#.......#
#..##.....#
#.........#
#.........#
#e........#
#e?......e#
###########
enemies 3
sign Many have walked this path.

0
2
###########
#.........#
#.##......#
#.k##.....#
#.#.#..p..#
D.........D
#.........#
#.........#
#.........#
#.........#
#####D#####
key : 4

0
0
###########
#.........#
#.........#
#.........#
#.........#
#.........D
#.........#
#.........#
#.........#
#.........#
#####l#####
locked : 1

5
0
#####D#####
#.#.....#.#
#.........#
#.#.#...#.#
#.........#
#...#.....#
#.........#
#.#.#.#.#.#
#.........#
#.......#.#
###########

2
2
#####D#####
#.........#
#..#......#
#.#.......#
#.........#
d.........l
#.........#
#.#.......#
#..#......#
#.........#
#####d#####

2
1
#####D#####
#.........#
#.........#
#.........#
#.........#
l.........d
#.........#
#.........#
#.........#
#.........#
#####D#####
locked : 0

2
0
#####D#####
#.........#
#.........#
#....p....#
#...@.....#
#....#.#..l
#....#?##.#
#....##.#.#
#.....#..##
#.......###
#####D#####
sign Turn back; you are not yet ready.

3
3
#####D#####
#..#......#
#..##.....#
#..##.....#
#.#.......#
D.........#
#.........#
#.........#
#.........#
#........X#
###########

0
3
###########
#.......ee#
#.........#
##...#....#
#.#..#....#
D..##.....#
#.#.##.#..#
#...##....#
#.........#
#.........#
#####D#####
enemies 2
door 0 : 0

1
3
#####D#####
##........#
#.##......#
#.####.##.#
#...##.#..#
D...#e.#..#
#...e#s##.#
#...###?#.#
#.........#
#.........#
#####D#####
enemies 2
switch 0 : 0
sign This door will not yield without a key.

