4
0
#####D#####
#.........#
#.........#
#.........#
#.........#
#...####..D
#.....#.#.#
#...###...#
#...#.##..#
#......##.#
#####D#####

4
1
#####D#####
#.........#
#......#..#
#.......#.#
#.........#
D.........d
#.........#
#.......#.#
#......#..#
#.........#
#####D#####

4
2
#####D#####
#.........#
#.........#
#.........#
#.........#
d.........D
#.........#
#.........#
#.........#
#......p..#
#####l#####

3
2
#####D#####
#..#...#.##
#.........#
#...#.#.#.#
#.........#
d..#.#.#..D
#.........#
#.#.#.#.#.#
#.........#
##.#...#..#
#####D#####

2
1
#####D#####
#.........#
#......#..#
#.......#.#
#.........#
D.........D
#.........#
#.........#
#.........#
#.........#
#####d#####

3
4
###########
#.........#
#.........#
#......#..#
#..####...#
d...##.#..#
#..###....#
#.######..#
#..##.....#
#.##......#
###########

1
2
#####D#####
#.........#
#.........#
#.........#
#..###....#
D...#e....D
#...##....#
#..#.#....#
#.........#
#.........#
#####l#####
locked : 1
boss
enemies 1

5
0
#####D#####
#.........#
#.........#
#.........#
#...@.....#
#..###....D
#.........#
#..###....#
#.........#
#.........#
###########

1
1
###########
#X........#
#.........#
#.........#
#.........#
#.........D
#.........#
#.........#
#.........#
#.........#
#####D#####

5
1
#####D#####
#.........#
#......#..#
#.......#.#
#.........#
D.........D
#.........#
#.#.....#.#
#..#...#..#
#..k......#
###########
key : 1

3
1
#####d#####
#k........#
#.........#
#.........#
#.........#
D.........d
#.........#
#.......#.#
#......#..#
#.........#
#####D#####
key : 0

2
0
###########
#.........#
#..#...#..#
#.#.....#.#
#.........#
#.........D
#.........#
#.#.......#
#..#......#
#.........#
#####D#####

1
3
###########
#.........#
#.........#
#.........#
#.........#
D.........#
#.........#
#.........#
##..#..#..#
#.........#
###########

0
2
###########
#k........#
#......#..#
#.......#.#
#.........#
#.........#
#.........#
#.#.....#.#
#..#...#..#
#.........#
#####D#####
key : 5

3
0
#####D#####
#.........#
#.........#
#.#.#.#...#
#.........#
#...#.#...D
#.........#
#...#.#...#
#.........#
#.......#.#
#####D#####

5
2
#####l#####
#.......#.#
#...#..#..#
#...#.....#
#.....#.#.#
D.........#
#.........#
#.........#
#.........#
#.........#
###########
locked : 0

4
3
#####D#####
#.........#
#..#......#
#.#.......#
#.........#
D.........#
#.........#
#.........#
#.........#
#........k#
###########
key : 4

3
3
###########
#.........#
#..#...#..#
#.#.....#.#
#.........#
D.........d
#.........#
#.#.......#
#..#......#
#.........#
#####D#####

2
2
#####l#####
#.........#
#........?#
#..#.....##
#........e#
D.........#
#...#..#..#
#.........#
#.........#
#..#.....##
#####D#####
enemies 1
sign This door will not yield without a key.

