3
3
#####l#####
#.........#
#.........#
#.........#
#.........#
...........
#.........#
#.#.....#.#
#..#...#..#
#..k......#
###########
key : 2

5
2
###########
#.#.....#.#
#.........#
#..#.....##
#.........#
....#.#...#
#.........#
#....#.#..#
#.........#
#.#.....#.#
###########

3
1
###########
#.........#
##.#...#.##
#.........#
#.#.#.#...#
...........
#..#...#..#
#.........#
#.#.......#
#.........#
#####.#####

3
0
###########
#..#......#
#.........#
#.........#
#...#..#..#
#..........
#.........#
#.....#...#
#.........#
#.........#
#####.#####

3
6
###########
#.........#
#......#..#
#...##..#.#
#.........#
l.........#
#.........#
#.......#.#
#......#..#
#.........#
###########
locked : 1

3
2
#####d#####
#........##
#.........#
#.........#
#..#......#
...........
#.........#
#.....#...#
#.........#
#....k....#
###########
key : 1

2
5
#####d#####
#.........#
#......#.##
#.........#
#.#.#.#.#.#
..........#
#......#..#
#.........#
#...#.#.#.#
#.........#
#####.#####

0
5
###########
#X........#
#.........#
#.........#
#.........#
#.........#
#.........#
#.........#
#.........#
#.........#
#####.#####

3
5
#####.#####
#.........#
#.........#
#.........#
#.........#
l.........l
#.........#
#.........#
#.........#
#.........#
###########
locked : 0

4
0
#####.#####
#..#......#
#..##.##..#
#..#####..#
#..#@.....#
#..####....
#.........#
#.........#
#.........#
#.........#
#####.#####

1
5
#####.#####
####......#
##.#......#
#..###....#
#.###.....#
#..##e....#
#.........#
#.........#
#.........#
#.........#
#####d#####
boss
enemies 1

4
1
#####.#####
#.......#k#
#.........#
#....#...##
#....###..#
..........#
#.........#
#.........#
#.........#
#.........#
#####.#####
key : 0

6
0
#####d#####
#.........#
#..#...#.##
#.........#
#...#.#.#.#
#.........#
#..#.#.#..#
#.........#
#.#...#.#.#
#.........#
###########

2
4
###########
#.........#
#.........#
#.........#
#....##...#
...........
#....##...#
#.....##..#
#......#..#
#.........#
#####l#####
locked : 3

5
1
#####.#####
#..#...#.##
#.........#
##.#.....##
#.........#
d..#.#.#...
#.........#
#..#.#...##
#.........#
##.#...#.##
###########

5
0
#####.#####
#.......#.#
#.....##..#
#....#.##.#
#....#..#.#
#....##...d
#.........#
#.........#
#.........#
#.........#
#####d#####

2
2
###########
#.........#
#.........#
#.........#
#.........#
#....#.....
#.........#
#.........#
#.........#
#.........#
#####d#####

3
4
#####l#####
#.........#
#..#...#..#
#.#.....#.#
#.........#
..........l
#.........#
#.#.......#
#..#......#
#..#k..#..#
###########
key : 3

2
3
###########
#.........#
#..#...#..#
#.#.....#.#
#.........#
...........
#.........#
#.......#.#
#......#..#
#.........#
#####l#####
locked : 2

