4
2
#####D#####
#.........#
#..#......#
#.#.......#
#.........#
D.........#
#...#.....#
#.......#.#
#......#..#
##........#
#####D#####

1
0
###########
#?........#
#.....#.#.#
#......#..#
#.........#
#....@....D
#.........#
#.........#
#.........#
#.........#
###########
sign What you seek is close.

5
3
###########
#.#.......#
#.#.#.#...#
#.###.....#
#.#####...#
d....e....#
#.........#
#.........#
#.........#
#.........#
#####D#####
boss
enemies 1

3
2
#####l#####
#.#.....#.#
#.........#
#.........#
#..#..#...#
D.........#
#.........#
#....#..#.#
#.........#
#.........#
#####D#####
locked : 2

3
1
#####l#####
#.........#
#......#..#
#.......#.#
#.........#
#.........D
#.........#
#.........#
#.........#
#.........#
#####d#####
locked : 3

1
1
###########
#..k......#
#..#......#
#.#.......#
#.........#
D.........D
#.........#
#.........#
#.........#
#.........#
#####D#####
key : 0

5
2
#####D#####
#.........#
#.........#
#.........#
#.........#
l.........d
#.........#
#...p.....#
#.p.......#
#.........#
#####D#####
locked : 0

0
2
###########
#e.......e#
#s........#
#.........#
#.........#
#.........#
#...###...#
#...#..#..#
#...#.#...#
#.........#
#####D#####
enemies 2
switch 0 : 0 1

6
2
#####D#####
#.........#
#.........#
#.........#
#.........#
D.........D
#.....#...#
#...#.....#
#.........#
#.........#
###########

1
2
#####D#####
#k#.....#.#
#.........#
#..#...#.##
#.........#
D...#.#...D
#.........#
#..#.#...##
#.........#
#.#.....#.#
#####D#####
key : 1

2
1
#####D#####
#.........#
#.........#
#.........#
#.........#
#e........D
#.........#
#.........#
#.........#
#.........#
#####l#####
enemies 1

2
3
#####D#####
#.........#
#.#.....#.#
#.........#
#.........#
D....#....#
#.........#
#.........#
#.#.....#e#
#......?ee#
###########
enemies 3
door 0 : 0 1
sign A useful tool lies just ahead.

1
4
###########
#.........#
#.........#
#.........#
#.........#
D.........#
#.........#
#.........#
#.........#
#.........#
###########

4
1
#####d#####
#.........#
#.........#
#.........#
#.........#
#.........D
#.........#
#.........#
#.........#
#.........#
#####d#####

2
2
#####D#####
#k........#
#......#..#
#..#....#.#
#.........#
D.........D
#...#.....#
#.......#.#
#......##.#
#.........#
#####l#####
key : 2

6
1
#####l#####
#.........#
#.........#
#...p.....#
#.........#
#.....#...D
#...#.#...#
#...#.#...#
#.........#
#.........#
###########
locked : 1

6
3
#####D#####
#......#..#
#...#..#..#
#...##....#
#....#....#
D.........#
#.........#
#.........#
#.........#
#........X#
###########

5
1
#####d#####
#.........#
#..#......#
#.#.......#
#.........#
#.........l
#.........#
#.#.......#
#..#......#
#.........#
#####l#####

1
3
###########
#....k....#
#.........#
#.........#
#.........#
D.........D
#.........#
#.#.......#
#..#......#
#.........#
#####D#####
key : 3

