6
2
#####.#####
#.........#
#..#......#
#.#.......#
#.........#
...........
#...#.....#
#.......#.#
#......#..#
##........#
###########

1
4
###########
#.........#
##.#......#
#.........#
#..#.#....#
..........#
#..#.#.#..#
#.........#
##.#...#..#
#.........#
###########

4
2
#####.#####
#.........#
##.#...#.##
#.........#
#.#.#.#.#.#
..........#
#..#.#.#..#
#.........#
#.#.#.#...#
#.........#
#####.#####

1
0
###########
#?........#
#..##.#...#
#......#..#
#....#.#..#
#....@#....
#.........#
#...#.....#
#.#.......#
#.........#
###########
sign What you seek is close.

1
2
#####.#####
#.........#
#.........#
#.........#
#.........#
...........
#...###...#
#...#.k#..#
#...#.#...#
#.........#
#####.#####
key : 1

5
3
###########
#.........#
#.........#
##..#.....#
#..#e#....#
d..#.#....#
#..#......#
##...#....#
#.........#
#.........#
#####.#####
boss
enemies 1

3
2
#####l#####
#.........#
#.........#
#.#.....#.#
#.........#
..........#
#..#..#...#
#.........#
#.........#
#.#.....#.#
#####.#####
locked : 2

2
2
#####.#####
#k........#
##.#...#..#
#.#....##.#
#.........#
...........
#.........#
#.........#
#.........#
#.........#
#####l#####
key : 2

1
1
###########
#.........#
#..##.....#
#..#k.....#
#.####....#
...........
#.........#
#.........#
#.........#
#.........#
#####.#####
key : 0

4
1
#####d#####
#.........#
#.........#
#...#.....#
#.........#
#.....#....
#...#.#...#
#...#.#...#
#.........#
#.........#
#####d#####

1
3
###########
#...k.....#
#.#.#.....#
#.........#
#..#.#.#..#
...........
#.#.#.#.#.#
#.........#
#..#......#
#.........#
#####.#####
key : 3

5
1
#####d#####
#.........#
#.........#
#.........#
#.........#
#.........l
#.........#
#.........#
#.........#
#.........#
#####l#####

3
1
#####l#####
#.........#
#..#...#..#
#.#.....#.#
#.........#
#..........
#.........#
#.........#
#.........#
#.........#
#####d#####
locked : 3

5
2
#####.#####
#.........#
#..#......#
#.#.......#
#.........#
l.........d
#.........#
#.#.......#
#..#......#
#.........#
#####.#####
locked : 0

6
3
#####.#####
#.........#
####......#
####......#
#...#.....#
....#.....#
#.#.......#
##........#
##........#
#........X#
###########

6
1
#####l#####
#.........#
#..#......#
#.#.....#.#
#.........#
#..........
#.........#
#.......#.#
#......#..#
#.........#
###########
locked : 1

2
3
#####.#####
##.#......#
##.#......#
##........#
#.#.......#
...#......#
#....#?#..#
#....##e..#
#.....##..#
#......e.e#
###########
enemies 3
door 0 : 0 1
sign A useful tool lies just ahead.

2
1
#####.#####
#.........#
#.........#
#.........#
#.........#
#..#.##....
#..#.##...#
#..##.....#
#.##......#
#e#.......#
#####l#####
enemies 1

0
2
###########
##e#e....s#
##.##.....#
#...#.....#
#.####....#
#..###....#
#.........#
#.##......#
##.##.....#
#.........#
#####.#####
enemies 2
switch 0 : 0 1

