3
4
###########
#..#.....##
#.........#
#.........#
#...#..#..#
D.........#
#.........#
#..#.....##
#.........#
#.........#
#####D#####

2
3
###########
#........k#
#..#......#
#.#.......#
#.........#
D.........#
#.........#
#.........#
#.........#
#.........#
#####D#####
key : 5

2
0
#####l#####
#.........#
#..#......#
#.#.......#
#.........#
#.........D
#.........#
#.......#.#
#......#..#
#.........#
#####D#####

2
1
###########
##.#...#.##
#.........#
#...#...#.#
#.........#
D....#....D
#.........#
#.#.#.#.#.#
#.........#
##.#...#..#
#####D#####

4
3
#####D#####
#........k#
#..#...#.##
#.........#
#...#.#.#.#
D.........D
#..#...#..#
#.........#
#...#.#.#.#
#.........#
#####d#####
key : 2

6
3
#####D#####
#.##......#
#.###.....#
#.##......#
#.#.#.....#
#.........#
#.........#
#.#.......#
#.........#
#X.......##
###########

3
2
#####d#####
#.........#
#.#.......#
#.........#
#.........#
D....#....D
#.........#
#.........#
#.#.......#
#.........#
#####D#####

4
1
#####d#####
#.........#
#..#......#
#.#.......#
#.........#
D.........d
#.........#
#.........#
#.........#
#.........#
###########

2
2
###########
#.........#
#.........#
#.........#
#.........#
D.........D
#.........#
#.#.......#
#..#......#
#.........#
#####d#####

4
0
#####D#####
#.......#.#
#.........#
#.........#
#.........#
#.........D
#.........#
#.#.....#.#
#..#...#..#
#k.....#..#
###########
key : 0

4
4
#####D#####
#.........#
#...#.#.#.#
#.........#
#..#.#.#..#
D.........#
#.#...#.#.#
#.........#
#..#.....##
#........k#
###########
key : 7

0
0
###########
#e.......e#
#?........#
#.........#
#.........#
#.........#
#.........#
#.........#
#......#..#
#..#......#
#####D#####
enemies 2
sign Seek the matching key before you proceed.

3
3
#####D#####
#e........#
#......#..#
#.........#
#.##......#
D.........D
#.#.......#
#........##
#.........#
#?........#
#####D#####
enemies 1
sign Something glints behind that door…

5
2
#####l#####
#......#..#
#.....#.#.#
###.......#
#..##.#...#
#.........D
#.........#
#.........#
#.........#
#.........#
###########
locked : 2

5
3
#####d#####
#.........#
#........##
#....#.#..#
#....###..#
D....e##..#
#.....#...#
#...#.....#
#.........#
#.........#
#####D#####
boss
enemies 1

4
2
#####D#####
##.#......#
#...#.....#
#..##..#..#
#.#.#.##..#
d......#..D
#.........#
#.........#
#.........#
#.........#
#####l#####

3
1
#####D#####
#..#.....##
#.........#
##.#.#...##
#.........#
D..#.#.#..D
#.........#
##.#.#.#.##
#.........#
#..#...#..#
#####d#####

3
0
#####D#####
#.........#
#.........#
#.........#
#.........#
#....@....D
#.........#
#......#..#
#......#..#
#.........#
#####D#####

1
0
#####D#####
#.........#
#.........#
#.#..#..#.#
#.........#
#.........#
#.#.....#.#
#.........#
#.........#
#.#.....#.#
#####l#####
locked : 0

