6
1
#####.#####
#.........#
#..#......#
#.#.......#
#.........#
...........
#....#....#
#.........#
#.........#
#.........#
###########

2
2
#####.#####
#..#......#
#.###.....#
#.##......#
#.........#
d..........
#.........#
#.........#
#.........#
#.........#
#####.#####

5
0
#####.#####
#.........#
#..#..#...#
#k#.......#
#.........#
#..........
#.........#
#.#.......#
#.##......#
#.........#
#####.#####
key : 0

4
0
#####.#####
#?........#
#.........#
#...#.....#
#...e##...#
#e..#e#...d
#.........#
#.........#
#.........#
#.........#
#####.#####
enemies 3
sign A useful tool lies just ahead.

3
0
###########
#.........#
#..#...#..#
#.#.....#.#
#.......#.#
#..........
#....#..#.#
#.........#
#.........#
#.........#
#####.#####

5
1
#####.#####
#.........#
#..#......#
#.#.......#
#.........#
..........#
#........k#
#....#...##
#........##
#.........#
#####.#####
key : 1

3
2
#####.#####
#.#.....#.#
#.........#
#......#.##
#.........#
d...#.....#
#.........#
#..#.#...##
#.........#
#.#.....#.#
#####.#####

0
1
###########
#.........#
#.........#
#.........#
#.........#
#.........#
#.........#
#.........#
#.........#
#.........#
#####l#####
locked : 3

0
3
###########
#X........#
#.........#
#.........#
#.........#
#.........#
#.........#
#.........#
#.........#
#.........#
#####.#####

4
2
#####.#####
##.....#..#
#.........#
#.........#
#.#..#..#.#
l.........#
#.........#
##..#.....#
#.........#
#.........#
###########
locked : 1

2
1
#####.#####
#.........#
#.........#
#......#..#
#......#..#
#....#.#..d
#.........#
#.........#
#.........#
#.........#
#####.#####

6
2
###########
#........k#
#........##
#.........#
#.........#
..........#
#....#....#
#.#.....#.#
#..#......#
#.........#
###########
key : 2

1
2
###########
#.........#
#.###.....#
#.#####...#
#.#.#e....#
....###...d
#.#####...#
#.........#
#.........#
#.........#
#####.#####
enemies 1

1
1
#####l#####
#.........#
#..#......#
#.#.......#
#.........#
#..........
#.........#
#.......#.#
#......#..#
#.........#
#####.#####

4
1
#####.#####
#.........#
#.........#
#.........#
#.........#
d.........l
#......##.#
#.#....##.#
#.......#.#
#.........#
#####.#####

1
3
#####.#####
#.........#
#.........#
#.........#
#.........#
d..##e....#
#.###.....#
#..#......#
#.........#
#.........#
#####.#####
boss
enemies 1

3
1
#####.#####
#k........#
#..#......#
#.#.......#
#.........#
..........d
#.........#
#.........#
#.........#
#.........#
#####.#####
key : 3

2
3
#####.#####
#.........#
#..#...#.##
#.........#
#.#.#.#.#.#
..........#
#....#.#..#
#.........#
#.#.#...#e#
#...?...ee#
###########
enemies 3
sign Beware what lurks ahead.

6
0
#####.#####
#.........#
#.........#
#.........#
#.........#
#...#@.....
#..##.....#
#.#.......#
##........#
#.........#
###########

