2
0
#####D#####
#.........#
#.........#
#.........#
#.........#
#....@....D
#.........#
#.........#
#.........#
#.........#
#####D#####

1
1
###########
#..k......#
#..#......#
#.#.......#
#...#.....#
D.........D
#..#......#
#.........#
#...#.....#
#.........#
#####D#####
key : 3

5
0
#####D#####
#.........#
#...#..#..#
#.........#
#.........#
#....#....d
#.........#
#.........#
##........#
#.........#
###########

4
1
#####D#####
#.........#
#......#.##
#.........#
#..#...#..#
d.........D
#..#.#.#..#
#.........#
##.....#.##
#.........#
#####D#####

3
0
#####D#####
#.........#
#.......#.#
#.........#
#.........#
#k........D
#.........#
#.........#
#.......#.#
#.........#
#####D#####
key : 1

1
2
###########
#.......ee#
#.........#
#.........#
#.........#
D.........#
#.........#
#.........#
#.........#
#.........#
#####D#####
enemies 2
door 0 : 0 1

2
3
###########
#.........#
#.........#
#...#.....#
#.###.....#
D..##.....#
#.#.#.....#
##..#.....#
#.........#
#.........#
###########

2
2
#####D#####
#.........#
#.........#
#.........#
#......#..#
D..#..##..D
#.##..#k#.#
#.#.......#
#.#.......#
#.........#
#####l#####
key : 2

3
1
#####l#####
#.........#
#.........#
#.........#
#.........#
D....#....D
#....###..#
#....##.###
#.......###
#......####
#####D#####
locked : 3

6
1
#####d#####
#.#.....#.#
#.........#
#.#.....#.#
#.........#
#...#.....D
#.........#
#.#...#.#.#
#.........#
#.#.......#
###########

2
1
#####D#####
#.........#
#..##.....#
###k#.....#
#....#....#
D...#.....D
#.##.##...#
#.........#
#.........#
#.........#
#####l#####
key : 0

5
2
#####D#####
#.........#
#.........#
#.........#
#.........#
d....e....#
#.........#
#.........#
#.........#
#.........#
#####D#####
boss
enemies 1

4
0
#####D#####
#.........#
#.........#
#...p.....#
#....#.#..#
#....##...d
#.....##..#
#.........#
#.......p.#
#.........#
#####D#####

0
0
###########
#e.......e#
#.s#..#...#
#e##..#...#
#.....#...#
#...##.#..#
#....#....#
#...p.###.#
#p....##..#
#......#..#
#####D#####
enemies 3
switch 0 : 0 1

6
2
#####D#####
#.........#
#.........#
#.........#
#.........#
D.........#
#.........#
#.........#
#.........#
#........X#
###########

3
2
#####l#####
#.........#
#.........#
#.........#
#.........#
D....#....#
#.........#
#.........#
#.........#
#.........#
#####D#####
locked : 1

5
1
#####D#####
#.........#
#.........#
#.........#
#.........#
d.........d
#.........#
#.#.......#
#..#......#
#.........#
#####d#####

1
0
#####D#####
#.........#
#.........#
#.........#
#.........#
#.........D
#.........#
#.........#
#.........#
#.........#
#####D#####

4
2
#####D#####
#......#..#
#..#...#..#
#.#.......#
#.........#
D.........#
#.........#
#.....#.#.#
#......#..#
#.........#
#####D#####

