1
0
#####.#####
#.........#
#.........#
#....#..#?#
#.........#
#.........#
#e#..#..#s#
#.........#
#.........#
#e#.......#
#####.#####
enemies 2
switch 0 : 0 1
sign The dungeon remembers all who enter.

2
1
###########
#....k....#
#.........#
#.........#
#.........#
...........
#.........#
#.........#
#.........#
#.........#
#####.#####
key : 1

3
1
#####.#####
#k........#
#.........#
##..#.....#
#.........#
...........
#.#..#..#.#
#.........#
#.........#
##........#
#####.#####
key : 0

1
2
###########
#.........#
#.........#
#..#..#..##
#.........#
#.........#
#..#..#...#
#.........#
#.........#
#..#.....##
#####.#####

5
3
#####.#####
#.......#.#
#.........#
#..#.#.#.##
#.........#
....#.#...#
#.........#
#..#...#..#
#.........#
#......e#e#
###########
enemies 2
door 0 : 0 1

7
2
#####.#####
#.........#
#.........#
#.........#
#.....#.#.#
#..#..#...#
#.###.#.#.#
#...###...#
#..##.....#
#X........#
###########

5
1
#####l#####
#.........#
#.........#
#.........#
#.........#
#.........d
#.........#
#.........#
#.........#
#.........#
#####d#####
locked : 1

3
0
#####.#####
#.........#
#.........#
#.........#
#.........#
#....@.....
#.........#
#.........#
#.........#
#.........#
#####.#####

4
1
#####.#####
#........k#
#........##
#.........#
#....#.#..#
..........d
#....#.#..#
#.........#
#..#...#.##
#.........#
#####l#####
key : 2

2
2
#####.#####
#.........#
#.........#
#.........#
#.........#
..........#
#.........#
#.......#k#
#......#..#
#.........#
#####.#####
key : 3

5
2
#####.#####
#.........#
#.....#.#.#
#.......#.#
#.........#
d..........
#.........#
#.........#
#.........#
#.........#
#####d#####

6
2
#####d#####
#.........#
#.........#
#.........#
#.........#
.....e....#
#.........#
#.........#
#.........#
#.........#
#####.#####
boss
enemies 1

4
0
#####.#####
#.........#
#.........#
#.........#
#.........#
#...#......
#.........#
#.........#
#?........#
#e......#.#
###########
enemies 1
sign Those who search shall find.

3
2
#####.#####
#.........#
#......#.##
#.......#.#
#.........#
..........#
#.........#
#.........#
#.........#
#.........#
#####.#####

2
0
#####.#####
#.........#
#.........#
#.........#
#......#..#
#..........
#.........#
#.....#..##
#.........#
#.........#
#####.#####

0
0
###########
#.........#
#.........#
#.....##.##
#......#..#
#.........#
#....#..#.#
#....######
#.........#
#.#.......#
#####.#####

4
2
#####.#####
##.....#..#
#.........#
#.........#
#.#..#....#
d.........l
#.........#
##..#..#..#
#.........#
#.........#
#####.#####

6
1
#####d#####
#.........#
#.........#
#.........#
#.........#
#..........
#.........#
#.........#
#.........#
#.........#
###########

4
3
###########
#.........#
#..#...#..#
#.#.....#.#
#.........#
l.....##..#
#.........#
#....#....#
#.........#
#.........#
#####.#####
locked : 3

