3
3
#####.#####
#k........#
##.#...#.##
#.........#
#..#.#.#..#
...........
#..#...#..#
#.........#
##.#...#.##
#.........#
###########
key : 4

4
4
#####d#####
#.........#
#.........#
#.........#
#..#.##...#
#..##..#..#
#.....##..#
#...####..#
#.........#
#.........#
###########

3
5
#####.#####
#.........#
##..#..#..#
#.........#
#.........#
d...#..#..#
#.........#
#.........#
##..#..#..#
#.........#
###########

3
0
#####.#####
#..#......#
#...#.....#
###.#.....#
#.#.#.....#
#....@.....
#?##......#
###.#.....#
#.........#
#.........#
###########
sign Those who search shall find.

1
2
###########
#.........#
#..#...#..#
#.#.....#.#
#.........#
#.........#
#.........#
#.........#
#.........#
#.........#
#####l#####
locked : 3

3
4
#####l#####
#.........#
#..##.....#
#.#####...#
#.#...#...#
....#.#...d
#.#.#.....#
#.........#
#.........#
#.........#
#####d#####

3
1
#####.#####
#.........#
#..#...#..#
#.........#
#.#.#.#.#.#
...........
#..#.#....#
#.........#
#.#.#...#.#
#.........#
#####.#####

1
4
#####.#####
#..#......#
#..##.....#
#..###....#
#.........#
#....e....#
#.........#
#.........#
#.........#
#.........#
#####d#####
boss
enemies 1

2
3
###########
#.........#
#.......#.#
#.........#
#.........#
l..#.......
#.........#
#.........#
#.#.....#.#
#.........#
#####.#####
locked : 4

2
4
#####d#####
#.........#
#......#..#
##.#.##...#
#.####....#
....#.....d
#..###....#
#...##....#
#.........#
#.........#
#####l#####
locked : 0

3
2
#####.#####
#.........#
#..#......#
#.#.......#
#.........#
...........
#.........#
#.......#.#
#......#..#
#.........#
#####.#####

2
1
###########
#....k....#
#.........#
#.........#
#.........#
.....#.....
#.#.....#.#
#...#...#.#
#.....#...#
#.........#
#####.#####
key : 2

2
2
#####l#####
#k........#
#......#..#
#.......#.#
#.........#
..........l
#.........#
#.........#
#.........#
#.........#
#####.#####
key : 3

2
5
###########
#.........#
#..#......#
#.#.......#
#.........#
d.........#
#.........#
#.........#
#.........#
#.........#
#####.#####

2
0
###########
#k........#
#.........#
#.........#
#.........#
#..........
#.........#
#.........#
#.........#
#.........#
#####.#####
key : 0

0
4
###########
#X........#
#.........#
#.........#
#.........#
#.........#
#.........#
#.........#
#.........#
#.........#
#####.#####

4
2
#####.#####
#.......#.#
#.........#
#....#.#.##
#.........#
..........#
#.........#
#....#...##
#.........#
#.#.......#
###########

5
1
#####.#####
#.........#
#.........#
#......#..#
#.......#.#
#.........#
#...#.#...#
#.........#
#...#.#...#
#.........#
###########

4
1
#####.#####
#.........#
#.........#
#.....##..#
#.....#...#
#...#k##...
#....###..#
#.........#
#.........#
#.........#
#####.#####
key : 1

