3
2
#####.#####
#.#.......#
#.........#
#.........#
#..#..#...#
..........#
#.........#
#....#..#.#
#.........#
#.........#
#####.#####

4
1
#####.#####
##........#
#.........#
#.........#
#......#..#
d..........
#.........#
##..#.....#
#.........#
#.........#
#####.#####

2
1
#####.#####
#e........#
##..#.....#
#.........#
#.........#
.....#....d
#.........#
#.........#
##..#..#..#
#.........#
#####.#####
enemies 1

3
0
#####.#####
#e........#
#.........#
#.........#
#.........#
#e.........
#.........#
#....#....#
#.........#
#.........#
#####.#####
enemies 2

0
0
###########
#.........#
#......#..#
#.......#.#
#.........#
#..........
#.........#
#.........#
#.........#
#.........#
#####l#####
locked : 1

5
0
#####d#####
#.#.....#.#
#.........#
#..#.#.#.##
#.........#
#...#.#....
#.........#
#..#...#.##
#.........#
#.#.......#
###########

2
0
#####.#####
#.........#
#.........#
#....#....#
#.....#...#
#..##@.....
#.........#
#.........#
##........#
##........#
#####.#####

3
1
#####.#####
#k........#
#..#...#..#
#.#.....#.#
#.........#
...........
#.........#
#.........#
#.........#
#.........#
#####.#####
key : 1

4
0
#####.#####
#.........#
#...#.#...#
#...###...#
#.....#...#
#....##...d
#...#.#.#.#
#......##.#
#...#..#..#
#......##.#
#####d#####

1
0
#####l#####
#.........#
#.........#
#........##
#.........#
#..........
#.........#
#.........#
#.........#
#..#.....##
#####.#####

7
1
#####.#####
#.........#
#........##
#....##.#.#
#....#.#..#
#....#....#
#....#.#..#
#.........#
#.........#
#X........#
###########

1
1
#####d#####
#.........#
#.........#
#..#.#.#..#
#.######..#
...##..#...
#..#k#.#..#
#..#...#..#
#.........#
#.........#
#####.#####
key : 0

1
2
###########
#.........#
#.........#
#.........#
#.........#
..........#
#.........#
#.#.......#
#..#......#
#.........#
#####.#####

6
1
#####l#####
#.........#
#...#...#.#
#.....###.#
#...#.....#
#..#e###..#
#....###..#
#.........#
#.........#
#.........#
#####.#####
locked : 3
boss
enemies 1

5
2
#####.#####
#.........#
#.........#
#.........#
#.........#
l.........#
#.........#
#.........#
#.........#
#.........#
###########
locked : 2

0
1
###########
#..#......#
#.#.#.#...#
#...#.....#
#.#.......#
.....#....#
#.........#
#.........#
#.........#
#.........#
#####d#####

2
2
#####.#####
#.........#
#..#......#
#..#......#
#..#......#
d.........#
#.........#
#.........#
#.........#
#.........#
#####.#####

4
2
#####.#####
#.........#
#.........#
#.........#
#.........#
.........k#
#.........#
#.........#
#.........#
#.........#
#####.#####
key : 2

5
1
#####.#####
#k........#
#......#..#
#.......#.#
#.........#
..........l
#.........#
#.......#.#
#......#..#
#.........#
#####l#####
key : 3

