4
1
#####l#####
#.........#
#.........#
#.........#
#.....#...#
...........
#....###..#
#.....#k###
#.....#.#.#
#.........#
#####.#####
key : 0

2
0
###########
#.........#
#.#...#.#.#
#.........#
#..#.#.#..#
#..........
#.....#.#.#
#.........#
#..#...#.##
#.........#
#####l#####
locked : 1

3
2
#####d#####
#.........#
#......#..#
#.......#.#
#.........#
l.........#
#.........#
#.#...#...#
#..#......#
#.#.......#
#####.#####
locked : 2

5
1
#####.#####
#.........#
#.........#
#.#.....#.#
#.........#
..........#
#.#..#..#.#
#.........#
#.........#
#k#.......#
#####.#####
key : 2

7
0
#####d#####
#.........#
#.........#
#.........#
#.........#
#.........#
#.........#
#.........#
#.........#
#.........#
###########

6
1
#####.#####
#.........#
#......#..#
#.......#.#
#.........#
...........
#..#......#
#.........#
#.........#
##........#
###########

2
2
#####.#####
#.#.......#
#.........#
#...#.#.#.#
#.........#
......#...#
#.........#
#.#.#.#.#.#
#.........#
#.#.....#.#
#####d#####

1
1
#####d#####
#.........#
#......#..#
#.......#.#
#.........#
#.........d
#.........#
#.........#
#.........#
#.........#
#####.#####

4
0
#####.#####
#.........#
#.........#
#.........#
#.........#
#....@.....
#.........#
#.........#
#.........#
#.........#
#####.#####

6
0
#####.#####
#k#.....#.#
#.........#
#.........#
#.........#
#..........
#.........#
#.#..#..#.#
#.........#
#.........#
#####d#####
key : 3

0
2
###########
#........X#
#.........#
#....####.#
#....#....#
......#...#
#....#....#
#.....#...#
#.........#
#.........#
#####.#####

3
0
#####l#####
#.........#
#.........#
#.........#
#.........#
#k.........
#.........#
#.........#
#.........#
#.........#
#####.#####
key : 1

2
1
#####.#####
#e#.......#
#.###.#...#
#..e#.....#
#..#e#....#
...#.#.....
#.........#
#.........#
#.........#
#......#..#
#####.#####
enemies 3

5
0
#####.#####
#.........#
#.........#
#.........#
#.........#
#..........
#.........#
#.#.......#
#..#......#
#.........#
#####.#####

3
1
#####.#####
#.........#
#.........#
#....##...#
#....#.#..#
..........l
#.........#
#.........#
#.........#
#.........#
#####l#####
locked : 0

4
2
#####.#####
#.........#
#.#.....#.#
#.........#
#.........#
..........#
#.........#
#.........#
#.#.......#
#.........#
###########

6
2
###########
#........e#
#.........#
#.........#
#.........#
..........#
#....#....#
#.....#...#
#.....#...#
#.....?..e#
###########
enemies 2
sign Many have walked this path.

0
1
###########
#.........#
#...#.#.#.#
#.........#
#.#...#...#
#..........
#.#.#...#.#
#.........#
#.#.#.....#
#.........#
#####d#####

1
2
#####.#####
#.........#
#.........#
#.........#
#.........#
d....e....#
#.....#...#
#.........#
#.........#
#.........#
#####.#####
boss
enemies 1

