3
1
#####l#####
#.........#
#..#......#
#.#.......#
#.........#
...........
#.........#
#.........#
#.........#
#.........#
###########

5
0
#####.#####
#.........#
#.........#
#.........#
#.........#
#.........#
#.........#
#.........#
#.........#
#k........#
###########
key : 0

2
1
###########
#.........#
#.........#
#.........#
#.........#
...........
#.........#
#.........#
#.........#
#.........#
#####l#####
locked : 0

2
0
###########
#.........#
#.........#
#.........#
#.........#
#..........
#.........#
#.......#.#
#......#..#
#.........#
#####.#####

3
0
#####.#####
#e........#
#.........#
#..#..#..##
#.........#
#e.........
#...#..#..#
#.........#
#.........#
#..#.....##
#####.#####
enemies 2

1
4
#####.#####
#.........#
#.........#
#.........#
#.........#
.....e.....
#.........#
#.........#
#.........#
#.........#
#####d#####
boss
enemies 1

3
3
#####d#####
#.........#
#..#......#
#.#.......#
#.........#
...........
#.........#
#.#.......#
#..#......#
#.........#
###########

2
3
#####.#####
#.........#
#..#......#
#.#.......#
#.........#
..........d
#.........#
#....#....#
#.........#
#.........#
#####d#####

2
2
#####d#####
#.......###
#......#k##
#........##
#......#..#
...........
#.........#
#.........#
#.........#
#.........#
#####.#####
key : 3

2
4
#####d#####
#..#.....##
#.........#
#.........#
#...#..#..#
d..........
#.........#
#..#......#
#.........#
#.........#
#####l#####

1
2
###########
#.........#
#..#......#
#.#.......#
#.........#
#..........
#.........#
#.#.......#
#..#......#
#.........#
#####d#####

1
5
###########
#.......ee#
#........?#
#.........#
#.........#
..........#
#.........#
#.........#
#.........#
#.........#
#####.#####
enemies 2
door 0 : 0
sign Beware what lurks ahead.

4
0
#####.#####
#.........#
#.........#
#.........#
#.........#
#....@....#
#.........#
#.........#
#.........#
#.........#
#####.#####

3
4
#####l#####
#.#.....#.#
#.........#
#.........#
#.#..#..#.#
...........
#.........#
#.#.....#.#
#.........#
#.........#
###########
locked : 3

3
5
#####.#####
#.........#
#..#......#
#.#.......#
#.........#
..........#
#.........#
#.......#.#
#......#..#
#........k#
###########
key : 7

2
5
#####.#####
#e........#
#.........#
#.........#
#.........#
.........e#
#.........#
#.........#
#.........#
#s........#
#####.#####
enemies 2
switch 0 : 0

0
4
###########
#X........#
#.........#
#.........#
#.........#
#.........#
#..#......#
#.........#
#.........#
#.........#
#####.#####

1
3
###########
#.........#
#......#..#
#.......#.#
#.........#
...........
#.........#
#.#.....#.#
#..#......#
#.........#
#####.#####

3
2
#####.#####
#.........#
#...#.....#
#.#k###...#
#..###....#
.....##....
#.#######.#
#.........#
#.........#
#.........#
###########
key : 2

