6
2
#####d#####
#.........#
#.........#
#.........#
#.........#
#.........#
#.........#
#.........#
#.........#
#.........#
###########

3
1
#####D#####
#.........#
#..#...#..#
#.##....#.#
#.........#
l.........D
#.........#
#.........#
#.........#
#.........#
#####D#####
locked : 0

4
0
#####D#####
#.........#
####......#
##.#......#
#...##....#
#....@....D
#.##.#....#
#.........#
#.........#
#.........#
#####D#####

3
0
###########
#k........#
#.......#.#
#.........#
#.........#
#....#....l
#.........#
#.........#
#.#.......#
#.........#
#####D#####
key : 0

1
2
#####D#####
#.........#
#.........#
#...#.##..#
#...#.....#
#..###....#
#...e.....#
#.........#
#.........#
#.........#
#####l#####
locked : 1
boss
enemies 1

5
3
#####D#####
#.........#
#.........#
#..#.#.#..#
#....#....#
D...####..#
#..##.#e..#
#..##.e#..#
#..#..##..#
#........e#
###########
enemies 3

4
1
#####D#####
##k#...#.##
#.........#
#.#.#.#.#.#
#.........#
D..#.#.#..D
#.........#
#.#.#.#...#
#.........#
#..#...#.##
#####D#####
key : 1

5
2
#####D#####
#s........#
#.........#
#.........#
#.........#
D.....##..D
#.....#e#.#
#.....#.###
#.......#e#
#.........#
#####d#####
enemies 2
switch 0 : 0

3
4
###########
#........e#
#...#.....#
##.#?.....#
#.###.....#
D..##.....#
#..##.....#
#..#......#
#.........#
#.........#
#####D#####
enemies 1
door 0 : 0
sign Many have walked this path.

0
2
###########
#X........#
#.........#
#.........#
#.........#
#.........#
#.....#...#
#.........#
#.........#
#.........#
#####D#####

2
2
#####l#####
#.........#
#.........#
#..#..#..##
#.........#
l.........#
#..#..#...#
#.........#
#.........#
#........##
#####D#####
locked : 2

2
1
###########
#k........#
#.........#
#....#....#
#.........#
#....#....l
#.........#
#.......###
#......#..#
#.........#
#####D#####
key : 3

4
4
#####D#####
#.........#
#..#......#
#.#.......#
#.........#
d.........#
#.........#
#.#.....#.#
#..#...#..#
#.........#
###########

4
2
#####D#####
#k........#
#..#......#
#.#.....#.#
#.........#
D......#..l
#.........#
#.........#
#.........#
#.........#
#####D#####
key : 2

5
1
#####D#####
#.........#
#.........#
#.........#
#..#.#....#
D..#......D
#...#.....#
#.........#
#.........#
#.........#
###########

3
2
#####D#####
#.........#
#.........#
#..#..#..##
#.........#
D.........d
#...#..#..#
#.........#
#.........#
#..#.....##
#####D#####

5
0
#####D#####
#.........#
#.........#
###.......#
#..#......#
#.........D
#.##......#
#...#.....#
#.........#
#.........#
###########

4
3
#####D#####
#.........#
#.........#
#.........#
#.........#
l.........d
#.........#
#.........#
#.........#
#.........#
#####D#####
locked : 3

3
3
###########
#.........#
#..#......#
#.#..##...#
#..#...#..#
d.....#...D
#.........#
#.........#
#.........#
#.........#
#####D#####

