3
0
#####.#####
#.........#
#.........#
#.........#
#.........#
#....@.....
#...#.....#
#...##....#
#..#......#
#.........#
#####l#####

2
2
#####.#####
#.........#
#..#...#..#
#.#.....#.#
#.........#
d.........l
#.........#
#.......#.#
#......#..#
#.........#
#####.#####

2
0
#####.#####
#.........#
#..#......#
#k#.......#
#.........#
#..........
#.........#
#.......#.#
#......#..#
#.........#
#####.#####
key : 0

3
1
#####.#####
#k........#
#.........#
##.#......#
#..#......#
...........
#....#....#
#...###...#
#.....#...#
#.........#
#####.#####
key : 1

2
1
#####l#####
#.........#
#.........#
#.........#
#.........#
..........d
#.........#
#.........#
#.........#
#.........#
#####.#####

0
0
###########
#.........#
#......#..#
#....#.#..#
#......##.#
#....#.#...
#....###..#
#.....##..#
#.........#
#.........#
#####.#####

2
3
###########
#........##
#......#..#
#.......#.#
#.#.......#
l.........#
#.........#
#.......#.#
#.....##..#
#.........#
###########
locked : 5

0
1
###########
#.........#
#.........#
#.........#
#.........#
...#......#
#.#.......#
###.......#
#.........#
#.........#
#####d#####

4
0
#####l#####
#.........#
#.#.....#.#
#.........#
#.........#
#..#..#....
#.........#
#.........#
#.......#.#
#.........#
#####.#####
locked : 0

1
1
#####d#####
#.........#
##..#..#..#
#.........#
#.........#
.......#...
#.........#
#.........#
##..#.....#
#.........#
#####l#####
locked : 3

6
1
#####d#####
#.........#
#.........#
#...##....#
#...#.##..#
#...#e.#..#
#...#.....#
#....##...#
#.........#
#.........#
#####.#####
boss
enemies 1

3
2
#####.#####
#.........#
#.........#
#.........#
#.........#
..........#
#.........#
#.........#
#.........#
#.........#
#####d#####

1
2
###########
#.........#
#.##..#...#
#.##.#....#
#.##..#...#
...#......#
#..##.....#
#.........#
#.........#
#.........#
#####.#####

7
1
#####.#####
#.........#
#.........#
##.##.....#
#.........#
#...#.....#
#X##......#
#####.....#
#.........#
#.........#
###########

5
1
#####.#####
#........k#
#........##
#.........#
#.........#
..........#
#.........#
#.#.......#
#..#......#
#.......#.#
#####d#####
key : 5

4
2
#####d#####
#.........#
#.........#
#..###....#
#...##....#
...#......#
#......#..#
#......#..#
#.....#...#
#.........#
###########

1
0
#####.#####
#.........#
#..#......#
#.#.#.....#
#.........#
#..........
#k#.......#
#.........#
#.........#
#.........#
#####.#####
key : 3

4
1
#####.#####
#.........#
##..#..#..#
#.........#
#.........#
...........
#.........#
#.........#
##.....#..#
#.........#
#####.#####

5
0
#####.#####
#.........#
#..#......#
#...#.....#
#.###.....#
#..##......
#...##....#
#...###...#
#...#.....#
#.........#
###########

