2
0
#####.#####
#.........#
#.........#
#.........#
#.........#
#..........
#.........#
#.........#
#.........#
#.........#
###########

1
3
###########
#....e....#
#.........#
#....#..#.#
#.........#
..........l
#.......#.#
#.........#
#.........#
#e#.....#e#
#####.#####
enemies 3

4
3
#####d#####
#.........#
#.#.......#
#.........#
#.........#
.....e....#
#.........#
#.........#
#.........#
#.........#
#####.#####
boss
enemies 1

5
3
#####.#####
#.........#
#..##.....#
#..###...##
#....###..#
#......#..#
#......##.#
#....##..##
#.........#
#X........#
###########

1
0
#####d#####
#.........#
#.........#
#.........#
#.#.@###..#
#..####....
#.###.##..#
#.#.#.....#
#.........#
#.........#
#####.#####

2
1
#####.#####
#k#.....#.#
#.........#
#.........#
#..#..#...#
...........
#.........#
#.#..#..#.#
#.........#
#.........#
###########
key : 1

1
2
#####d#####
#.........#
#.........#
#..#..#...#
#.........#
l..........
#...#..#..#
#.........#
#.........#
#..#.....##
#####.#####
locked : 0

1
4
###########
#.........#
#..#......#
#.#.......#
#.........#
l.........#
#.........#
#.#.......#
#..#......#
#........##
#####.#####
locked : 1

0
1
###########
#..k......#
#..#......#
#.#.......#
#.........#
...........
#.........#
#.......#.#
#......#..#
#.........#
#####.#####
key : 0

0
0
###########
#.........#
#.#.....#.#
#.........#
#.........#
#..#..#....
#.........#
#.........#
#.........#
#.........#
#####d#####

2
2
#####.#####
#.........#
#.........#
#.........#
#.........#
...........
#.........#
#.........#
#.........#
#.........#
#####.#####

2
3
#####.#####
#k........#
#.........#
#..#.....##
#.........#
...........
#..#..#...#
#.........#
#.........#
#..#.....##
#####.#####
key : 3

3
3
#####.#####
#.#.....#.#
#.........#
#.#.#.#.#.#
#.........#
d...#......
#.........#
#.#.#.#.#.#
#.........#
#.........#
#####d#####

2
4
#####.#####
#.........#
#..#......#
#.#.......#
#.........#
..........#
#.........#
#.#.....#.#
#..#...#..#
#.........#
#####l#####

3
4
#####l#####
#..#......#
#..##.....#
#...#.....#
#.........#
..........#
#...#.....#
##.#.#....#
#..#......#
####......#
###########
locked : 3

4
2
#####.#####
#.........#
#.........#
#.........#
#.......#.#
#......#...
#.....###.#
#....##.#.#
#.....#.#.#
#k........#
###########
key : 5

1
1
#####.#####
#.........#
#.........#
#.........#
#.........#
..........l
#.........#
#.#.......#
#..#......#
#.........#
#####.#####

3
2
#####.#####
#..#......#
#.###.....#
#..##.....#
#.........#
#.........d
#.........#
#.........#
#.........#
#.........#
#####.#####

0
2
###########
#.##......#
#.#.#.##..#
#.....##..#
#....#.#..#
..........#
#.........#
#.........#
#.........#
#.........#
#####d#####

