1
4
###########
##.#.....##
#.........#
#.#.#.#.#.#
#.........#
...#...#..d
#.........#
#.#.#.#.#.#
#.........#
##.#...#..#
#####.#####

1
5
#####.#####
#.........#
#......#..#
#......#..#
#.........#
d....e....#
#.........#
#.........#
#.........#
#.........#
#####.#####
boss
enemies 1

3
0
#####.#####
#?........#
#e##......#
#e###.....#
#.........#
#s.........
#.........#
#.........#
#.........#
#.........#
#####l#####
enemies 2
switch 0 : 0 1
sign Turn back; you are not yet ready.

3
1
#####.#####
#......#..#
#..#......#
#.........#
#.........#
..........#
#.........#
#.#.....#k#
#..#...#..#
#.........#
#####.#####
key : 2

2
3
#####d#####
#.........#
#..#......#
#.#.......#
#.........#
l..........
#.........#
#.........#
##........#
#.........#
#####d#####
locked : 0

1
3
###########
#.........#
#......#..#
#.......#.#
#.........#
...........
#.........#
#.........#
#.........#
#.........#
#####d#####

4
0
#####l#####
#.........#
#.#.....#.#
#.........#
#.........#
#....#....d
#.........#
#.........#
#.#.....#.#
#.........#
###########
locked : 2

2
2
#####l#####
#.........#
#..#......#
#.#.......#
#.........#
..........l
#.........#
#.#.......#
#..#......#
#.........#
###########

2
1
#####.#####
#k........#
#......#..#
#.......#.#
#.........#
...........
#.........#
#.#.......#
#..#......#
#.........#
#####.#####
key : 1

4
1
#####.#####
#.........#
#.........#
#.........#
#.........#
d.........#
#.........#
#...#.#...#
#.........#
#.........#
###########

0
5
###########
#X........#
##.#......#
###..#....#
#..#......#
#.........#
#.....#.#.#
#....#....#
#.........#
#.........#
#####.#####

3
4
#####.#####
#.........#
#.........#
#.........#
#.........#
..........#
#.........#
#.........#
#........?#
#.......ee#
###########
enemies 2
door 0 : 0 1
sign The dungeon remembers all who enter.

3
3
#####d#####
#.........#
##..#..#..#
#.........#
#.........#
#....#.....
#.........#
#.........#
##..#..#..#
#.........#
###########

2
4
#####.#####
#......#.##
#.........#
##.#.#.#..#
#.........#
.....#.#...
#.........#
##...#.#.##
#.........#
##.....#.##
#####.#####

1
0
###########
#.........#
#.........#
###.......#
#..###....#
#....@.....
#...#.....#
#.....#...#
#.........#
#.........#
#####.#####

1
2
###########
#.........#
#..#.....##
#.........#
#.....#...#
...........
#..#.#.#..#
#.........#
#...#.#.#.#
#.........#
#####l#####
locked : 1

2
5
#####.#####
#.#.....#.#
#.........#
#..#.#.#..#
#.........#
....#.#...#
#.........#
#..#...#.##
#.........#
#.#.....#k#
###########
key : 4

2
0
#####.#####
#.........#
#.........#
#.........#
#.........#
#..........
#.........#
#.......#.#
#......#..#
#.........#
#####.#####

1
1
###########
#.......#k#
#.........#
#.........#
#.......#.#
...........
#.........#
#.#.....#.#
#.........#
#.........#
#####.#####
key : 0

