2
1
###########
#.........#
#.........#
#.........#
#.....##..#
l..#......D
#..#..##..#
#..#...#..#
#..#...#..#
#..#......#
###########
locked : 0

2
2
#####D#####
#.........#
#..#...#..#
#.#.#...#.#
#.........#
D.....#...l
#.#.......#
#.........#
#.........#
#.........#
#####D#####

4
3
#####D#####
#.........#
#......#..#
#.......#.#
#.........#
D.........l
#.........#
#.#.......#
#..#......#
#.........#
#####d#####

4
4
#####D#####
#.........#
#.........#
#.........#
#.........#
l.........d
#..#......#
#.#.......#
#........##
#.........#
#####D#####
locked : 2

3
4
###########
#.#.....#.#
#.........#
#....#.#..#
#.........#
D...#.#...#
#.........#
#..#.#.#.##
#.........#
#.#.....#.#
#####D#####

1
3
#####D#####
##.#...#.##
#.........#
##.#.#.#.##
#.........#
D..#.#....#
#.........#
##.#.#.#.##
#.........#
##.....#.##
#####D#####

4
5
###########
#.........#
#.........#
#.........#
#.........#
d....e....#
#.........#
#.........#
#.........#
#.........#
#####D#####
boss
enemies 1

3
2
#####D#####
#.........#
#.........#
#.........#
#.........#
#k........D
#.........#
#.........#
#.........#
#.........#
#####d#####
key : 2

5
4
#####D#####
#.........#
#.#.#.#...#
#.........#
#..#.#.#..#
D.........D
#.#.#.#...#
#.........#
#..#...#..#
#..k......#
###########
key : 3

1
2
#####D#####
#.........#
#.........#
#.........#
#.........#
#k........D
#.........#
#.........#
#.........#
#.........#
#####D#####
key : 1

0
2
###########
#e........#
##.#...#.##
#?........#
#.#.#.#...#
#.........d
#..#......#
#.........#
#.#.#.#.#.#
#.........#
#####D#####
enemies 1
sign A useful tool lies just ahead.

2
3
#####D#####
#.........#
#.........#
#.........#
#.........#
l.........#
#.........#
#.......#.#
#......#..#
#.......#.#
#####D#####
locked : 1

3
3
#####D#####
#.........#
#..#......#
#.#.......#
#.........#
D.........D
#.........#
#.........#
#.........#
#.........#
#####D#####

2
0
#####D#####
#.........#
#.........#
#.........#
#.........#
#....@....l
#.........#
#.........#
#.........#
#?........#
###########
sign Seek the matching key before you proceed.

5
5
#####D#####
#.........#
#.........#
#.........#
#.........#
D.........#
#.........#
#.........#
#.........#
#........X#
###########

1
0
###########
##.#...#.##
#k........#
##.#.#.#..#
#.........#
#..#.#.#..#
#.........#
##.#.#.#..#
#.........#
##.#.....##
#####D#####
key : 0

0
3
###########
#.........#
#.........#
#.........#
#.........#
d.........#
#...###...#
#.........#
#.........#
#.........#
#####D#####

4
2
#####d#####
#.........#
#.........#
#.........#
#.........#
#.........D
#.........#
#.#.....#.#
#..#...#..#
#.........#
###########

5
3
#####d#####
#..#.....##
#.........#
#.........#
#...#..#..#
#.........D
#.........#
#..#..#...#
#.........#
#.........#
###########

