3
3
#####l#####
##.#......#
##.##.....#
##..##....#
#.....#...#
.....e....#
#.....#...#
#.........#
#.........#
#.........#
#####.#####
locked : 2
boss
enemies 1

5
1
#####.#####
#.........#
#......#..#
#.......#.#
#.........#
..........#
#.........#
#.........#
#.........#
#.........#
###########

2
2
#####.#####
#.........#
#..#...#.##
#.........#
#..#...#..#
...........
#..#.#.#..#
#.........#
##.#...#.##
#.........#
#####d#####

4
1
#####.#####
#.........#
##.#...#.##
#.........#
#..#.#.#..#
..........d
#..#...#..#
#.........#
#..#...#.##
#.........#
#####.#####

4
3
#####.#####
#.........#
#.........#
#.....#.#.#
#.....#...#
..........#
#.........#
#.........#
#.........#
#........X#
###########

1
2
#####.#####
#s........#
#.........#
#..#..#..##
#.........#
#e.........
#...#..#..#
#.........#
#.........#
#..#.....##
#####.#####
enemies 1
switch 0 : 0 1

2
1
###########
#.........#
#.........#
#.........#
#.........#
...........
#.........#
#.........#
#.........#
#.........#
#####d#####

3
2
#####d#####
#......#..#
#.........#
#.........#
#...#.....#
...........
#.........#
##..#..#..#
#.........#
#.........#
#####.#####

2
3
#####.#####
#e#.....#e#
#.........#
#.........#
#....#..#.#
..........l
#.........#
#....#..#.#
#.........#
#?........#
#####l#####
enemies 2
door 0 : 0 1
sign Only the prepared may pass.

3
0
#####.#####
#.........#
#.........#
#.........#
#.........#
#.........l
#.........#
#k#.......#
#..#..#...#
#.........#
#####.#####
key : 0

5
0
#####.#####
#.#.......#
#.........#
#.##..#...#
#..#.##...#
#...#@.....
#.........#
#........##
#.........#
#.........#
###########

4
2
#####.#####
#..#......#
#.........#
#...#...#.#
#.........#
d....#.#...
#.........#
#...#...#.#
#.........#
##.#...#.##
###########

1
3
###########
#....k....#
#.........#
#.........#
#.........#
...........
#.........#
#.........#
#.........#
#.........#
#####.#####
key : 3

2
4
#####.#####
#.........#
#.........#
#.#.....#.#
#.....###.#
l.....#...#
#......#..#
#....##...#
#.........#
#.........#
###########
locked : 4

3
1
#####d#####
#.........#
#.........#
#.........#
#.........#
l..........
#.........#
#.........#
#.........#
#.........#
#####.#####
locked : 0

2
0
###########
#.........#
##.#...#.##
#.........#
#....#.#..#
#..........
#..#...#..#
#.........#
#..#...#.##
#.........#
#####.#####

1
4
###########
#......#.k#
#.........#
#......#..#
#.........#
...#......#
#...#.....#
#...#.....#
##.#......#
##........#
#####.#####
key : 4

0
2
###########
#k........#
#.........#
#....#.##.#
#...###.#.#
#...#.....#
#...##....#
#....####.#
#..#......#
#.........#
#####.#####
key : 2

4
0
#####.#####
#.........#
#......#..#
#.......#.#
#.........#
#..........
#.........#
#.......#.#
#......#..#
#.........#
#####.#####

