3
4
#####D#####
#.........#
#.........#
#.........#
#..##.....#
D..##e....#
#..##.....#
####......#
#.#.#.....#
#.........#
#####d#####
boss
enemies 1

0
2
###########
#.........#
#.......#.#
#.........#
#.........#
#....#....#
#.........#
#.........#
#.......#.#
#.........#
#####d#####

5
0
#####D#####
#.#.....#.#
#.........#
#..#.#.#..#
#.........#
#.....#...D
#.........#
#..#.#.#.##
#.........#
#e#?....#.#
###########
enemies 1
sign Seek the matching key before you proceed.

2
2
#####D#####
##.#.....##
#k........#
##...#.#..#
#.........#
#......#..d
#.........#
##.#.#.#.##
#.........#
##.#...#.##
#####D#####
key : 1

3
3
#####D#####
#.........#
#.........#
#.........#
#.........#
d.........D
#.........#
#.......#.#
#......#..#
#.........#
#####D#####

4
1
#####D#####
#k........#
#.........#
#.........#
#.........#
D..#..#...D
#.........#
#.........#
#.#.....#.#
#.........#
#####l#####
key : 0

4
4
#####d#####
#.........#
#..#......#
#.#.......#
#.........#
l.........#
#.........#
#.........#
#.........#
#.........#
###########
locked : 3

6
1
#####D#####
#.........#
#..#...#..#
#.#.....#.#
#.........#
#.........#
#.........#
#.#.......#
#..#......#
#.........#
###########

2
4
###########
#........X#
#.........#
#.........#
#.........#
D.........#
#.........#
#.........#
#.........#
#.........#
#####D#####

4
0
###########
#?........#
#.........#
#.........#
#.........#
#....@....D
#.#.#.....#
#.#.#.....#
#..#......#
#.........#
#####D#####
sign What you seek is close.

5
1
#####l#####
#.........#
#.........#
#.........#
#.........#
D.........D
#.........#
#.#.....#.#
#..#...#..#
#.........#
#####D#####
locked : 0

4
2
#####D#####
#k........#
#..#......#
#.#.......#
#....#....#
D.........l
#.........#
#.......#.#
#..#...#..#
#.........#
#####l#####
key : 2

3
2
#####D#####
#.......#.#
#.........#
#.........#
#..#......#
D.........d
#.........#
#.#.....#.#
#.........#
#.........#
#####D#####

3
1
###########
#.........#
#.........#
##..#..#..#
#.........#
#.........D
#...#.....#
#.........#
#.........#
##.....#..#
#####D#####

2
3
#####D#####
#.........#
#......#..#
#.......#.#
#.........#
d.........D
#.........#
#.........#
#.........#
#.........#
#####D#####

4
3
#####D#####
#........##
#.........#
#.........#
#.........#
l.........l
#.........#
#.........#
#.........#
##........#
###########
locked : 2

5
2
#####l#####
#.........#
#.........#
#.........#
#.........#
D.........#
#.........#
#.........#
#.........#
#.........#
###########
locked : 1

1
3
###########
#........k#
#.#.#.#...#
#.........#
#.#.#.#.#.#
D.........#
#.#.#.#.#.#
#.........#
#.#.#.#.#.#
#.........#
#####D#####
key : 3

1
2
#####d#####
#.........#
#.#...#...#
#.........#
#..#.#.#..#
#.........D
#.#.#.#.#.#
#.........#
#......#.##
#.........#
#####D#####

