3
2
#####.#####
#..#.....##
#.........#
#.........#
#..#......#
..........d
#.........#
#.....#..##
#.........#
#.........#
#####.#####

4
4
#####d#####
#.........#
#.........#
#.........#
#.........#
l.........#
#.........#
#.........#
#.........#
#.........#
###########
locked : 3

4
2
#####.#####
#k........#
###.#.....#
#.........#
#..###....#
....#.....l
#.#.##....#
#.........#
#.#.......#
#.........#
#####l#####
key : 2

2
2
#####.#####
#.........#
#......#..#
#.......#.#
#k#.....#.#
#.........d
#.........#
#.........#
#.........#
#.........#
#####.#####
key : 1

4
3
#####.#####
#.........#
#...#..#..#
#.........#
#.........#
l....#....l
#.........#
#.........#
#...#..#..#
#.........#
###########
locked : 2

3
3
#####.#####
#.#.......#
#.........#
#.........#
#..#..#...#
d..........
#.........#
#.#..#..#.#
#.........#
#.........#
#####.#####

1
2
#####d#####
#.........#
#.#.#.....#
#....##...#
#..##.....#
#..#.#.....
#.........#
#.........#
#.........#
#.........#
#####.#####

5
2
#####l#####
#.........#
#...#..#..#
#.......#.#
#.........#
..........#
#.........#
#.......#.#
#......#..#
#.#.......#
###########
locked : 1

4
0
###########
#?........#
#.........#
#.........#
#...#.....#
#...#@.....
#....#....#
#.........#
#........##
#..#......#
#####.#####
sign What you seek is close.

4
1
#####.#####
#k........#
#.........#
#.........#
#.........#
...........
#.........#
#.......#.#
#......#..#
#.........#
#####l#####
key : 0

1
3
###########
#........k#
#.........#
#.#.#.....#
#.#.#.....#
....#.....#
#.###.....#
#.##......#
#.........#
#.........#
#####.#####
key : 3

6
1
#####.#####
#.........#
#.#.....#.#
#.........#
#.........#
#..#......#
#.........#
#.........#
#.......#.#
#.........#
###########

2
3
#####.#####
#.........#
#...#.#...#
#......##.#
#...###.#.#
d.....#....
#.........#
#.........#
#.........#
#.........#
#####.#####

3
4
#####.#####
##........#
#.........#
#.........#
#.........#
.....e#...#
#.........#
#.........#
#.........#
#.........#
#####d#####
boss
enemies 1

5
0
#####.#####
#.........#
#..##.##..#
#....###..#
#...#.....#
#....#.#...
#...##..#.#
#.........#
#?........#
#e........#
###########
enemies 1
sign Seek the matching key before you proceed.

2
4
###########
#........X#
#.........#
#.........#
#.........#
..........#
#....#....#
#.........#
#.........#
#.........#
#####.#####

3
1
###########
#......#.##
#.........#
#.#.#.#.#.#
#.........#
#..#...#...
#.........#
#.#.#.....#
#.........#
##.#.....##
#####.#####

5
1
#####l#####
#.........#
#......#..#
#.......#.#
#.........#
...........
#.........#
#.#.......#
#..##.....#
#.........#
#####.#####
locked : 0

0
2
###########
#.........#
#..#......#
#.#.......#
#.........#
#.........#
#.........#
#.#.......#
#..#......#
#.........#
#####d#####

