5
1
#####D#####
#.........#
#......#..#
#.......#.#
#.........#
l.........D
#.........#
#.........#
#.........#
#.........#
#####D#####
locked : 0

2
0
###########
#.........#
#.....#.#.#
#.........#
#...#.#.#.#
#.........D
#.#...#.#.#
#.........#
#.....#.#.#
#.........#
#####D#####

4
2
#####D#####
#.........#
#.........#
#.........#
#.........#
D.........#
#.........#
#.......#.#
#......#..#
#.........#
#####D#####

0
3
###########
#X........#
#.........#
#.........#
#..###....#
#..#.#....#
#..#......#
#.........#
#..p......#
#.........#
#####D#####

3
0
#####D#####
#.........#
#.##....p.#
#.###.....#
#.........#
#...#@....D
#?#.##....#
#.........#
#.........#
#......p..#
#####D#####
sign A useful tool lies just ahead.

4
1
#####D#####
#.......#.#
#.....###.#
#.....###.#
#...#...#.#
D...##....D
#.........#
#.........#
#.........#
#.........#
#####D#####

2
1
###########
#.#.....#.#
#.........#
#.#.#.#.#.#
#.........#
D...#.#...D
#.........#
#.#.#.#.#.#
#.........#
#.#.....#.#
#####D#####

3
3
#####d#####
#.........#
###.......#
###.......#
#.##......#
D..#.#....#
#..###....#
#..##.....#
#.........#
#.........#
###########

2
2
#####D#####
#k........#
#..#...#..#
#.#.....#.#
#.........#
D.........l
#.........#
#.........#
#.........#
#.........#
#####D#####
key : 2

1
3
#####D#####
#.........#
#.........#
#.........#
#...###...#
D...e#....#
#...###...#
#.........#
#.........#
#.........#
#####d#####
boss
enemies 1

2
4
###########
#........k#
#..##.....#
#.........#
#.........#
D.........#
#.........#
#.........#
#.........#
#.........#
###########
key : 9

5
2
#####D#####
#.........#
#.........#
#.........#
#.........#
D.........#
#.........#
#.........#
#........?#
#.......ee#
###########
enemies 2
door 0 : 0
sign This door will not yield without a key.

1
2
###########
#ee.......#
#e........#
#?........#
#.........#
#.........D
#.........#
#.........#
#.........#
#.........#
#####D#####
enemies 3
sign The brave are rewarded.

2
3
#####d#####
#.........#
#.........#
#.........#
#.........#
l.........D
#.........#
#.........#
#.........#
#.........#
#####d#####
locked : 2

4
0
#####D#####
#e........#
#.........#
#?........#
#s........#
#e........D
#.........#
#.........#
#.........#
#.........#
#####d#####
enemies 2
switch 0 : 0
sign The dungeon remembers all who enter.

3
1
#####D#####
#k........#
#..#......#
#.#.......#
#.........#
D.........d
#.........#
#.#.....#.#
#..#...#..#
#.........#
#####D#####
key : 0

6
1
#####D#####
#.........#
#.........#
#...#.....#
#.........#
#.........#
#......#..#
#.........#
#.........#
##.......k#
###########
key : 4

5
0
#####d#####
#.........#
#.........#
#.........#
#.........#
#.........l
#.........#
#.........#
#.........#
#.........#
###########

3
2
#####D#####
###.......#
####......#
##...#....#
#.##.#....#
d.........D
#.........#
#.........#
#.........#
#.........#
#####D#####

