3
1
#####D#####
##.....#.##
#.........#
#.#...#.#.#
#.........#
#..#.#.#..D
#.........#
#.#...#...#
#.........#
#..#...#.##
#####D#####

2
4
###########
#.........#
#..#......#
#.#......##
#.........#
D.........#
#..#......#
#.........#
#..#......#
#.........#
###########

2
3
#####d#####
#.#.....#.#
#.........#
#.........#
#..#..#...#
D.........D
#.........#
#.#..#..#.#
#.........#
#.........#
#####d#####

3
2
#####l#####
#.........#
#.........#
#..##..#..#
#..##.##..#
D...#.##..D
#..##.##..#
#..#.#.#..#
#.........#
#.........#
#####D#####

5
1
#####d#####
#k........#
#.........#
#.........#
#.........#
D.........D
#.........#
#.........#
#.........#
#.........#
#####D#####
key : 0

4
1
#####D#####
#.........#
#.........#
#....#...##
#....#..#.#
D....#....l
#....#..#.#
#.....#..##
#..p......#
#.........#
#####d#####

4
4
###########
#........k#
#.........#
#.........#
#.........#
D.........#
#...#.....#
#.........#
#.#.......#
#.........#
###########
key : 3

3
3
#####d#####
#.........#
#..#......#
#.#.......#
#.........#
D........k#
#.........#
#.........#
#.........#
#.........#
#####D#####
key : 2

4
0
###########
#.........#
#.........#
#.........#
#.........#
#...#.....D
#.###.....#
#.#.......#
#.###.....#
#.##......#
#####D#####

6
1
#####D#####
#.........#
#.........#
#.........#
#.........#
#.........#
#.........#
#.........#
#.........#
#e.......?#
###########
enemies 1
sign A useful tool lies just ahead.

5
3
#####D#####
#........##
#.....#####
#....#.##.#
#....#..#.#
D....#....#
#.........#
#.........#
#.........#
#.........#
###########

2
2
###########
#.........#
#...#.###.#
#....#..#.#
#....#.#..#
D......#..D
#.......#.#
#.........#
#.........#
#.........#
#####l#####
locked : 1

0
3
###########
#X........#
#.........#
#.........#
#.####....#
#..###....#
#.........#
#.####....#
#..#..#...#
#.........#
#####D#####

2
1
###########
#k........#
#.........#
#..#.....##
#.........#
#.........D
#......#..#
#.........#
#.........#
#........##
#####D#####
key : 1

4
2
#####D#####
#.........#
#.........#
#.#..#..#.#
#.........#
l.........D
#..#..#...#
#.........#
#.........#
#.#.......#
#####d#####
locked : 0

4
3
#####D#####
#e.......?#
#.........#
#.........#
#.........#
D....#....D
#.........#
#.........#
##........#
#e........#
#####D#####
enemies 2
sign Seek the matching key before you proceed.

1
3
#####D#####
#.........#
#..#......#
#..##.....#
#...####..#
#...e##...#
#.........#
#.........#
#.........#
#.........#
#####d#####
boss
enemies 1

5
2
#####d#####
#.........#
#......#.##
#....#..###
#....#.#..#
D.........D
#.....###.#
#.........#
#.........#
#.........#
###########

5
0
#####D#####
#.##...####
#..#...##.#
#.#...#.#.#
#....##...#
#....@....D
#.........#
#.........#
#.........#
#.........#
###########

