0
1
###########
#.........#
#.........#
#.........#
#.........#
#..##......
#....#....#
#...##....#
#.........#
#.........#
#####.#####

5
0
#####d#####
#.........#
#..#...#.##
#.........#
#...#...#.#
#..........
#..#...#..#
#.........#
#.#.#.#.#.#
#.........#
#####d#####

3
0
#####l#####
#.......#.#
#.........#
#..#.#.#.##
#.........#
#.....#....
#.........#
#.........#
#.........#
#.#.....#.#
#####.#####
locked : 0

0
3
###########
#.........#
#.........#
#.........#
#.........#
..........#
#.........#
#.........#
#.........#
#.........#
###########

6
0
#####d#####
#.........#
#.........#
#.........#
#.........#
#.........#
#.........#
#.#.......#
#..#......#
#.........#
#####d#####

4
0
#####.#####
#.........#
#......#..#
#.......#.#
#.........#
#..........
#.........#
#.........#
#.........#
#.........#
#####d#####

1
2
#####d#####
#.........#
#......#..#
#.......#k#
#.........#
..........#
#.........#
#.........#
#.........#
#.........#
#####.#####
key : 3

5
1
#####.#####
#.........#
#.....#...#
#...###.#.#
#...##.#..#
.....#....#
#...#.#...#
#......#..#
#.........#
#.........#
###########

2
0
#####.#####
#......####
#......#?##
#.....#...#
#...@#..#.#
#....#.....
#.........#
#.........#
#.........#
#.........#
#####l#####
sign Turn back; you are not yet ready.

1
0
###########
##.....#..#
#k........#
#.........#
#...#..#..#
#..........
#.........#
#...#..#..#
#.........#
#.........#
#####.#####
key : 0

0
2
###########
#.........#
#..#...#..#
#.#....##.#
#.........#
...#.......
#.........#
#.#.......#
#..#......#
#.........#
#####d#####

2
1
#####.#####
#k........#
#.........#
#.........#
#.........#
..........l
#.........#
#.........#
#.........#
#.........#
#####.#####
key : 1

7
1
###########
#.......ee#
#.........#
#.........#
#.........#
..........#
#.........#
#.........#
#.........#
#.......?e#
###########
enemies 3
door 0 : 0
sign Beware what lurks ahead.

1
1
#####.#####
#.........#
#.........#
#.........#
#..#.##...#
....#.#....
#.....##..#
#..#..##..#
#...#.....#
#.........#
#####.#####

7
0
#####d#####
#......#..#
#......#..#
#....##...#
#....###..#
#....e##...
#...###...#
#..#..##..#
#...#.....#
#.........#
#####.#####
boss
enemies 1

8
0
#####.#####
#.........#
#.........#
#.........#
#.........#
#.........#
#....#....#
#....#....#
#.........#
#X........#
###########

3
1
#####.#####
##.......##
#..##....k#
#.#.......#
#.........#
..........#
#.........#
#.#.......#
#..#......#
#.........#
#####.#####
key : 2

4
1
#####.#####
#e........#
#.........#
#.........#
#.........#
.....#...e#
#..###....#
#..s......#
####......#
#e........#
#####.#####
enemies 3
switch 0 : 0

2
2
#####.#####
#......#..#
#.........#
#.........#
#......#..#
l.........#
#.........#
##..#..#..#
#.........#
#.........#
###########
locked : 2

