2
0
###########
#.........#
#...#.....#
#.#..#....#
#...##....#
#..####...D
#.##.##...#
#.........#
#.........#
#.........#
#####D#####

6
0
#####D#####
#.........#
#.........#
#.........#
#.........#
#.....##..#
#....###..#
#....##.#.#
#.....#.#.#
#.......###
###########

3
1
#####D#####
#.........#
#......#..#
#.......#.#
#.........#
D.........#
#.........#
#.........#
#.........#
#.........#
#####D#####

4
2
###########
#......##.#
#.........#
#........##
#....###..#
d....#....d
#.........#
#.........#
#.........#
#.#.......#
###########

3
0
#####D#####
#.........#
#.........#
#.........#
#.........#
#....@....D
#.........#
#.........#
#.........#
#.........#
#####D#####

4
1
#####D#####
#k........#
##........#
#.........#
#..#......#
D.........d
#.........#
#.#.......#
#..#......#
#......#..#
#####D#####
key : 1

2
1
#####D#####
#e........#
#.##......#
#.e##.....#
#.##......#
D.........D
#.........#
#.........#
#.........#
#e#.......#
#####D#####
enemies 3

1
4
###########
#.........#
#.........#
#.........#
#.........#
d....e....#
#.........#
#.........#
#.........#
#.........#
#####D#####
boss
enemies 1

2
3
#####D#####
#.........#
#......#..#
#.....##..#
#....#k...#
D....###..D
#....#.#..#
#....#....#
#.........#
#.......#.#
###########
key : 4

2
4
#####D#####
#......#..#
#.......#.#
#......#..#
#.........#
D.........#
#.........#
#.........#
#.........#
#........X#
###########

4
0
#####D#####
#.........#
#..#......#
#.#.......#
#.........#
#.....#...D
#k#.......#
#.........#
#.........#
#..#......#
#####l#####
key : 0

1
3
#####D#####
#.........#
#..#...#..#
#.#.....#.#
#.........#
l.........d
#.........#
#.........#
#.........#
#.........#
#####D#####
locked : 3

1
2
###########
#.........#
#.........#
#..#..#...#
#.........#
D.........l
#...#..#..#
#.........#
#.........#
#..#.....##
#####d#####

5
1
#####D#####
#.#.....#.#
#.........#
#...#.#.#.#
#.........#
D...#.#...#
#.........#
#.#.#.#.#.#
#.........#
#.#.....#.#
###########

1
1
###########
#k........#
#...#.#.#.#
#.........#
#....#.#..#
#.........D
#.#.#.#...#
#.........#
#..#...#.##
#.........#
#####D#####
key : 3

2
2
#####d#####
#?........#
#.........#
#.........#
#.........#
D.........D
#.........#
#.........#
#.........#
#....e....#
###########
enemies 1
sign Something glints behind that door…

5
0
#####l#####
#........##
#.........#
#.........#
#..#......#
#.........D
#.........#
#.......#.#
#......#..#
#.........#
#####D#####
locked : 1

0
3
###########
#e.......?#
#.........#
#.........#
#.........#
#.........#
#.###.....#
#.##......#
#p#.#..p..#
###.......#
#####D#####
enemies 1
sign Only the prepared may pass.

4
3
###########
#.#.......#
#.........#
#.........#
#.#..#..#.#
d.........#
#.........#
#.#..#....#
#.........#
#.........#
###########

