4
3
#####.#####
#.........#
#.........#
#.........#
#.........#
..........l
#.........#
#.......#.#
#.#....#..#
#.........#
###########

6
1
#####.#####
#.#.....#.#
#.........#
#..#.#.#..#
#.........#
#...#.#...#
#.........#
#..#.#.#.##
#.........#
#k#.....#.#
###########
key : 1

4
4
#####.#####
#.........#
#.........#
##........#
#.....#...#
l.........l
#.........#
#........##
#.........#
#.........#
#####.#####
locked : 0

5
4
#####.#####
#.........#
#.........#
##..#..#..#
#.........#
#.........#
#.#..#..#.#
#.........#
#.........#
#k.....#..#
###########
key : 3

4
1
#####d#####
##........#
#.........#
#.#.#.#.#.#
#.........#
...#.#.#...
#.........#
#.#.#.#.#.#
#.........#
##.....#.##
#####.#####

3
4
#####.#####
#.........#
#..#......#
#.#.......#
#.........#
.........k#
#.........#
#.........#
#.........#
#.........#
#####.#####
key : 2

4
5
###########
#.........#
#..#...#.##
#.........#
#.#.#.#...#
l.........#
#....#.#..#
#.........#
#.#.#.#...#
#.........#
###########
locked : 1

2
3
#####l#####
#.........#
#.........#
#.........#
#.........#
#..#.#.#..d
#.###.##..#
#.##..#...#
####......#
##.....#..#
#####l#####
locked : 2

5
1
#####.#####
##.....#..#
#.........#
#.........#
#.........#
#.........#
#.........#
##..#..#..#
#.........#
#.........#
#####.#####

3
3
#####l#####
##.....#..#
#.........#
#.........#
#...#..#..#
d..........
#.........#
##..#..#..#
#.........#
#.........#
#####.#####

2
4
#####.#####
#.........#
#......#..#
#.......#.#
#.........#
d.........#
#.........#
#.......#.#
#......#..#
#.........#
#####.#####

0
3
###########
#e.......?#
#.........#
#..#......#
#.........#
#.........#
#.....#...#
#.........#
#.........#
#..#.....##
#####.#####
enemies 1
sign Seek the matching key before you proceed.

1
4
###########
#........X#
#.........#
#.##.#....#
#..#.#....#
...###....#
#.#...#...#
#.#..#....#
#.........#
#.........#
#####.#####

2
1
###########
#.......###
#.....##.k#
#.....##.##
#......#..#
#....###..#
#.....#...#
#.........#
#.........#
#.........#
#####.#####
key : 0

3
1
#####.#####
#.........#
#.###...#.#
#.#.#.###.#
#.........#
...##......
#.........#
#.........#
#.........#
#.........#
#####d#####

1
3
#####.#####
#.........#
#.........#
#.........#
#.........#
#....e.....
#.........#
#.........#
#.........#
#.........#
#####l#####
locked : 3
boss
enemies 1

4
2
#####d#####
#.........#
#.........#
##.....#..#
#.........#
...........
#...#..#..#
#.........#
#.........#
##.....#..#
###########

4
0
#####.#####
#.........#
#.........#
#.........#
#.#.##@...#
#...##.....
#...##....#
####......#
#.###.....#
#.........#
###########

3
2
###########
#.........#
##.#.....##
#.........#
#..#.#.#..#
..........d
#..#.#....#
#.........#
##.#...#.##
#.........#
#####d#####

3
0
###########
#.........#
#.#.#.....#
#.........#
#..#.#....#
#..........
#.#.#.....#
#.........#
#..#...#..#
#.........#
#####.#####

