1
2
###########
#........e#
#.........#
#....###..#
#....##...#
.......#..#
#.....#.#?#
#....#...##
#.........#
#.........#
###########
enemies 1
sign The dungeon remembers all who enter.

3
2
###########
##s...e#..#
#e........#
##...#.#.##
#.........#
...#.#.#..d
#.........#
##.#.#.#.##
#e........#
##.....#..#
#####.#####
enemies 3
switch 0 : 0

5
0
#####.#####
#k#.......#
#.........#
#.........#
#..###....#
#....##...l
#....#....#
#.........#
#.........#
#.........#
#####.#####
key : 0

4
1
#####.#####
#e.......e#
#..#...#.##
#.........#
#.#.#.....#
...........
#..#.#.#..#
#.........#
#.#.#.#.#.#
#?........#
#####.#####
enemies 2
sign Only the prepared may pass.

3
3
###########
#.........#
#.........#
#.........#
#.........#
d.........#
#.........#
#.#.......#
#..#......#
#.........#
#####.#####

5
2
#####.#####
#.........#
#.........#
#.........#
#.........#
d..........
#.........#
#.#.......#
#..#......#
#.........#
###########

5
1
#####.#####
#.........#
#..#..#..##
#.........#
#.........#
l...#.....d
#.........#
#.........#
#..#..#..##
#.........#
#####.#####
locked : 1

4
2
#####.#####
#k........#
#.........#
#..#..#..##
#.........#
...........
#...#..#..#
#.........#
#.........#
#..#.....##
#####.#####
key : 2

1
1
#####.#####
#.......#.#
#.......#.#
#.....##..#
#...###...#
#...e##....
#......#..#
#.........#
#.........#
##........#
#####d#####
boss
enemies 1

6
3
#####.#####
#.........#
#.........#
#.........#
#.........#
#.........#
#.........#
#.........#
#e........#
#e.......e#
###########
enemies 3
door 0 : 0

5
3
#####.#####
#.........#
#..#......#
#.#.......#
#.........#
..........#
#.........#
#.......#k#
#......#..#
#.........#
#####.#####
key : 4

6
1
#####.#####
##.....#..#
#.........#
#.........#
#.#..#..#.#
..........#
#.........#
##.....#..#
#.........#
#.........#
#####.#####

4
0
###########
#?.#......#
#..#..#...#
#.#..#....#
#..#..#...#
#....@.....
#..##.....#
#...#.....#
#.###.....#
#.........#
#####.#####
sign Those who search shall find.

4
3
#####.#####
#.........#
#......#..#
#.......#.#
#.........#
..........#
#.........#
#.......#.#
#......#..#
#.........#
#####.#####

6
0
#####.#####
#.........#
#.........#
#..#.....##
#.........#
#..........
#...#..#..#
#.........#
#.........#
#k.#......#
###########
key : 1

2
1
#####d#####
#.......#.#
#.........#
#.........#
#.#..#..#.#
#.........#
#.........#
#.#..#..#.#
#.........#
#.........#
#####d#####

3
1
#####d#####
#.........#
#.........#
#......#..#
#.........#
#..........
#.........#
#..#......#
#.........#
#.........#
#####.#####

0
1
###########
#X........#
#.......#.#
#....###..#
#...###.#.#
#....##...#
#...##....#
#.........#
#.........#
#.........#
#####.#####

7
1
#####.#####
#.........#
#......#..#
#.......#.#
#.........#
#....#....#
#.........#
#.#..#...##
#..#......#
#.........#
###########

