4
3
#####D#####
#e........#
#.........#
#..#..p...#
#..#......#
D..#......D
#.##......#
#.##......#
#.#ep.....#
#?........#
#####D#####
enemies 2
sign A useful tool lies just ahead.

4
4
###########
#.#.....#k#
#.........#
#.........#
#.#.....#.#
D.........#
#.........#
#.#.....#.#
#.........#
#.........#
#####D#####
key : 6

2
1
#####D#####
#......##.#
#...#..##.#
#.p.####..#
#......##.#
D.........d
#.........#
#..p......#
#.........#
#.........#
#####D#####

2
2
###########
#.........#
#..#...##.#
#...#.###.#
#..#...#..#
d.........#
#.........#
#.........#
#.........#
#.........#
###########

3
3
###########
#e........#
##..#..#..#
#.........#
#.........#
#.........#
#.........#
#.........#
##..#.....#
#.........#
#####D#####
enemies 1
door 0 : 0 1

6
2
#####d#####
#.........#
#.........#
#.........#
#.........#
#.........#
#.........#
#.#.......#
#..#......#
#.........#
###########

3
0
#####D#####
#.........#
#.........#
#.........#
#.........#
#....@....l
#.........#
#.........#
#.........#
#.........#
#####D#####

5
4
#####D#####
#.........#
#.........#
#.........#
#.........#
d....e....#
#.........#
#.........#
#.........#
#.........#
#####D#####
boss
enemies 1

4
2
###########
#.........#
#.........#
#.........#
#.........#
D..#......D
#.##......#
##.#......#
##........#
#k........#
#####D#####
key : 1

3
1
#####D#####
#.........#
#.........#
#.........#
#.........#
l.........#
#.........#
#.........#
#.........#
#.........#
#####D#####
locked : 0

6
4
#####D#####
#.........#
#.........#
#.........#
#.........#
#.........#
#.........#
#.........#
#.........#
#X........#
###########

1
1
###########
#......?ee#
#........e#
#.........#
#....#....#
D.........#
#.##.#.#..#
#.#.......#
#.........#
#.........#
#####D#####
enemies 3
sign Many have walked this path.

1
0
#####d#####
#s........#
#e#.....#.#
#.........#
#....#.#..#
#e........D
#...#.#.#.#
#.........#
#..#...#.##
#........e#
#####D#####
enemies 3
switch 0 : 0 1

2
0
#####D#####
#.........#
#.........#
#.........#
#.........#
#.........D
#.........#
#.........#
#.........#
#.........#
#####D#####

0
0
###########
#.........#
#.........#
#.........#
#.........#
#.........#
#.........#
#.........#
#.........#
#.........#
#####d#####

4
1
#####D#####
##.#...#..#
#.........#
#...#.#.#.#
#.........#
D..#.#.#..D
#.........#
#.#...#...#
#.........#
##.....#.##
###########

5
2
#####D#####
#k#.....#.#
#.........#
#..#.#.#..#
#.........#
#...#.#...D
#.........#
#....#.#.##
#.........#
#.#.....#.#
#####d#####
key : 3

4
0
#####D#####
#.#.......#
#.........#
#.#.#.#.#.#
#.........#
#...#.#...D
#.........#
#.#.....#.#
#.........#
#k#.....#.#
###########
key : 0

5
3
#####D#####
#.........#
#.........#
#.#.......#
#.#.......#
D.........d
#..#......#
#.#.......#
#..#......#
#.........#
###########

