3
1
#####d#####
#.........#
#.........#
##.....#..#
#.........#
..........#
#...#..#..#
#.........#
#.........#
#......#..#
###########

5
1
###########
#.......#.#
#.........#
#.........#
#.........#
..........#
#.........#
#.....##..#
#.........#
#.........#
#####d#####

0
2
###########
#.##.....X#
#...#.....#
##........#
#..##.....#
......#...#
#.....###.#
#.....##..#
#.........#
#.........#
#####.#####

7
0
#####.#####
#.........#
#......#..#
#.........#
#.........#
#k........l
#.........#
#.........#
#.........#
#.........#
#####.#####
key : 1

8
0
#####.#####
#.........#
#.........#
#.........#
#.........#
#.........#
#.........#
#.........#
#.........#
#k........#
###########
key : 4

0
1
###########
#.......#.#
#.........#
#.#...#.#.#
#.........#
#...#.#....
#.........#
#.....#.#.#
#.........#
#.#.....#.#
#####d#####

2
2
#####.#####
#.........#
#.........#
#.........#
#.#.#.#.#.#
..........#
#....#.#..#
#.........#
#.#.#...#e#
#...?...ee#
###########
enemies 3
sign This door will not yield without a key.

6
2
###########
#.........#
#......##.#
#......####
#......##.#
d....###..#
#......##.#
#.........#
#.........#
#.........#
###########

1
1
#####d#####
#.........#
#.........#
#....##.###
#....##.#.#
.....##...l
#....####.#
#.....#k###
#.........#
#.........#
#####.#####
key : 3

1
2
#####.#####
#.........#
#.........#
#.........#
#.........#
l..##e....#
#.#.......#
###.#.....#
###.#.....#
#.........#
#####.#####
locked : 3
boss
enemies 1

1
0
###########
##.....#..#
#.........#
#.........#
#.#..#..#.#
#..........
#.........#
#......#..#
#.........#
#.........#
#####l#####
locked : 0

3
0
#####.#####
#.........#
#.........#
#.........#
#.........#
#..........
#.........#
#.........#
#.........#
#.........#
#####.#####

4
0
#####.#####
#.........#
#.........#
#.........#
#.........#
#?...@....#
#.........#
#.........#
#.........#
#.........#
#####.#####
sign The dungeon remembers all who enter.

7
1
#####.#####
#.......#.#
#...#.....#
#.........#
#.........#
l.........#
#.........#
#.........#
#.........#
#.........#
###########
locked : 1

5
0
#####.#####
#.........#
##.#...#.##
#.........#
#...#.....#
#..........
#..#.#.#..#
#.........#
#.#.#...#.#
#.........#
#####.#####

6
1
#####d#####
##.#.....##
#.........#
#.#.....#.#
#.........#
...#.#.#..d
#.........#
#.....#.#.#
#.........#
##.#......#
#####.#####

6
0
#####.#####
#.........#
#..#..##..#
#..#.#....#
#..##.#.#.#
#..k#.##...
#.....#...#
#.........#
#.........#
#.........#
#####.#####
key : 0

2
1
#####.#####
#e.......e#
#.........#
#...#.....#
#.........#
...........
#...#.....#
#.........#
#.........#
##........#
#####d#####
enemies 2

2
0
#####l#####
#.........#
#.........#
#.....##..#
#....###..#
#.....#....
#.........#
#.........#
#.........#
#.........#
#####.#####

