5
1
#####D#####
#.........#
#.........#
#.........#
#.........#
d.........d
#.........#
#.........#
#.........#
#.........#
#####D#####

3
1
#####D#####
#.........#
#..##.....#
#..##.....#
#...#.....#
l....###..d
#.........#
#.........#
#.........#
#.........#
#####D#####
locked : 3

0
1
###########
#e#e......#
#.##......#
#.e#......#
#.#.#.....#
#.........#
#.........#
#.........#
#.........#
#.........#
#####D#####
enemies 3
door 0 : 0 1

5
0
#####d#####
#.........#
#......#..#
#.......#.#
#.........#
#.........d
#.........#
#.........#
#.........#
#.........#
#####D#####

4
1
#####D#####
#.#.......#
#.........#
#.........#
#....#..#.#
D.........D
#.........#
#....#..#.#
#.........#
#.........#
#####D#####

5
3
###########
#.#.....#.#
#.........#
#......#..#
#.........#
D...#.#...#
#.........#
#..#.#.#.##
#.........#
#.......#.#
###########

7
1
#####D#####
#.........#
#.........#
#...#.###.#
#....#....#
D....###..#
#...#.#.#.#
#...#.#...#
#.........#
#........k#
###########
key : 0

5
2
#####D#####
#.........#
#.........#
#....#....#
#....#....#
d..#......D
#.###.....#
#.#.......#
#.........#
#.........#
###########

6
1
#####D#####
#.........#
#.........#
#.........#
#.........#
D.........#
#..#.##...#
#...##....#
#...#.#...#
#k#.......#
#####D#####
key : 1

2
1
#####D#####
#e........#
#.........#
##..#..#..#
#.........#
D.......?e#
#.#..#..#e#
#.........#
#.........#
#s.....#..#
#####D#####
enemies 3
switch 0 : 0 1
sign This door will not yield without a key.

3
2
###########
#.........#
#.........#
#..#.#....#
#.....#...#
d..#.e.#..#
#..#..#...#
#......#..#
#.........#
#.........#
#####D#####
boss
enemies 1

6
0
#####D#####
#.........#
##.#...#.##
#.........#
#.#.#.#.#.#
#.........D
#..#.#....#
#.........#
#.#.#.#.#.#
#.........#
#####D#####

2
0
#####D#####
#.........#
#..#......#
#.........#
#.........#
#k........D
#.........#
#.........#
#.........#
###.......#
#####D#####
key : 3

1
1
#####D#####
#.........#
#..#......#
#.#.......#
#.........#
D........k#
#.........#
#.#.......#
#..#......#
#.........#
#####D#####
key : 5

4
0
#####D#####
#.........#
#.........#
#.........#
#.........#
#.........D
#.........#
#.#.....#.#
#..#...#..#
#.........#
#####d#####

4
2
#####D#####
#.........#
#.........#
#.........#
#.........#
D........X#
#.........#
#.........#
#.........#
#.........#
#####D#####

1
0
###########
#e........#
##..p.....#
#p###.##..#
#e###.....#
#....#....D
#...##....#
#.........#
#.........#
#.........#
#####D#####
enemies 2

7
0
#####D#####
#.........#
#.........#
#.........#
#.........#
#....@....D
#.........#
#.........#
#.........#
#?........#
###########
sign A useful tool lies just ahead.

3
0
#####D#####
#.........#
#.........#
#..#...#.##
#.........#
#...#.#...l
#.........#
#..#...#.##
#.........#
#.......#.#
#####D#####

