4
1
#####.#####
#.........#
#.........#
#.........#
#.........#
d..........
#.........#
#.........#
#.........#
#.........#
#####.#####

2
2
#####.#####
#.........#
##.......##
#.........#
#..#.#.#..#
d..........
#....#....#
#.........#
##.#.....##
#.........#
#####d#####

6
1
#####.#####
#.........#
#.........#
#.........#
#...#.....#
#.........l
#.........#
#.......#.#
#.....##..#
#k........#
###########
key : 1

2
1
#####.#####
#.........#
#........##
#.........#
#.........#
l..#......d
#.........#
#.........#
#..#..#..##
#.........#
#####.#####
locked : 1

4
2
#####.#####
#.........#
#.........#
#.........#
#..##.#...#
...#.##...#
#.........#
#.#.###...#
#.#.......#
#........X#
###########

1
0
#####d#####
#.........#
#.........#
#.........#
#.........#
#...#......
#.........#
#..#......#
#.........#
#.......#k#
#####.#####
key : 2

3
0
#####.#####
#.........#
#.........#
#.........#
#.........#
#..........
#.........#
#.#.......#
#..#......#
#.........#
#####.#####

5
1
#####.#####
#.........#
#.........#
#.........#
#.........#
..........#
#.........#
#.........#
#.........#
#.........#
#####.#####

0
0
###########
#.........#
#......#..#
#.........#
#.........#
#....#.....
#.........#
#.........#
##.....#..#
#.........#
#####d#####

1
1
#####.#####
#..#......#
#.#.#.#...#
#.#..#....#
#.....#...#
......##...
#.....#...#
#.....#...#
#.........#
#......##.#
#####.#####

5
0
#####.#####
#.........#
#.##......#
#...#.....#
#.#.#.#...#
#...#......
#.........#
#.........#
#e........#
#es.......#
###########
enemies 2
switch 0 : 0 1

3
2
#####d#####
#.........#
#.....#...#
#....####.#
#...###...#
.....e.#..#
#..##.....#
#.........#
#.........#
#.........#
#####.#####
boss
enemies 1

6
2
###########
#......#..#
#.....#...#
#....###..#
#.........#
l.........#
#.........#
#.........#
#.........#
#.........#
###########
locked : 0

4
0
#####.#####
#.........#
#.........#
#.........#
#.........#
#?...@....d
#.........#
#.........#
#.........#
#.........#
#####.#####
sign Beware what lurks ahead.

1
2
###########
#......?ee#
#........e#
#.........#
#.........#
.....##...#
#.....#...#
#.........#
#.........#
#.........#
#####.#####
enemies 3
door 0 : 0 1
sign Many have walked this path.

2
0
#####.#####
#..#......#
#.........#
#.........#
#..#..#...#
#.........l
#.........#
#..#..#...#
#.........#
#.........#
#####.#####

3
1
#####.#####
#k........#
#......##.#
#.......#.#
#.........#
...........
#.........#
#.........#
#.........#
#.........#
#####.#####
key : 0

2
3
###########
#........k#
#..#......#
#.#.......#
#.........#
..........#
#.........#
#.#.......#
#..#......#
#.........#
###########
key : 4

0
1
###########
#.......ee#
#.........#
#.........#
#.........#
..........#
#.........#
#.........#
#.........#
#.........#
#####.#####
enemies 2

