5
1
#####d#####
#.#.......#
#.........#
#.#...#.#.#
#.........#
#...#.#...#
#.........#
#.#...#.#.#
#.........#
#.........#
###########

2
3
#####D#####
#.........#
#.........#
#.........#
#.###.....#
d....e....D
#...##.#..#
#####.##..#
##..#.##..#
#.........#
#####D#####
boss
enemies 1

3
1
#####D#####
#.........#
#.........#
#.........#
#..p......#
D.........D
#.........#
#.........#
#.........#
#.........#
#####d#####

2
4
###########
#........k#
##.#...#..#
#.#.....#.#
#.........#
D.........#
#.........#
#.........#
#...#.....#
#.........#
###########
key : 10

4
3
#####D#####
#.........#
#.........#
#.........#
#.........#
d.........#
#.....###.#
#.....#.#.#
#.....#...#
#.........#
###########

4
2
#####D#####
#p........#
#.........#
#..#......#
#.#.......#
D.........d
#.........#
#..p......#
#.........#
#?...e....#
###########
enemies 1
sign Many have walked this path.

3
2
#####D#####
#.........#
#.........#
#...##....#
#.#.#.....#
D....#....D
#...#.....#
#.........#
#.........#
#.........#
#####D#####

1
3
###########
#........X#
#.........#
#..#.#....#
#..#..#...#
D.........#
#...#.....#
#.##..#...#
#.........#
#.........#
#####D#####

2
1
#####D#####
#.........#
#......#..#
#.........#
#.........#
l...#..#..D
#...##.#..#
#...##.#..#
#......##.#
#......#..#
#####D#####
locked : 1

2
2
#####D#####
#.........#
#.........#
#.........#
#.........#
D.........d
#.........#
#.........#
#.........#
#.........#
#####D#####

4
1
#####d#####
#.........#
#..#...#.##
#.........#
#.#.#.#.#.#
D.........D
#....#.#..#
#.........#
#.#.#.#...#
#.........#
#####d#####

4
0
#####D#####
#.........#
#.#...#.#.#
#.........#
#..#.#.#..#
#.........D
#.#.#.#.#.#
#.........#
#..#...#.##
#k........#
###########
key : 1

1
0
###########
#.........#
##.....#..#
#.......#.#
#.........#
#.........D
#.........#
#.........#
#.........#
#.........#
#####l#####
locked : 0

1
1
###########
#.e..e..?.#
#.#.....#.#
#.........#
#.........#
D..#..#...D
#.........#
#.........#
#.......#.#
#.........#
#####D#####
enemies 2
sign Turn back; you are not yet ready.

2
0
#####l#####
#......####
#..##.##k.#
#..#..###.#
#....####.#
#.....#...l
#.........#
#.........#
#..#......#
#.........#
#####D#####
key : 0

3
0
#####D#####
#.........#
#.........#
#.........#
#.........#
#....@....D
#.........#
#.........#
#.........#
#.........#
#####D#####

1
2
#####D#####
#.........#
#.#.#.....#
#..#.#....#
#.........#
D.........D
#.........#
#.........#
#.........#
#.........#
#####D#####

0
2
###########
#k#.....#.#
#.........#
#...#.#.#.#
#.........#
#.....#...#
#.........#
#.....#.#.#
#.........#
#.#.....#.#
#####D#####
key : 6

3
3
#####D#####
#.........#
#?#.......#
###e#.....#
#..#......#
D..#......#
#..#......#
#.........#
#.........#
#.........#
#####D#####
enemies 1
sign Many have walked this path.

