2
0
#####D#####
#.........#
#.........#
#...#.....#
#...k#.#..#
#...##....D
#.....##..#
#.........#
#.........#
#.........#
#####D#####
key : 3

0
2
###########
#.......?e#
#.........#
#.........#
#....#..#e#
D.....#...#
#.........#
#......#.##
#.....#####
#.........#
#####D#####
enemies 2
sign Beware what lurks ahead.

3
0
#####D#####
#.........#
#.........#
##.....#..#
#.........#
#.........d
#...#..#..#
#.........#
#.........#
##.....#..#
#####l#####
locked : 0

2
2
#####d#####
#.........#
#.........#
#..#.#.#..#
#..#.####.#
D...####..D
#..#####..#
#.....#.#.#
#.......#.#
#.........#
#####D#####

1
0
#####l#####
#.........#
#..#...#..#
#k#.....#.#
#.........#
#.........D
#.........#
#.........#
#.........#
#.........#
#####D#####
key : 5

4
0
#####l#####
#.........#
#.........#
#.........#
#.........#
#k........D
#.........#
#.........#
#.........#
#.........#
#####D#####
key : 0

1
1
#####D#####
#k........#
#.........#
#.........#
#.........#
D.........d
#.........#
#.......#.#
#......#..#
#.........#
#####D#####
key : 8

2
1
#####D#####
#.........#
#..#...#..#
#.#.....#.#
#.........#
D.........D
#.........#
#.........#
#.........#
#.........#
#####D#####

0
0
###########
#........##
#.........#
#.........#
#.........#
#.........D
#.........#
#.#....#..#
#..#......#
#.........#
#####l#####
locked : 5

2
3
#####D#####
#.........#
#.........#
#.........#
#.........#
D...##....#
#...#.#...#
#.........#
#.........#
#........X#
###########

6
0
#####D#####
#.........#
#.........#
#.........#
#.........#
#.........#
#.........#
#.........#
#.........#
#.........#
###########

0
1
###########
#.........#
#.........#
#....#...##
#.........#
D....###..D
#....#.#..#
#.........#
#.........#
#.........#
#####D#####

1
3
###########
#.........#
#.........#
#.........#
#.........#
l....e....#
#.........#
#.........#
#.........#
#.........#
#####D#####
locked : 8
boss
enemies 1

5
0
#####D#####
#.........#
#.........#
#.###.....#
#..##.....#
#..###....D
#.##@.....#
###..#....#
#.........#
#.........#
#####D#####

3
1
#####D#####
#.........#
#.........#
#.........#
#.........#
d.........d
#.........#
#.........#
#.........#
#.........#
#####l#####

4
1
#####l#####
#.........#
#.........#
#.........#
#.........#
D.........#
#.........#
#.........#
#.........#
#.........#
#####D#####
locked : 3

1
2
#####D#####
#.........#
#......#..#
#.......#.#
#.........#
d.........l
#.........#
#.......#.#
#......#..#
#.........#
#####d#####

3
2
#####D#####
#.........#
#.........#
#.....p...#
#.........#
d.........#
#......p..#
#.........#
#.........#
#.........#
###########

5
1
#####D#####
#.........#
##.#......#
#.#.......#
#.......#.#
D.........#
#.......#.#
#.........#
#.........#
#.........#
###########

