5
2
#####d#####
#.........#
#......#..#
#.......#.#
#.........#
#.........#
#.........#
#.......#.#
#......#..#
#.........#
#####D#####

0
4
###########
#X##......#
#...#.....#
#.####....#
#.........#
#.........#
#.........#
#.........#
#.........#
#.........#
#####D#####

1
3
###########
#e..?.....#
##..#..#..#
#.........#
#.........#
D......#..D
#.........#
#.........#
##..#..#..#
#e........#
#####D#####
enemies 2
sign Only the prepared may pass.

3
2
#####D#####
#.........#
#..#..#..##
#.........#
#.........#
D.........D
#.........#
#.........#
#..#..#..##
#.........#
#####D#####

3
3
#####D#####
#..#...#.##
#.........#
#.#...#.#.#
#.........#
D......#..D
#.........#
#.#.#...#.#
#.........#
##.#......#
#####D#####

2
4
#####l#####
#.........#
#.........#
#....#..#.#
#.........#
D.........D
#.#.......#
#.........#
#.........#
#k#.....#.#
#####d#####
key : 4

6
2
#####D#####
##.....#.##
#.........#
#..#.#.#.##
#.........#
#..#.#.#..#
#.........#
#..#.#.#.##
#.........#
##k#...#.##
###########
key : 5

3
4
#####d#####
#.........#
#.........#
#.........#
#.........#
D.........#
#.........#
#.#.......#
#..#......#
#.........#
###########

1
4
#####D#####
#.........#
#.........#
#......p..#
#.........#
D...pe....#
#.........#
#.........#
#.........#
#.........#
#####l#####
locked : 4
boss
enemies 1

3
0
###########
#.........#
#.........#
#.........#
#.........#
#.........D
#.........#
#.........#
#.........#
#.........#
#####D#####

2
1
###########
#k........#
#.........#
#.........#
#.........#
#.........l
#.........#
#.........#
#.........#
#.........#
#####D#####
key : 0

2
5
###########
#.........#
#.......#.#
#.........#
#.........#
D.....#...#
#....#....#
#.........#
#.........#
#.........#
###########

2
3
#####D#####
#.........#
#...#..##.#
#.###..#..#
#.####....#
d.........D
#.........#
#.........#
#.........#
#.........#
#####D#####

4
0
#####D#####
#.........#
#.........#
#..##.#...#
#..##.....#
#...#@....#
#.....#...#
#....##...#
#.........#
#?........#
###########
sign The dungeon remembers all who enter.

2
2
#####D#####
#..#...##.#
#..##.##..#
#...#.###.#
#..#.#.#..#
l....#.#..d
#.........#
#.........#
#.......p.#
#.........#
#####D#####
locked : 0

4
2
#####D#####
#.........#
#.........#
#.........#
#.....#...#
#......#..D
#....####.#
#....##k.##
#.....##.##
#.........#
#####d#####
key : 2

1
2
###########
#e........#
#e##......#
##.#......#
#..##.....#
#..#......D
#.#.......#
#...#.....#
##........#
#.........#
#####D#####
enemies 2

4
3
#####D#####
##........#
#.........#
#.........#
#.........#
D.........#
#.........#
#.#.....#.#
#..#...#..#
#.........#
###########

3
1
#####D#####
#.........#
#.....#.#.#
#.........#
#.#.#...#.#
D.........D
#.#.#.#.#.#
#.........#
#.#.#...#.#
#.........#
###########

