4
3
#####.#####
#.........#
#.........#
#.........#
#.........#
...........
#......##.#
#......#k.#
#.......#.#
#.........#
#####d#####
key : 2

5
2
#####.#####
#.........#
#.........#
#.........#
#.......#.#
...........
#.........#
#.#.......#
#.##.....##
#.........#
#####.#####

4
1
###########
##.#...#.##
#k........#
##.#.#...##
#.........#
#..#.#.#...
#.........#
##...#.#.##
#.........#
#..#...#.##
#####.#####
key : 0

3
3
#####.#####
#.........#
#.#.#.#.#.#
#.........#
#.#.#.#.#.#
...........
#.#.#.#...#
#.........#
#.#.#.#.#.#
#.........#
#####.#####

2
4
#####l#####
#.........#
#.........#
#.........#
#.........#
...........
#.........#
#.#.......#
#..#......#
#.........#
#####d#####

3
2
###########
#k........#
#.........#
#.........#
#.........#
#..........
#.........#
#.......#.#
#......#..#
#.........#
#####.#####
key : 3

2
3
###########
##.#...#.##
#.........#
##.#...#.##
#.........#
#..#.#.#...
#.........#
#....#.#.##
#.........#
##.....#.##
#####.#####

6
1
#####d#####
##.#.....##
#.........#
#.#...#.#.#
#.........#
#..#.#.#...
#.........#
#...#.#.#.#
#.........#
##.#...#..#
###########

4
4
#####.#####
#.........#
#.....#.#.#
#.........#
#.#.#.#.#.#
..........#
#.#.#.#.#.#
#.......?.#
#.#.....#e#
#.......ee#
###########
enemies 3
sign Those who search shall find.

3
4
#####d#####
#?.......e#
#..#.....##
#.........#
#.........#
...#..#...d
#.........#
#.........#
#..#.....##
#........e#
#####.#####
enemies 2
sign The dungeon remembers all who enter.

6
2
#####.#####
#.#.......#
#.........#
#.........#
#.........#
.......#..#
#.........#
#.#.....#.#
#..#...#..#
#........k#
###########
key : 1

5
0
###########
#.........#
##.#......#
##.#......#
#.##......#
#....@.....
#.#.#.....#
#.###.....#
#.#.......#
#.........#
###########

5
3
#####d#####
#.........#
#.........#
#.........#
#.#.......#
..........#
#....#....#
#.#.......#
#..#......#
#.........#
###########

2
5
###########
#.#....e#e#
#.........#
#.........#
#....#..#e#
..........#
#.........#
#....#..#.#
#.........#
#.........#
#####.#####
enemies 3

0
4
###########
#X........#
#.....#...#
#######...#
#...###...#
#.........#
#...##....#
###.......#
#.........#
#.........#
#####.#####

3
5
#####.#####
#..#......#
#..#......#
#.#.......#
#.........#
d.........#
#.........#
#.#.....#.#
#..#...#..#
#.#.......#
###########

5
1
#####.#####
#.........#
#......#..#
#.......#.#
#......#..#
...........
#.........#
#.........#
#.........#
#.........#
#####d#####

4
2
#####.#####
#e........#
#.........#
#.........#
#.........#
....#......
#...#.?#..#
#.....##..#
#..#..##..#
##........#
#####.#####
enemies 1
sign Those who search shall find.

1
4
#####.#####
#..#......#
#.##......#
#..#......#
#.........#
#....e....#
#.........#
#.........#
#.........#
#.........#
#####l#####
locked : 3
boss
enemies 1

