3
2
#####D#####
#.........#
#.........#
#.........#
#.........#
D...#..#..D
#.........#
#.........#
##..#.....#
#k........#
###########
key : 1

2
0
###########
#k#.....#.#
#.........#
#.........#
#.#.....#.#
#.........D
#.........#
#.#..#..#.#
#.........#
#.........#
#####D#####
key : 0

1
1
#####D#####
#k........#
##.##.....#
##.#......#
#...#.....#
#...#.....D
#..#......#
#.........#
#.........#
#.........#
#####D#####
key : 2

1
2
###########
#...k.....#
#...#.#.#.#
#.........#
#..#.#.#..#
D.........D
#.#.#.#.#.#
#.........#
#......#.##
#.........#
#####D#####
key : 3

2
4
###########
#.........#
#.........#
#....#.#..#
#....#....#
d.........#
#.........#
#.........#
#.......p.#
#.p.......#
#####l#####

4
0
#####d#####
#.........#
#.........#
#.........#
#.#.......#
#.........D
#.#.......#
#.........#
#.........#
#.........#
###########

4
1
#####l#####
#.........#
#.#.......#
#.........#
#.........#
D.........#
#.........#
#.........#
#.......#.#
#.........#
###########
locked : 0

0
1
###########
##.......##
#.........#
#.#.#.#.#.#
#.........#
#..#.#....#
#.........#
#.#.#.#...#
#.........#
##.......##
#####D#####

1
3
###########
#.........#
#.........#
#.........#
#.........#
D.........#
#.........#
#.........#
#...p.....#
#..p......#
#####d#####

3
0
#####D#####
#.........#
#.........#
#.........#
#.........#
#?...@....D
#.........#
#.........#
#.........#
#.........#
#####d#####
sign Something glints behind that door…

5
5
#####D#####
#.........#
#.........#
#.........#
#.........#
#.........#
#.........#
#.........#
#.........#
#X........#
###########

2
3
#####d#####
#.........#
#.........#
#.........#
#.........#
d.........d
#.........#
#.........#
#.........#
#.........#
#####D#####

3
4
#####l#####
#.........#
#.#.#.#...#
#.........#
#..#...#..#
D.........#
#.#...#.#.#
#.........#
#..#...#..#
#.........#
#####D#####
locked : 3

3
1
#####D#####
#.........#
#..#......#
#.#.......#
#.........#
D.........D
#.........#
#.#.....#.#
#..#...#..#
#.........#
#####l#####

2
2
#####D#####
#.........#
#.....#...#
#..###....#
#....#....#
l..#......d
#.........#
#.........#
#.........#
#.........#
#####D#####
locked : 1

4
4
#####D#####
#.........#
##.##.....#
###.#.....#
#...#.....#
#.........l
#.........#
#.........#
#e........#
#e........#
###########
enemies 2

4
5
###########
#.........#
#.........#
#.........#
#.........#
l....e....#
#.........#
#.........#
#.........#
#.........#
#####D#####
locked : 2
boss
enemies 1

2
1
#####D#####
#.........#
#.........#
#.........#
#.........#
D.........l
#....#....#
#.........#
#.........#
#.........#
#####D#####

3
3
#####D#####
#.........#
#.........#
#.....p...#
#.........#
D.........D
#.........#
#..p......#
#.........#
#.........#
###########

