4
2
#####D#####
#.........#
#.........#
#.........#
#.........#
d.........#
#.........#
#.........#
#.........#
#.........#
#####l#####

3
0
#####D#####
#.........#
#.........#
#.........#
#.........#
#.........D
#.........#
#.........#
#.........#
#.........#
#####D#####

1
1
#####d#####
#.........#
#.........#
#.........#
#.........#
#.........D
#.........#
#.##......#
#..#..#...#
#.........#
#####D#####

0
1
###########
#.........#
##.....#.##
#.........#
#..#.#.#..#
#.........#
#....#.#..#
#.........#
#..#.....##
#.........#
#####d#####

3
1
#####D#####
#.........#
#.........#
#.........#
#.........#
D.........D
#.........#
#.........#
#.........#
#.........#
#####d#####

3
2
###########
#...k.....#
#...#.#...#
#...#.....#
#.#####...#
D..###....D
#.#.##....#
#.........#
#.........#
#.........#
#####D#####
key : 1

7
2
#####D#####
#.........#
#......#..#
#.......#.#
#.........#
#.........#
#.........#
#.#.......#
#..#..#...#
#k........#
###########
key : 5

2
3
###########
#k........#
#.#.....#.#
#.........#
#.........#
#..#..#...#
#.........#
#.........#
#.#.....#.#
#.........#
#####D#####
key : 3

5
3
###########
#........X#
#.........#
#.........#
#.........#
D.........#
#.........#
#.........#
#.........#
#.........#
#####D#####

6
3
#####D#####
##.#...#..#
#.........#
#..#...#.##
#.........#
D..#.#....#
#.........#
##.#.#.#..#
#.........#
##.#.....k#
###########
key : 4

4
0
#####D#####
#.........#
#.........#
#.........#
#.........#
#....@....D
#.........#
#.........#
#.........#
#.........#
###########

2
1
#####D#####
##.....#s##
#.........#
#.#.#...#.#
#.........#
D..#.#.#..#
#.........#
#.#.#.#.#.#
#.........#
##e#...#.##
#####D#####
enemies 1
switch 0 : 0

2
0
###########
#.........#
#.........#
#.........#
#.........#
#..#......D
#....##...#
#..##.#...#
#...#.#...#
#.........#
#####D#####

5
1
#####d#####
#.........#
#.........#
#.........#
#.........#
#...##....D
#..###....#
#..###....#
#.........#
#.........#
###########

4
1
#####d#####
#.........#
#..#......#
#.#.......#
#.........#
D.........d
#.........#
#.........#
#.........#
#.........#
#####d#####

1
2
###########
#.......ee#
#.........#
#.........#
#.........#
D.........#
#.........#
#.........#
#.........#
#.......?e#
###########
enemies 3
door 0 : 0
sign The dungeon remembers all who enter.

5
2
#####l#####
#.........#
#.........#
####......#
#.##......#
D..#.e....D
#.#.......#
#.........#
#.........#
#.........#
#####D#####
locked : 1
boss
enemies 1

3
3
#####D#####
#.........#
#.........#
#.........#
#.........#
D.........#
#.........#
#.........#
#........s#
#.......ee#
###########
enemies 2
switch 1 : 1 2

6
2
#####D#####
#?........#
#.........#
#.........#
#.........#
#e........D
#..#......#
#..##.....#
#...#.....#
#.........#
#####D#####
enemies 1
door 1 : 1 2
sign Only the prepared may pass.

