1
2
#####.#####
#.........#
#.#.#.#.#.#
#.........#
#..#.#....#
d.........d
#.#.#.#.#.#
#.........#
#..#...#..#
#.........#
#####.#####

3
2
#####.#####
#.........#
#.........#
#.........#
#.........#
..........d
#.........#
#.........#
#.........#
#.........#
#####.#####

0
2
###########
#........k#
#.........#
#......#..#
#....#....#
.....#....#
#.........#
#.........#
#.........#
#.........#
#####.#####
key : 4

2
1
#####.#####
#......##.#
#...#.###.#
#...##..#.#
#...##....#
.....##....
#.....##..#
#.....#k###
#.......###
#.......###
#####.#####
key : 1

0
1
###########
#......##.#
#...#.....#
#...#..##.#
#..###..#.#
#..#.......
#.#.##....#
##...#....#
##........#
#.........#
#####l#####
locked : 0

4
1
#####l#####
##........#
#.........#
#.........#
#....#....#
...........
#.........#
#.........#
#.........#
#.........#
###########
locked : 1

1
3
###########
#.........#
#.........#
#.........#
#.........#
d.........d
#.........#
#.........#
#.........#
#.........#
#####.#####

2
4
#####.#####
#.........#
#.........#
#.........#
#.........#
..........#
#.........#
#.........#
#.........#
#........X#
###########

2
2
#####.#####
#..#...#..#
#...#..#..#
#..###....#
#.....#...#
....#..#...
#..#......#
#.#.......#
###.......#
#.........#
#####.#####

1
1
#####l#####
#......#..#
#.........#
#.........#
#.#.#.....#
l..#......d
#..#......#
##.###....#
#..##.....#
##........#
#####.#####
locked : 2

3
3
#####.#####
#.........#
#..#......#
#.#.......#
#.........#
d.........#
#.........#
#.#.....#.#
#..#...#..#
#.........#
###########

3
1
#####.#####
#.........#
##.#...#.##
#.........#
#....#....#
...........
#..#.#.#..#
#.........#
##.#...#..#
#.........#
#####l#####

4
2
#####.#####
#.........#
#..#......#
#.#.......#
#.........#
..........#
#.........#
#.#.......#
#..#......#
#.........#
###########

3
0
#####.#####
#.........#
#.......#.#
#.......#.#
#...@..##.#
#....#.#...
#...#.#.#.#
#...#.....#
#.........#
#........##
#####.#####

2
3
#####.#####
#.........#
#.........#
#...#.#...#
#.....##..#
...#..#....
#....#.#..#
#....#.#..#
#.........#
#.........#
#####.#####

1
4
###########
#.........#
#.........#
#.........#
#.........#
d....e....#
#.........#
#.........#
#.........#
#.........#
#####.#####
boss
enemies 1

2
0
#####.#####
#.........#
#.........#
#.........#
#.........#
#k.........
#.........#
#.........#
#.........#
#.........#
#####.#####
key : 0

1
0
###########
#k.....#..#
#.........#
#.........#
#.........#
#.........l
#.........#
#..#......#
#.........#
#.........#
#####.#####
key : 2

4
0
#####.#####
#.........#
##.#...#.##
#.........#
#...#.#.#.#
#..........
#..#.#.#..#
#.........#
#?#...#.#.#
#e........#
###########
enemies 1
sign This door will not yield without a key.

