3
1
#####l#####
#.........#
#.........#
#.........#
#.....#...#
D.........D
#.........#
#.#.....#.#
#..#...#..#
#.........#
#####D#####

4
2
#####D#####
#..#.....##
#.........#
#.........#
#...#..#..#
D.........#
#.........#
#.....#...#
#.........#
#........k#
###########
key : 1

4
0
#####D#####
#.........#
#..#...#..#
#.#.....#.#
#.........#
#.........D
#.......#.#
#.#.......#
#..#......#
#.........#
###########

3
4
#####D#####
#.........#
#.........#
#.........#
#.........#
D.........#
#.........#
#.........#
#.........#
#........X#
###########

2
4
#####D#####
#.........#
#.........#
#.........#
#.........#
D........k#
#.........#
#.........#
#.........#
#.........#
#####D#####
key : 3

1
5
###########
#.........#
#..#......#
#.#.......#
#.........#
D.........#
#..#......#
#..#.....##
#.........#
#.........#
###########

2
0
###########
#.........#
#...#.#...#
#..##.....#
#..##..#..#
#...####..D
#..#......#
#.........#
#.........#
#.........#
#####d#####

4
1
#####D#####
#.........#
#.........#
#.........#
#.........#
D.........D
#.........#
#.........#
#.........#
#.........#
#####D#####

2
3
#####d#####
#.........#
#.....#..##
#.........#
#.........#
D......#..D
#.........#
#.........#
#.....#..##
#.........#
#####d#####

3
0
#####d#####
#.........#
#.........#
#.....###.#
#...@.#.#.#
#..#?##...D
#..##.....#
#.#..#....#
#...#.#...#
#.........#
#####D#####
sign Many have walked this path.

3
3
#####d#####
#.........#
#.........#
#.........#
#.........#
D.........D
#.........#
#.........#
#.........#
#.........#
###########

1
3
#####D#####
#.........#
#.........#
#.........#
#.........#
#...#..#..l
#...#.##..#
#..#.##...#
#.....#...#
#.##......#
#####d#####

2
2
###########
#.........#
#.........#
#.........#
#.........#
D....###..D
#....#.#..#
#....#....#
#.........#
#.........#
#####d#####

5
1
#####D#####
#.........#
#..#...#..#
#.#.....#.#
#.........#
#.........#
#.........#
#.........#
#.........#
#k........#
###########
key : 2

0
3
###########
#ee.......#
#e........#
#s........#
#.........#
#.........D
#.....##..#
#....##..##
#.....##..#
#......####
#####D#####
enemies 3
switch 0 : 0

1
4
#####D#####
#.........#
#.........#
#.........#
#.........#
l....e....D
#.........#
#.........#
#.........#
#.........#
#####D#####
locked : 2
boss
enemies 1

0
4
###########
##e#....ee#
##........#
###.#.....#
#..#......#
D.........#
#....#....#
#......#..#
#.........#
#.........#
#####D#####
enemies 3
door 0 : 0

2
1
###########
#.........#
#.......#.#
#.....#.#.#
#......##.#
D.........D
#.........#
#.........#
#........p#
#.........#
#####l#####
locked : 0

3
2
#####d#####
#.........#
#.........#
#.#..#....#
#..####...#
D..###....D
#..####...#
#.#k###...#
#.........#
#.........#
#####D#####
key : 0

