4
3
#####d#####
#k#.......#
#.........#
#..#.#.#.##
#.........#
D.....#...D
#.........#
#..#.#.#.##
#.........#
#.......#.#
###########
key : 4

3
2
#####D#####
#..#...#.##
#.........#
##.#...#.##
#.........#
D..#.#....D
#.........#
##.#.#...##
#e........#
##.......##
#####D#####
enemies 1

3
3
#####D#####
#.........#
#......#..#
#.......#.#
#.........#
D.........D
#.........#
#.#.....#.#
#..#...#..#
#.........#
#####d#####

4
2
#####D#####
#.........#
##.......##
#.........#
#..#.#.#..#
#.........D
#....#.#..#
#.........#
##.#......#
#.........#
#####d#####

4
4
#####d#####
#.........#
#......#..#
#.......#.#
#.........#
D.........#
#.........#
#.#.....#.#
#..#...#..#
#.........#
#####D#####

1
0
#####D#####
#.........#
#e#.#.#.#.#
#.........#
#..#...#..#
#.........D
#e#.....#.#
#.........#
#..#...#..#
#.........#
#####D#####
enemies 2

3
1
#####D#####
#.........#
#..#...#..#
#.......#.#
#.........#
#.........D
#.........#
#.......#.#
#......#..#
#k........#
###########
key : 0

0
0
###########
#k........#
#.........#
#.........#
#.........#
#.........#
#.........#
#.........#
#.........#
#.........#
#####D#####
key : 6

3
4
###########
#.........#
#.........#
#.........#
#.........#
D.........#
#.p.......#
#.......p.#
#.........#
#.........#
#####d#####

2
2
#####D#####
#.........#
#.........#
##..#..#..#
#.........#
d.........D
#.#.....#.#
#.........#
#.........#
#......#..#
#####D#####

1
2
###########
#........k#
#..#......#
#.#.......#
#.........#
D.........#
#.........#
#.......#.#
#......#..#
#.......#.#
#####D#####
key : 1

5
4
#####D#####
#.........#
#.........#
#.........#
#.........#
#.........l
#......p..#
#..p......#
#.........#
#e........#
###########
enemies 1

2
3
###########
#.........#
#...p.....#
#.........#
#.###p....#
D...#.....#
#.#.#.....#
#.........#
#.........#
#.........#
#####D#####

2
1
#####l#####
#.........#
#.........#
#...###.#.#
#...#.....#
D....#.#..d
#....##...#
#...#...#.#
#.........#
#.........#
#####D#####

2
0
#####D#####
#.##......#
#..#......#
##.#......#
#..#@.....#
#...###...D
#.........#
#.........#
#.........#
#?........#
###########
sign Many have walked this path.

5
5
###########
##........#
####......#
#.###.....#
#.####....#
l...##....#
#.##e.....#
#.##......#
#..##.....#
#.##......#
#####D#####
locked : 4
boss
enemies 1

1
1
###########
#.........#
#..#......#
#.#.......#
#.........#
D.........D
#.........#
#.#.......#
#..#......#
#.........#
#####l#####
locked : 0

6
5
#####D#####
#.........#
#...#.#.#.#
#...####..#
#...#.###.#
#..##.....#
#.....#.#.#
#.........#
#.........#
#X........#
###########

5
2
#####d#####
#.......#.#
#...#.##..#
#.......#.#
#.....#...#
#...#.#...#
#...##....#
#..#.#....#
#..#......#
#.........#
###########

