5
1
#####.#####
#.........#
#.........#
#.........#
#.........#
#..........
#.........#
#?........#
#e........#
#ee.......#
###########
enemies 3
door 0 : 0 1
sign Many have walked this path.

3
3
#####d#####
##k#.....##
#.........#
#...#.#...#
#.........#
...#.#.#...
#.........#
#.#.#.#.#.#
#.........#
##.#...#.##
#####.#####
key : 1

1
3
###########
#X........#
#.....#...#
#.........#
#....###..#
#..#..#...#
#..##.....#
#..####.#.#
#.#.#.#...#
#.#.......#
#####.#####

2
3
#####.#####
#.........#
#.........#
#.........#
#.........#
.....e.....
#.........#
#.........#
#.........#
#.........#
#####d#####
boss
enemies 1

2
4
###########
####.....k#
#..#......#
##..##....#
#..#..#...#
....#.#...#
#.........#
#.........#
#.........#
#.........#
#####.#####
key : 3

1
0
#####.#####
#.........#
#..#......#
#k#.......#
#....#..#.#
#..........
#.........#
#........##
#.........#
#.........#
#####.#####
key : 0

0
0
###########
#.........#
#..#......#
#.#.......#
#.........#
#..#......#
#.#.......#
#.#..#....#
#..#......#
#.........#
#####.#####

4
1
#####d#####
#.........#
#.........#
#.........#
#.........#
..........d
#..#......#
#.........#
#.........#
#..#......#
#####.#####

2
2
###########
#.........#
#.....#..##
#.........#
#.........#
#..#.......
#.........#
#.........#
#..#..#..##
#.........#
#####.#####

3
0
#####l#####
#.........#
#.........#
#..##.....#
#.........#
#..###.#...
#...##....#
#..#..##..#
#..#...#..#
#..#...#..#
#####.#####
locked : 0

3
2
#####.#####
#.........#
###.......#
#.##......#
#.##......#
...........
#.........#
#.........#
#.........#
#.........#
#####.#####

4
3
#####.#####
#.........#
##.....#..#
#.........#
#.........#
.....#....#
#.........#
#.........#
#...#.....#
#........e#
###########
enemies 1

4
2
#####.#####
#.........#
#..#...#..#
#.#.....#.#
#.........#
d..........
#.........#
#.........#
#.........#
#.........#
#####d#####

3
1
###########
#.........#
#..#......#
#.#.......#
#.........#
...........
#.........#
#.........#
#.........#
#.........#
#####d#####

3
4
#####.#####
#.........#
#.........#
#.........#
#.........#
..........#
#.........#
#.........#
#.........#
#........k#
###########
key : 2

5
2
#####d#####
##.....#.##
#.........#
#..#.#.#.##
#.........#
...#.#.#..#
#.........#
##...#.#..#
#.........#
#..#...#..#
###########

4
0
#####.#####
#.........#
##.....#..#
#.........#
#.....#.#.#
#..........
#..#.#.#..#
#.........#
#s..#.#.#.#
#e?.e.....#
###########
enemies 2
switch 0 : 0 1
sign A locked path — look elsewhere first.

1
1
###########
#.........#
#......#..#
#.......#.#
#.........#
..........#
#.........#
#.......#.#
#......#..#
#.........#
###########

2
0
#####.#####
#......#..#
#.....##..#
#.........#
#.........#
#....@....#
#.........#
#.........#
#.........#
#.........#
#####l#####

