5
1
#####.#####
#k........#
#......#..#
#.......#.#
#.........#
...........
#.........#
#.#.....#.#
#..#...#..#
#.........#
#####.#####
key : 1

4
0
#####.#####
#.........#
#.........#
#.........#
#...@.#...#
#....#.#...
#.......#.#
#.......#.#
#.....###.#
#.........#
#####.#####

5
0
#####.#####
#..#......#
#.##..#...#
#..##.....#
#....#....#
#..........
#.........#
#.........#
#.........#
#.........#
#####.#####

6
0
#####.#####
#.........#
#.........#
#.........#
#.........#
#.........l
#......#..#
#.........#
#e........#
#es.......#
###########
enemies 2
switch 0 : 0

3
0
###########
#.........#
#.........#
#.........#
#.........#
#.........#
#.........#
#.........#
#.........#
#.........#
#####.#####

5
2
#####.#####
#.........#
#...#.....#
#....###.##
#...#.#...#
......k#..#
#.....##..#
#.....###.#
#.........#
#.........#
#####.#####
key : 2

3
2
#####d#####
#.........#
#.........#
#.........#
#.........#
#..........
#.........#
#.........#
#.........#
#.........#
#####.#####

4
3
#####.#####
#.........#
#.........#
#.........#
#.........#
d...#.....#
#......#..#
#.........#
#.........#
#.........#
###########

7
2
#####.#####
#?........#
#.........#
#.........#
#.........#
.........e#
#.........#
#.........#
#.........#
#.........#
#####.#####
enemies 1
door 0 : 0
sign Something glints behind that door…

6
2
#####.#####
#.........#
#.........#
##..#.....#
#.........#
..........#
#.#.....#k#
#.........#
#.........#
#......#..#
#####.#####
key : 3

4
1
###########
#.........#
#.........#
#....#.####
#....k###.#
....##....l
#..#.#..#.#
#....##.###
#..#......#
#.........#
#####.#####
key : 0

4
2
#####.#####
#.........#
#.........#
#....##...#
#.....#...#
l...#..#..d
#.####....#
#...#.....#
#.#.#.#...#
#.#.......#
#####.#####
locked : 0

2
2
#####d#####
#.........#
#.#...#...#
#.........#
#.#.#...#.#
#.........#
#.#.#.#.#.#
#.........#
#...#...#.#
#.........#
#####d#####

6
1
#####.#####
#.#.....#.#
#.........#
#.#.#.#.#.#
#.........#
l...#.#....
#.........#
#...#.#.#.#
#.........#
#.#.......#
#####d#####
locked : 2

7
1
#####d#####
#........##
#.........#
#.........#
#...#..#..#
#..........
#.........#
#.....#..##
#.........#
#.........#
###########

0
2
###########
#X........#
#..#...#..#
#....#.#..#
#..#..##..#
#..#..##..#
#.....###.#
#.....##..#
#.....##..#
#.........#
#####.#####

1
2
#####.#####
#.........#
#.........#
#.........#
#.........#
#....e....#
#.........#
#.........#
#.........#
#.........#
#####d#####
boss
enemies 1

3
3
###########
#.........#
#.........#
#..#####..#
#..##.#...#
..........#
#...####..#
#..####...#
#.......#.#
#.........#
#####.#####

8
2
#####.#####
#.........#
#.........#
#....#..#.#
#.........#
#.........#
#..#..#...#
#.........#
#.........#
#e......#e#
###########
enemies 2

