2
1
###########
#....k....#
#.........#
#.........#
#.#.......#
......#....
#.........#
#.........#
#.........#
#.........#
#####.#####
key : 1

0
3
###########
#.........#
#..#..#...#
#.........#
#.........#
d..#......#
#.........#
#.........#
#..#..#..##
#.........#
#####.#####

2
0
###########
##?....#..#
#e........#
##.#.....##
#.........#
#......#...
#.........#
##...#.#.##
#.........#
##.#...#.##
#####.#####
enemies 1
sign A useful tool lies just ahead.

3
2
#####.#####
#.........#
##.#...#..#
#.........#
#..#.#....#
...........
#....#.#..#
#.........#
##.#...#..#
#.........#
#####l#####

4
2
#####l#####
#.#.....#.#
#.........#
#.........#
#.#..#..#.#
..........l
#.........#
#.#..#..#.#
#.........#
#.........#
###########
locked : 1

2
3
#####.#####
#..#......#
#...#.##..#
#..#...#..#
#...##.#..#
l...#..#...
#...#..##.#
#...#.##..#
#...#..##.#
#.........#
#####.#####
locked : 4

2
2
#####.#####
#.........#
#...#.....#
#.....#...#
#...#.....#
....##.#..l
#..#k#....#
#....#.#..#
#..##.#...#
#.........#
#####.#####
key : 4

4
0
#####.#####
#.........#
#..#......#
#.........#
#..##.#...#
#k.........
#....#....#
#.........#
#.........#
#.........#
#####d#####
key : 0

4
3
#####.#####
#.........#
#......#..#
#.......#.#
#.........#
l.........#
#.........#
#.........#
#.........#
#.........#
###########
locked : 0

3
1
#####.#####
#.........#
#..#...#..#
#.#.....#.#
#.........#
...........
#.........#
#.........#
#.........#
#.........#
#####.#####

5
0
#####d#####
#.........#
#.........#
#.........#
#.........#
#.........#
#.#.......#
####......#
####......#
#.........#
###########

3
0
#####.#####
#.........#
#.........#
#..#####..#
#...####..#
#...###....
#..#@.##..#
#..#......#
#.........#
#.........#
#####.#####

1
3
#####.#####
#.........#
#.........#
#.........#
#.........#
d.........d
#.........#
#.#.......#
#..#......#
#.........#
#####.#####

1
4
###########
#.........#
#.........#
#.........#
#.........#
d....e....#
#.........#
#.........#
#.........#
#.........#
#####.#####
boss
enemies 1

2
4
#####.#####
#.........#
#.#.......#
#.........#
#.........#
..........#
#.........#
#.........#
#.........#
#........X#
###########

1
2
#####.#####
#.........#
##..#.....#
#.........#
#.........#
#.........d
#.........#
#.........#
##..#..#..#
#.........#
#####.#####

3
3
#####.#####
#.........#
#.........#
#.........#
#.........#
.........k#
#.........#
#.#.......#
#..#......#
#.........#
#####.#####
key : 3

0
2
###########
#.........#
#.........#
#.........#
#.........#
#.........d
#.........#
#.........#
#.........#
#.........#
#####.#####

4
1
#####.#####
#.........#
#.........#
#.........#
#.........#
...........
#.........#
#.#.......#
#..#......#
#.........#
###########

