5
1
#####l#####
####......#
###.......#
##........#
#..##.....#
...#.#.....
#.........#
#.........#
#.........#
#.........#
###########
locked : 0

6
0
#####d#####
#.........#
#.........#
#.........#
#.........#
#.........#
#.........#
#.........#
#.........#
#.........#
###########

4
0
#####.#####
#.........#
#.........#
#.........#
#.........#
#..........
#.........#
#.......#.#
#......#..#
#.........#
#####.#####

6
3
#####.#####
#.........#
#.........#
#.........#
#.#.......#
#..#......#
#.........#
#####.....#
#####.....#
#X........#
###########

4
3
###########
#.........#
#.........#
#.........#
#.........#
....##.....
#...##....#
#...###...#
#.........#
#.........#
#####d#####

1
1
###########
##........#
###.#.....#
#####.....#
#.###.....#
...##.....#
#.........#
#.........#
#.........#
#.........#
#####.#####

1
0
#####l#####
#.........#
#.........#
#.#.#.....#
#.##......#
#..........
#k##.###..#
###.#.#...#
#.....#.#.#
#.........#
#####.#####
key : 3

2
1
#####.#####
#e.......?#
##.....#.##
#.........#
#.#...#.#.#
..........#
#..#.#.#..#
#.........#
#.#.#.#.#.#
#.........#
#####.#####
enemies 1
sign What you seek is close.

4
2
#####.#####
#.........#
#..#......#
#.#.......#
#.........#
d..........
#.#.......#
#.......#.#
#......#..#
#.........#
#####d#####

3
0
#####.#####
#.........#
#.........#
#.........#
#.........#
#....@.....
#..#......#
#.#.......#
#.........#
#.........#
#####.#####

4
1
#####.#####
#.........#
#.........#
#.......#.#
#.#.......#
...##.....d
#.##......#
#.###.....#
###.#.....#
#.........#
#####l#####

2
0
#####.#####
#.........#
#.........#
#.........#
#.........#
#k.........
#.........#
#.........#
#.........#
#.........#
#####.#####
key : 0

0
0
###########
##.#...#..#
#.........#
#.#.#.#...#
#.........#
#..#.#.#..#
#.........#
#.#...#.#.#
#.........#
##.#...#.##
#####l#####
locked : 1

5
2
#####d#####
#.........#
#......#..#
#.......#.#
#.........#
...........
#.........#
#.#...#...#
#..#......#
#.........#
###########

3
1
#####.#####
#.........#
#..#......#
#.#.......#
#.........#
...........
#.........#
#.........#
#.........#
#.........#
#####.#####

4
4
###########
#........k#
#.........#
#.........#
#.........#
..........#
#.........#
#.........#
#.........#
#.........#
###########
key : 4

5
3
#####d#####
#.........#
#.........#
#.........#
#..##.....#
....#e....#
#....#.#..#
#......#..#
#.........#
#.........#
#####.#####
boss
enemies 1

3
2
###########
#........k#
##.#...#..#
#.........#
#......#..#
..........#
#......#..#
#.........#
##.#...#.##
#.........#
#####.#####
key : 1

5
0
#####.#####
#.........#
#.........#
#.........#
#.........#
#..........
#.........#
#.........#
#.........#
#.........#
#####d#####

