3
1
#####D#####
#.........#
#.........#
#.........#
#.........#
D.........#
#.........#
#.......#.#
#......#..#
#.........#
#####D#####

2
2
#####D#####
#.........#
#.........#
#.........#
#.........#
D.........#
#.........#
#.........#
#.........#
#........k#
###########
key : 5

0
1
###########
#........X#
#.........#
#.........#
#.........#
D.........#
#.........#
#.........#
#.........#
#.........#
#####D#####

2
1
#####D#####
#.........#
#.........#
#.#####...#
#..###....#
D...###...D
#..##.....#
###.#.#...#
###.#.....#
###.......#
#####D#####

6
2
#####D#####
#.........#
##.#...#.##
#.........#
#..#.#.#..#
D.........#
#..#.#.#..#
#.........#
#......#.##
#........k#
###########
key : 4

4
2
###########
#.........#
#......#..#
#...##.#..#
#...#..##.#
d......#..#
#....##.#.#
#....#....#
#.........#
#.........#
#####D#####

1
0
#####D#####
#.........#
#......#..#
#.......#.#
#.........#
#.........d
#.........#
#.........#
#.........#
#.........#
#####d#####

7
1
#####d#####
#.........#
#..#...#..#
#.#.....#.#
#.........#
#..#......#
#.........#
#.........#
#.........#
#.........#
###########

4
1
#####D#####
#k........#
#.....#...#
#.........#
#...#.#.#.#
D.........d
#.#.#.#.#.#
#.........#
#...#.#.#.#
#.........#
#####D#####
key : 0

3
0
#####l#####
#.......#.#
#...#..#..#
#...###...#
#....#....#
#.........D
#.........#
#.........#
#.........#
#.........#
#####D#####

5
0
#####D#####
#.........#
#.........#
#.........#
#.........#
#.........D
#.........#
#.........#
#?........#
#e........#
###########
enemies 1
sign Many have walked this path.

5
2
#####D#####
#.........#
#.........#
#..#..#...#
#.........#
D........k#
#..#......#
#.........#
#.........#
#..#.....##
#####D#####
key : 2

0
0
###########
#.........#
#.#.#.#.#.#
#.........#
#..#.#.#..#
#.........D
#.#.#.#...#
#.........#
#..#...#.##
#.........#
#####D#####

2
0
#####d#####
#......#.##
#.........#
#..#......#
#.........#
#..#...#..D
#.........#
##.#...#.##
#.........#
##.#...#.##
#####l#####
locked : 0

6
1
#####l#####
##.....#..#
#.........#
#.........#
#.#.....#.#
#.........D
#.........#
##..#..#..#
#.........#
#.........#
#####d#####
locked : 2

4
0
#####D#####
#.........#
#.........#
#.........#
#.........#
#?...@....D
#.........#
#.........#
#.........#
#.........#
#####D#####
sign A useful tool lies just ahead.

5
1
#####D#####
#.........#
#.....##..#
#....#...##
#..##.##..#
D..#...#..D
#.....#...#
#....#....#
#...#..#..#
#.........#
#####l#####

1
1
#####D#####
#.........#
#.........#
#.........#
#.........#
d....e....D
#.........#
#.........#
#.........#
#.........#
#####D#####
boss
enemies 1

1
2
###########
#.........#
#.#.#.#.#.#
#.........#
#..#.#.#..#
D.........#
#.#.#.#.#.#
#.........#
#..#...#.##
#.........#
#####D#####

