3
2
#####.#####
#.........#
#......#.##
#.........#
#..#.#....#
l.........#
#..#.#.#..#
#.........#
#......#..#
#.........#
#####.#####
locked : 1

1
2
###########
####.....e#
####...#..#
#.#...#.#.#
#.#.#.....#
..........#
#.........#
#.........#
#.........#
#.........#
#####.#####
enemies 1

4
3
###########
#.#.......#
#.........#
#.........#
#.........#
d....e....#
#......#..#
#.........#
#.........#
#.........#
#####.#####
boss
enemies 1

4
1
#####.#####
#.........#
#......#..#
#.......#.#
#.........#
...........
#.........#
#.........#
#.........#
#.........#
#####.#####

1
1
#####.#####
###....##.#
#.........#
#.#.....#.#
#.........#
#..........
#.........#
#.........#
#.........#
#.........#
#####l#####
locked : 0

3
1
#####.#####
#k.#.....##
#.........#
#.........#
#...#..#..#
..........l
#.........#
#........##
#.........#
#.........#
#####.#####
key : 0

6
0
#####l#####
#.........#
#......#..#
#......#..#
#..#.#....#
#...##.....
#...##....#
#.........#
#.........#
#.........#
###########
locked : 4

6
1
#####d#####
#.#.....#.#
#.........#
#.#.#.#.#.#
#.........#
....#.....#
#.........#
#.#...#.#.#
#.........#
#.........#
###########

4
2
#####.#####
#k........#
#.#.......#
#.........#
#....#....#
..........d
#...#.....#
#...#.#...#
#...#.....#
#.........#
#####.#####
key : 5

2
1
#####l#####
#.........#
#..##.....#
#.....#...#
#..##.#...#
d....##...d
#.##.#....#
#.##......#
#.##......#
####......#
#####.#####

3
0
#####.#####
#..#...#..#
#.........#
#..#.#.#..#
#...#.#...#
#..##@.#...
#.........#
#.........#
#.........#
#.........#
#####.#####

4
0
#####.#####
#.........#
#..#......#
#.#.......#
#.........#
#..........
#.........#
#.........#
#.........#
#.........#
#####.#####

5
0
#####.#####
#.........#
#.........#
##..#.....#
#.........#
#..........
#...#.....#
#.........#
#.........#
##.....#..#
#####l#####

5
2
#####.#####
#.........#
#.........#
##...#....#
#....#?#..#
.....e##...
#....##...#
#.....##.##
#.........#
#.........#
###########
enemies 1
sign The brave are rewarded.

2
0
###########
##k#......#
#.........#
#.#.......#
#.........#
#..#.#.#..d
#.........#
#.#.#.#...#
#.........#
##.....#.##
#####.#####
key : 1

5
3
#####.#####
#.........#
#.........#
#.........#
#..#......#
.....##...#
#..#.##.#.#
#....#.#..#
#......#..#
#......#.X#
###########

2
2
#####.#####
#.........#
#.........#
#.........#
#.........#
d.........#
#.........#
#.........#
#.........#
#.........#
#####.#####

5
1
#####.#####
#k........#
#......#..#
#.......#.#
#.........#
...........
#.........#
#.........#
#.........#
#.........#
#####d#####
key : 4

0
1
###########
#.........#
#.........#
#.........#
#.........#
#...##.#..#
#....##.#.#
#...###...#
#.....###.#
#.........#
#####.#####

