4
2
#####.#####
#k........#
##........#
##........#
#..#......#
..........d
#.........#
#.........#
#.........#
#.........#
#####.#####
key : 1

5
1
#####d#####
#.........#
#...#.....#
#.........#
#.........#
...........
#.........#
#.........#
#.....#...#
##........#
###########

4
3
#####.#####
#.........#
#......#..#
#.......#.#
#.........#
d.........#
#.........#
#.........#
#.........#
#.........#
###########

6
0
#####.#####
#.........#
#.........#
#.........#
#.........#
#.........#
#.........#
#.........#
#.........#
#e........#
###########
enemies 1

3
3
#####.#####
##.....#..#
#.........#
#.........#
#...#..#..#
..........#
#.........#
##..#.....#
#.........#
#.........#
#####.#####

2
2
#####.#####
#.........#
#.........#
#.........#
#....###..#
.....###...
#.#.......#
#..#.######
##....#####
#.........#
#####d#####

0
3
###########
#........X#
#.........#
#.........#
#.#.......#
....#.#...#
#...##....#
#...##....#
#..#......#
#.........#
#####.#####

5
0
#####.#####
#..#.....##
#.........#
#.........#
#..#..#...#
#k.........
#.........#
#..#.....##
#.........#
#.........#
#####.#####
key : 0

5
2
#####.#####
#.......#.#
#......#..#
#...#...#.#
#.........#
..........#
#.........#
#.........#
#.........#
#.........#
###########

3
1
#####.#####
#.........#
#...#...#.#
#....#.##.#
#...#.#.#.#
......#....
#....##...#
#.........#
#...#.....#
#.........#
#####l#####
locked : 1

3
0
###########
##........#
#.##......#
#.##......#
#.........#
#..........
#.........#
#.........#
#.........#
#.........#
#####.#####

3
2
#####d#####
#?......e##
#.....#####
#....#e#e##
#......#..#
...........
#.........#
#.........#
#.........#
#.........#
#####.#####
enemies 3
sign Turn back; you are not yet ready.

4
1
#####l#####
#.........#
#......#..#
#.......#.#
#.........#
...........
#.........#
#.#.......#
#..#......#
#.........#
#####d#####

4
0
#####.#####
#.........#
#.........#
#.........#
#.........#
#....@.....
#?#.......#
#.#.......#
#.........#
#.........#
#####.#####
sign Something glints behind that door…

1
2
#####.#####
#.........#
#.#.#.#.#.#
#.........#
#k#.#.#.#.#
#.........d
#.#.#.....#
#.........#
#...#.#.#.#
#.........#
#####.#####
key : 4

1
3
#####.#####
#.........#
##....#.#.#
#...##.##.#
#..##...#.#
d...#e#...#
#..##.....#
#.........#
#.........#
#.........#
#####.#####
boss
enemies 1

2
1
###########
#k........#
#.........#
#...#..#..#
#.........#
#..........
#.#..#..#.#
#.........#
#.........#
##.....#..#
#####.#####
key : 2

2
3
#####.#####
#.........#
#..##.....#
#...####..#
#..###....#
...#####..#
#....###..#
#.........#
#.........#
#.........#
#####.#####

0
2
###########
#.........#
#.........#
##..#..#..#
#.........#
#..........
#.#..#..#.#
#.........#
#.........#
##........#
#####.#####

