3
1
#####d#####
#........e#
#........##
#.........#
#.......#.#
#..........
#.........#
#.........#
#.........#
#.........#
#####.#####
enemies 1

6
3
#####.#####
#.........#
#.........#
#.........#
#.........#
l.........#
#.........#
#.........#
#.........#
#.........#
#####d#####
locked : 1

5
2
#####.#####
#k........#
#.........#
#.........#
#.........#
...........
#.........#
#.........#
#.........#
#.........#
#####.#####
key : 1

2
2
#####.#####
#.........#
#.##..##..#
#..#..##..#
#.####....#
....#......
#.........#
#.........#
#.....#...#
#.........#
#####.#####

3
2
#####.#####
#..#...#..#
#.........#
#..#.#.#.##
#.........#
...#.#....#
#.........#
##.#.#.#.##
#.........#
##.#...#..#
#####.#####

0
2
###########
#k........#
#..#...#..#
#.#.....#.#
#.........#
#..#..#...#
#......#..#
#.#.......#
#..#......#
#.........#
#####.#####
key : 3

2
1
#####d#####
#.........#
#..#......#
#.#.......#
#.........#
#..........
#.........#
#.........#
#.........#
#.........#
#####d#####

5
0
###########
#.........#
#.........#
#....###..#
#.........#
#....@.....
#.........#
#.........#
#.........#
#.........#
###########

1
1
###########
#.........#
##.#.....##
#.........#
#..#.#.#..#
#..........
#..#...#..#
#.........#
##.#...#.##
#.........#
#####d#####

4
1
#####.#####
#.........#
#.........#
#.........#
#.........#
#..........
#.........#
#.........#
#.........#
#.........#
#####l#####
locked : 0

2
3
#####.#####
#.........#
#.....#...#
#....#....#
#.........#
..........#
#.........#
#.........#
#.........#
#........X#
###########

7
3
#####d#####
#.........#
#.#.#.#...#
#.........#
#..#...#..#
#.........#
#...#.#.#.#
#.........#
#..#...#.##
#.........#
###########

4
2
#####.#####
#.........#
#......#..#
#.......#.#
#.........#
..........#
#.........#
#.#.......#
#..#......#
#.........#
#####.#####

6
2
#####.#####
#.........#
#.....##..#
#.......#.#
#.........#
..........l
#.##......#
#.........#
#.........#
#.........#
###########

5
3
###########
#........k#
#..#......#
#.#.......#
#.........#
..........#
#.........#
#.......#.#
#......#..#
#.........#
#####.#####
key : 2

6
1
#####.#####
##.#...#.##
#.........#
#.#.#.#.#.#
#.........#
#..#.......
#.........#
#...#.#.#.#
#.........#
##.#...#.##
###########

5
1
#####l#####
#k........#
#.#.....#.#
#.........#
#.........#
...#..#....
#.........#
#.........#
#.......#.#
#.........#
#####.#####
key : 0

1
2
#####.#####
#.........#
#.........#
#.........#
#.........#
....###...d
#....#....#
#..###....#
#......#..#
#..#...#..#
#####.#####

1
3
###########
#.........#
#.........#
#.........#
#.........#
d....e....#
#.........#
#.........#
#.........#
#.........#
#####.#####
boss
enemies 1

