2
1
#####d#####
#.........#
#.##......#
#.##......#
#..##.###.#
d...#.##..d
#....##...#
#.....#...#
#.........#
#.........#
#####D#####

6
1
#####d#####
#.........#
#.........#
#.........#
#.........#
D.........#
#.........#
#.........#
#.........#
#.........#
###########

1
1
###########
#.........#
#.........#
#.........#
#.........#
D.........D
#.........#
#.........#
#.........#
#.........#
#####d#####

5
1
#####D#####
#k........#
#.........#
#.........#
#.........#
D.........D
#.........#
#.#.......#
#..#......#
#.........#
#####d#####
key : 0

6
0
#####D#####
#......p..#
#...#.#...#
#p.#..#...#
#.###.#...#
#..##.#...D
#.....#...#
#.........#
#.........#
#k........#
###########
key : 1

5
2
#####D#####
#.........#
#..#...#..#
#.#.....#.#
#.........#
D.........D
#.........#
#.........#
#.........#
#.........#
###########

1
2
###########
#........X#
#.........#
#.........#
#.........#
D.........#
#......#..#
#....#....#
#.....#...#
#.........#
#####D#####

5
3
###########
#......#?e#
#......#..#
#...#.###.#
#.#.......#
D..##.....#
#......p..#
#.........#
#......p..#
#........e#
###########
enemies 2
sign The dungeon remembers all who enter.

1
0
#####D#####
#.........#
#.........#
#.........#
#.........#
#.........D
#..p....p.#
#.........#
#.........#
#.........#
#####D#####

4
1
#####D#####
##.#...#.##
#.........#
#.....#.#.#
#.........#
D..#.#.#..D
#.........#
#.#.#.#.#.#
#.........#
##.#...#..#
#####D#####

3
0
#####l#####
#.........#
#.........#
#.........#
#.........#
#.........D
#.........#
#.........#
#.........#
#.........#
#####l#####
locked : 0

5
0
#####D#####
#.........#
#.........#
#.........#
#...#.....#
#...#@....D
#?####....#
##.#......#
##........#
###.......#
#####D#####
sign The brave are rewarded.

2
0
#####D#####
##.......##
#.........#
#..#.#.#.##
#.........#
#....#.#..d
#.........#
##.#...#.##
#.........#
#..#...#.##
#####l#####
locked : 1

4
2
#####D#####
#.........#
#..#..#...#
#.#......##
#........k#
D.........#
#.........#
#.........#
#.........#
#.........#
#####D#####
key : 3

3
1
#####D#####
##........#
##.#......#
#.#.......#
#.###.....#
D.....#...D
#....#.#..#
#....#.####
#......#.##
#........##
#####D#####

2
2
#####D#####
#......#..#
#..#...#..#
#.p#..#...#
#..#...#..#
d...#e....#
#....p....#
#.........#
#.........#
#.........#
#####D#####
boss
enemies 1

0
0
###########
#k........#
#.........#
#.........#
#..#......#
#...#.....#
#.###.....#
#####.....#
#...#.....#
#.........#
#####D#####
key : 5

4
0
#####l#####
#e........#
#.........#
#.........#
#e........#
#e........D
#.........#
#.........#
#.........#
#.........#
#####D#####
enemies 3

3
2
#####D#####
#e#.......#
#.........#
#.........#
#.........#
D........e#
#.........#
#.........#
#.....#...#
#.........#
#####D#####
enemies 2

