2
2
#####D#####
#.........#
#.........#
#.........#
#.........#
D.........D
#.........#
#.........#
#.........#
#........##
#####D#####

3
3
#####D#####
#.........#
#..#......#
#.#.......#
#.........#
d.........#
#.........#
#.........#
#.........#
#.........#
###########

3
1
#####l#####
#.........#
#.........#
#.........#
#.........#
d.........D
#.........#
#.........#
#...#.....#
#.........#
#####D#####

1
0
###########
#k........#
#.........#
#.........#
#.........#
#.........D
#.........#
#...#.....#
#.........#
#.........#
#####D#####
key : 2

2
4
#####D#####
#......#..#
#.........#
#......#..#
#....##...#
D..#..#...#
#..#.##...#
#..#.##...#
#.....#...#
#........X#
###########

1
1
###########
#.........#
#......#..#
#.......#.#
#.........#
D.........D
#.........#
#.......#.#
#......#..#
#.........#
#####l#####
locked : 2

3
2
#####D#####
#.#.....#.#
#.........#
#......#..#
#.........#
D...#.#...d
#.........#
#..#...#.##
#.........#
#.......#.#
#####d#####

1
4
###########
#.........#
#.........#
#.........#
#.........#
l....e....#
#.........#
#.........#
#.........#
#.........#
#####D#####
locked : 4
boss
enemies 1

1
2
###########
#.........#
#.........#
#.........#
#.........#
D.........D
#.........#
#.........#
#.........#
#.........#
#####D#####

2
0
#####D#####
#.........#
#.#.#.#.#.#
#.........#
#k#.#.#...#
#.........D
#.#.#...#.#
#.........#
#.#.#.....#
#.........#
#####D#####
key : 0

2
3
#####d#####
#.........#
#.......#.#
#.........#
#....#.#..#
D.........D
#...#...#.#
#.........#
#..#...#.##
#.........#
#####D#####

4
2
#####d#####
#.........#
#.........#
#.........#
#.........#
D.........#
#.........#
#.........#
#.........#
#.........#
###########

2
1
#####l#####
#.........#
#..#...#.##
#.........#
#.#.#.....#
D.........D
#..#.#.#..#
#.........#
#.#.#.#...#
#.........#
#####l#####
locked : 0

0
3
###########
#.........#
#.........#
#.........#
#.........#
#..#......#
#.........#
#.#.......#
#..#......#
#.........#
#####D#####

4
0
#####D#####
#.........#
#.........#
#.........#
#...##..#.#
#...#@.#..D
#...###...#
#....#?##.#
#......##.#
#.........#
#####D#####
sign Those who search shall find.

4
1
#####D#####
#......#.##
#.....##.##
#.....#k..#
#....###..#
D.........D
#.........#
#.........#
#.........#
#.........#
###########
key : 1

3
0
#####D#####
#.........#
##..#..#..#
#.........#
#.........#
#......#..d
#.........#
#.........#
##..#..#..#
#.........#
#####D#####

1
3
#####D#####
#k........#
#..#...#..#
#.#.....#.#
#.........#
D.........l
#.........#
#.........#
#.........#
#.........#
#####d#####
key : 4

5
0
#####D#####
##.....#.##
#.........#
#.#.#.#.#.#
#.........#
#..#...#..#
#.........#
#.#.#.#.#.#
#.........#
##.#.....##
###########

