3
1
###########
#.........#
#.........#
#.........#
#.........#
...........
#.....#...#
#...#.....#
#.#.#.#...#
#...e.....#
###########
enemies 1

5
3
#####.#####
#.........#
#.........#
#.........#
#.........#
#.........#
#.........#
#.........#
#.........#
#k........#
###########
key : 2

4
0
#####.#####
#.........#
#?#.......#
#..##.....#
#...#.....#
#....@....#
#.........#
#.........#
#.........#
#.........#
#####.#####
sign The dungeon remembers all who enter.

5
0
#####.#####
#.........#
#...#.....#
#.........#
#.........#
#..........
#.........#
#.#.....#.#
#..#...#..#
#.........#
#####d#####

3
4
#####.#####
#.........#
#.......#.#
#.........#
#.........#
.....#....#
#.........#
#.........#
#.#.....#.#
#.........#
#####.#####

3
3
#####d#####
#k#.......#
#..#...#..#
#.#.....#.#
#.....#...#
...........
#.........#
#.#.......#
#..#......#
#......#..#
#####d#####
key : 0

4
3
#####d#####
#.........#
#..#..#..##
#.........#
#.........#
#.....#....
#.........#
#.........#
#..#..#..##
#.........#
#####.#####

3
0
###########
#e#e......#
#e#.......#
#..#......#
#.........#
#..........
#.........#
#.........#
#.........#
#.........#
#####.#####
enemies 3

6
0
#####d#####
#.........#
#..#...#..#
#.#.....#.#
#.........#
#.........#
#.........#
#.......#.#
#......#..#
#.........#
###########

1
4
###########
##........#
#.........#
#.........#
#....#..#.#
#.........l
#.........#
##..#..#..#
#.........#
#.........#
#####d#####

4
4
#####.#####
#.#.....#.#
#.........#
#.........#
#.........#
..........#
#.........#
#.#..#..#.#
#.........#
#........k#
###########
key : 1

2
5
#####.#####
#.........#
#...#.#.#.#
#.........#
#.#.#.#.#.#
..........#
#.#.#...#.#
#.........#
#.#.#.#.#.#
#.........#
###########

2
2
###########
##.#...#.##
#.........#
##.#.#.#..#
#.........#
#..#.#.#...
#.........#
##.#.#....#
#.........#
##.#...#.##
#####.#####

1
5
#####.#####
#.........#
#.........#
#.........#
#.........#
l....e....#
#.........#
#.........#
#.........#
#.........#
#####.#####
locked : 0
boss
enemies 1

3
2
#####.#####
#e........#
##.#...#.##
#.........#
#..#.#.#..#
...........
#..#...#..#
#.........#
##.#...#.##
#.........#
###########
enemies 1

2
4
#####d#####
#..#......#
#.##..#...#
#.#k#.#...#
#.........#
....#......
#.........#
#.........#
#.........#
#.........#
#####.#####
key : 3

5
1
###########
#.#....e#e#
#.........#
#.........#
#.........#
..........#
#.........#
#.#..#....#
#.........#
#.......?e#
###########
enemies 3
sign Many have walked this path.

2
3
###########
#.........#
#.........#
#.........#
#.........#
...........
#.........#
#.........#
#...#.....#
#........##
#####d#####

0
5
###########
#X........#
#.........#
#.........#
#.........#
#.........#
#.........#
#.........#
#.........#
#.........#
#####.#####

