1
2
###########
#........k#
#........##
#.......#.#
#.........#
D.........#
#.........#
#.........#
#..#......#
#.........#
#####D#####
key : 1

2
2
#####D#####
##.....#..#
#.........#
#.........#
#.........#
D.........D
#.........#
##..#..#..#
#.........#
#.........#
#####d#####

3
0
#####D#####
#..#...#..#
#.....#...#
#...#..#..#
#..##..#..#
#....@.#..D
#.........#
#.........#
#.........#
#?p.......#
#####D#####
sign Beware what lurks ahead.

5
3
#####D#####
#........##
#......#.##
#......##.#
#...p##.#.#
#....#....#
#....#....#
#....p###.#
#......##.#
#X........#
###########

2
1
#####D#####
#.........#
#.......p.#
#.........#
#.........#
l.........D
#..p......#
#.........#
#.........#
#.........#
#####D#####
locked : 0

1
1
###########
#.........#
#.........#
#.........#
#..#......#
D...#.....D
#.....#...#
#...###...#
#.........#
#......#..#
#####D#####

4
0
#####D#####
#.........#
#.........#
#.........#
#.........#
#.........D
#.........#
#.........#
#.........#
#.........#
#####D#####

5
0
#####D#####
#.........#
#.........#
#.........#
#....#....#
#...###...#
#...####..#
#.....#...#
#......#..#
#.........#
###########

2
3
###########
#.........#
#.........#
#.........#
#.........#
D.........#
#.........#
#.#.....#.#
#..#...#..#
#.........#
#####D#####

2
0
#####D#####
#e........#
#.........#
#.........#
#.........#
#e........l
#.........#
#.........#
#.........#
#.........#
#####D#####
enemies 2

4
1
#####D#####
#.........#
#.#...#.#.#
#.........#
#..#.#.#..#
D.........d
#.#.#.#.#.#
#.........#
#..#.....##
#.........#
###########

4
2
#####D#####
#.........#
#.........#
#.........#
#.........#
d......#..D
#.....#...#
#......##.#
#.........#
#.........#
###########

3
2
#####d#####
#e........#
####..##..#
##.##.#?..#
#..##..##.#
D....#.#..d
#.........#
#.........#
#.........#
#.........#
#####D#####
enemies 1
sign The dungeon remembers all who enter.

3
3
#####D#####
#.........#
#.........#
#.........#
#.........#
d....e....D
#...#.....#
#..##.....#
#.##......#
#.........#
#####D#####
boss
enemies 1

4
3
#####D#####
#k........#
####......#
#.#..#....#
#..#......#
D...##....#
#..###....#
#####.....#
#.........#
#.#.......#
#####D#####
key : 2

3
4
###########
#........k#
#.........#
#...#.#...#
#...#...#.#
D....#....#
#...#####.#
#...#####.#
#.......#.#
#.........#
###########
key : 3

0
0
###########
#.........#
#.........#
#.........#
#.##......#
#..##.....#
#...#.....#
#.........#
#.........#
#.........#
#####d#####

3
1
#####D#####
#.........#
#.........#
#...##..#.#
#......##.#
D...#e#?..D
#...####..#
#.....#...#
#.........#
#.........#
#####D#####
enemies 1
sign A locked path — look elsewhere first.

1
0
#####d#####
#.........#
#.........#
#.........#
#.........#
#.........D
#.........#
#k#.......#
#..#......#
#.........#
#####D#####
key : 0

