1
1
#####l#####
#......#..#
#.........#
#.........#
#.........#
D.........D
#.........#
##..#..#..#
#.........#
#.........#
#####D#####
locked : 0

4
0
#####D#####
#.........#
#.........#
#.........#
#.........#
#.........#
#.........#
#.........#
#.........#
#k........#
###########
key : 3

2
4
#####D#####
##.#.....##
##..#.#.#.#
#....##.#.#
#...#.....#
d...#e.#..#
#.........#
#.........#
#.......#.#
#..#......#
#####D#####
boss
enemies 1

0
2
###########
#.........#
##..#..#..#
#.........#
#.........#
D....#....#
#.........#
#.........#
##..#..#..#
#.........#
#####l#####

4
2
#####d#####
#.........#
#.........#
#.........#
#.......#.#
#.....##..#
#.....##..#
#.....##..#
#.........#
#.........#
###########

3
1
#####D#####
#.........#
#......#..#
#.......#.#
#.........#
D.........D
#.........#
#.......#.#
#......#..#
#.........#
###########

0
0
###########
#k........#
#.#....#..#
#.#.....#.#
#.........#
#...#.....D
#.........#
#.#.......#
#..#......#
#.........#
#####D#####
key : 0

1
2
#####l#####
#.........#
#........p#
#.........#
#.........#
D.........#
#.........#
#.........#
#.........#
#.........#
#####d#####
locked : 1

1
0
#####D#####
#.........#
#.....#...#
##........#
#.#.#.....#
#..#.@....D
#.........#
#.........#
#.........#
#.........#
#####D#####

2
2
#####d#####
#.........#
#.#.#.....#
#.##......#
#.###.....#
D..#......D
#..##.....#
#.........#
#.........#
#.........#
#####D#####

3
0
#####D#####
##.....#.##
#e........#
##.....#..#
#e........#
#....#.#..D
#s........#
##...#.#..#
#e........#
##.#...#.##
#####D#####
enemies 3
switch 0 : 0 1

0
1
###########
#k#.....#.#
#.........#
#......#.##
#.........#
D...#.#...D
#.........#
#..#.....##
#.........#
#.......#.#
#####l#####
key : 1

3
3
#####d#####
#.........#
#..#......#
#.#.......#
#.........#
D.........D
#.........#
#.......#.#
#......#..#
#......k..#
###########
key : 5

2
0
#####D#####
#.........#
#..#......#
#.#.......#
#.........#
#.........D
#.........#
#.......#.#
#......#..#
#.........#
#####D#####

3
4
#####D#####
#.........#
#..##.#...#
#....#....#
#..#####..#
D..##.##..#
#..##.##..#
#......e..#
#...#..#..#
#......e?e#
###########
enemies 3
door 0 : 0 1
sign Those who search shall find.

1
4
###########
#X........#
#.........#
#.........#
#.#.##....#
#..###....#
#.##.#....#
#.........#
#.........#
#.........#
#####D#####

2
3
###########
#.........#
#.........#
#..#..#..##
#.........#
D.........d
#..#......#
#.........#
#.........#
#..#.....##
#####d#####

3
2
#####D#####
#.........#
#.........#
#.........#
#.........#
D.........D
#.........#
#.......#.#
#......#..#
#.........#
#####d#####

2
1
#####D#####
#e.......e#
#.........#
##..#.....#
#.........#
D.........D
#....#..#.#
#.........#
#.........#
##........#
#####D#####
enemies 2

