3
0
#####D#####
#.........#
#.........#
#.........#
#.........#
#.........#
#.........#
#.#.....#.#
#..#...#..#
#.........#
###########

2
1
#####d#####
#........e#
#..#..#..##
#.........#
#.........#
D..#......D
#.........#
#.........#
#..#..#...#
#.....e...#
###########
enemies 2

2
2
#####l#####
#.........#
#.........#
#......##.#
#.....###.#
D.....#...D
#.........#
#.........#
#.........#
#.........#
#####D#####

2
4
###########
#....k....#
#.........#
#.........#
#.........#
D.........D
#.........#
#.........#
#.........#
#.........#
#####D#####
key : 2

2
5
###########
#........k#
##.#...#..#
#.........#
#.#.#.#...#
D.........#
#....#....#
#.........#
#.#.#.#...#
#.........#
###########
key : 5

3
4
#####D#####
#.........#
#.........#
#.........#
#.........#
D.....#...#
#....#....#
#.....##..#
#.....##.##
#......ee##
###########
enemies 2

1
3
#####D#####
#.........#
#.........#
#.........#
#.........#
d....e....#
#.........#
#.........#
#.........#
#.........#
#####D#####
boss
enemies 1

1
2
#####d#####
#.........#
#.........#
#.........#
#.........#
D.........d
#.........#
#.........#
#.........#
#.........#
#####l#####
locked : 0

3
3
#####D#####
#e.......s#
#.........#
#.....#...#
#.....#.#.#
D.....#...D
#.........#
#.........#
#.........#
#e........#
#####D#####
enemies 2
switch 0 : 0

0
1
###########
#.........#
#.........#
#.........#
#.........#
#.........D
#.........#
#.........#
#.........#
#.........#
#####d#####

1
0
###########
#k........#
#.........#
#.........#
#.........#
#.........D
#.........#
#.#.......#
#..#......#
#.........#
#####D#####
key : 0

2
3
#####D#####
#.........#
#.........#
#..##.....#
#..##.....#
D.........D
#.........#
#..##.....#
#..#......#
#.........#
#####D#####

2
0
#####D#####
#.........#
#.#.......#
#?##......#
#.........#
#....@....D
#.........#
#.........#
#.........#
#.........#
#####D#####
sign The walls are warm to the touch.

0
2
###########
#......#.##
#.........#
#...#.#.#.#
#.........#
D..#.#.#..D
#.........#
#.#.#.#.#.#
#.........#
##.#...#.##
#####d#####

4
3
#####D#####
#.........#
#.........#
#.........#
#.........#
D.........#
#..#......#
####......#
#........e#
#......?ee#
###########
enemies 3
door 0 : 0
sign A useful tool lies just ahead.

1
1
#####d#####
#.........#
#......####
#......#..#
#.....#.#.#
D....##...D
#.........#
#.........#
#.........#
#.........#
#####d#####

3
2
#####D#####
#.........#
#.........#
#.#.....#.#
#.........#
#.........D
#.....#...#
#.........#
#.........#
#.......#.#
#####D#####

4
2
#####D#####
#.........#
#..##.....#
#..##.....#
#.........#
#.........D
#.........#
#.........#
#.........#
#k........#
###########
key : 3

0
3
###########
#........X#
#.........#
#.........#
#..###....#
D...#.....#
#.##......#
#.##......#
#.###.....#
#.........#
#####D#####

