2
1
#####.#####
#.........#
#.........#
#.........#
#.........#
....###...l
#..###....#
#.###.....#
#.###.....#
#e##......#
#####.#####
enemies 1

3
3
#####.#####
#.........#
#.....##..#
#......#..#
#....#..#.#
#k.........
#.........#
#.........#
#.........#
#.........#
#####.#####
key : 2

2
4
###########
#.........#
#..#..#...#
#.........#
#.........#
d..#..#...d
#.........#
#.........#
#..#..#...#
#.........#
#####.#####

1
1
#####.#####
##.#...#..#
#.........#
#.#.#.#.#.#
#.........#
...#.#.....
#.........#
#.#.#.#.#.#
#.........#
#..#...#.##
#####.#####

2
3
###########
#e...e....#
#.........#
#.........#
#.........#
..........d
#.........#
#.........#
#.........#
#.........#
#####.#####
enemies 2

5
5
#####.#####
#.........#
#.........#
#.........#
#..##.##..#
#......#..#
#..##.##..#
#.###.....#
#.###..#..#
#X........#
###########

3
5
#####.#####
#k........#
#..#......#
#.#.......#
#.........#
...........
#.........#
#.#.....#.#
#..#...#..#
#.........#
#####l#####
key : 4

3
1
#####.#####
#.#.....#.#
#.........#
#.........#
#....#....#
#.........#
#.........#
#.#..#..#.#
#.........#
#e.......e#
###########
enemies 2

4
5
#####l#####
#.........#
#.........#
#.........#
#.........#
.....e....#
#.........#
#.........#
#.........#
#.........#
#####.#####
locked : 2
boss
enemies 1

2
0
#####.#####
#..#......#
#.........#
#.........#
#...#.....#
#...#@.....
#...###...#
#.........#
#.........#
#.........#
###########

0
1
###########
#.........#
#..#...#..#
#.#.....#.#
#.........#
#.........#
#.........#
#.#.......#
#..#......#
#.........#
#####.#####

2
5
###########
#.........#
#..#......#
#.#.......#
#.........#
d.........#
#.....#...#
#.#.....#.#
#..#...#..#
#.........#
#####.#####

1
0
###########
#k........#
#.........#
#.........#
#.........#
#..........
#.........#
#.........#
#.........#
#.........#
#####.#####
key : 0

2
2
#####d#####
#.#.......#
#..#......#
##........#
#...##....#
l....#.....
#.##.##...#
#.#.......#
#.##......#
#.........#
###########
locked : 0

4
4
#####d#####
#.........#
#......#..#
#.......#.#
#.........#
...........
#.........#
#.......#.#
#......#..#
#.........#
###########

1
2
###########
#.........#
#.........#
#.........#
#.........#
..........#
#.........#
#.#.....#.#
#..#...#..#
#.........#
#####d#####

4
3
#####.#####
#.........#
##.....#..#
#.........#
#.........#
#...#..#...
#.........#
#.........#
##..#..#..#
#.........#
###########

3
4
#####.#####
#.........#
#.........#
##..#..#..#
#.........#
...........
#...#..#..#
#.........#
#.........#
##.....#..#
#####d#####

3
6
###########
#.#.....#k#
#.........#
#.........#
#..#......#
..........#
#.........#
#.#.....#.#
#.........#
#.........#
###########
key : 5

