3
1
#####.#####
#.........#
#.###.#...#
#.#####...#
#...#.....#
...#..#...l
#.#.##....#
#.........#
#.........#
#.........#
###########

1
1
#####d#####
#k........#
#..#....#.#
#..##.....#
#.#..#....#
..........d
#.........#
#.........#
#.........#
#.........#
#####.#####
key : 0

0
1
###########
#.........#
#..#......#
#.#.......#
#.........#
#.........#
#.........#
#.........#
#.........#
#.........#
#####d#####

3
4
#####.#####
#.........#
#.........#
#....#....#
#...#.....#
..........#
#.........#
#..#.....##
#.........#
#........k#
###########
key : 3

1
3
###########
#........k#
#.........#
#.........#
#..#.#....#
..........#
#.#...#.#.#
#.........#
#..#...#..#
#.........#
#####.#####
key : 8

2
4
###########
#.......ee#
#...#.....#
#.####....#
#.#.###...#
....#.....#
#.........#
#.........#
#.........#
#.........#
#####.#####
enemies 2
door 1 : 2

3
3
#####.#####
#........e#
#..#...#.##
#.........#
#..#.#.#..#
...........
#..#.#.#..#
#.........#
##.....#.##
#e...?.s.e#
###########
enemies 3
switch 0 : 0 1
sign This door will not yield without a key.

4
2
#####.#####
##.#...#.##
#.........#
##.#.#.#.##
#.........#
#..#.#.#..#
#.........#
##.#.#.#.##
#k........#
##.#.....##
###########
key : 1

2
0
#####.#####
#.........#
#.........#
#...##....#
#....#....#
#...#@.....
#.........#
####..#...#
#.........#
#.........#
#####d#####

1
0
###########
#..#.....##
#.........#
#.........#
#...#..#..#
#..........
#.........#
#..#..#..##
#.........#
#.........#
#####.#####

3
2
#####.#####
#.........#
#......#..#
#..#....#.#
#.........#
l..........
#.........#
#.........#
#.........#
#.........#
#####.#####
locked : 0

5
0
#####d#####
#.........#
#.........#
#.........#
#.........#
#....e....#
#.........#
#.........#
#.........#
#.........#
#####.#####
boss
enemies 1

2
3
#####.#####
#e........#
#.........#
#...##....#
#...#.....#
....#?.....
#..###....#
#..#......#
#..#......#
#e........#
#####.#####
enemies 2
door 0 : 0 1
sign Something glints behind that door…

4
0
#####.#####
#.........#
#.#.#.#...#
#.........#
#......#..#
#.........#
#.#.#.#.#.#
#.........#
#..#.....##
#.........#
#####d#####

2
1
#####.#####
#.#.....#.#
#.........#
#.#.#.#.#.#
#.........#
....#.#....
#.........#
#...#.#.#.#
#.........#
#.......#.#
#####.#####

2
2
#####.#####
##.......e#
##..#.....#
##........#
#..###....#
...........
#.........#
#.........#
#?........#
##.......s#
#####.#####
enemies 1
switch 1 : 2
sign A locked path — look elsewhere first.

1
2
###########
#.........#
#.........#
#.........#
#...###...#
d....#.....
#...##....#
#.........#
#.........#
#.........#
#####.#####

6
0
#####.#####
#.........#
#.........#
#.........#
#...##....#
#..##.....#
#..#......#
#....#.#..#
#...#.##..#
#X........#
###########

3
0
#####d#####
#.........#
#.........#
#.........#
#.........#
#..........
#.........#
#.........#
#.........#
#.........#
#####.#####

