1
1
###########
#........e#
#.....##..#
###.##?...#
#.#.###...#
...##.#...#
#.#.#.##..#
###.......#
#.........#
#.........#
#####.#####
enemies 1
door 0 : 0
sign Turn back; you are not yet ready.

4
1
#####.#####
##.....#k##
#.........#
#.#.#.#.#.#
#.........#
.....#.#...
#.........#
#.#...#.#.#
#.........#
#..#...#.##
#####.#####
key : 0

0
0
###########
#.........#
#...#.#...#
#...##.#..#
#......#..#
#..#.#....#
#.........#
#.........#
#.........#
#.........#
#####.#####

5
1
#####.#####
#.........#
#......#..#
#.......#k#
#.........#
..........#
#.........#
#.#.....#.#
#..#...#..#
#.........#
#####.#####
key : 2

5
0
#####.#####
#.........#
#.........#
##..#.....#
#.........#
#..........
#.#..#..#.#
#.........#
#.........#
##........#
#####.#####

6
0
#####.#####
#.........#
#.........#
#.....#..##
#.........#
#..........
#.........#
#.#.....#.#
#.##...#..#
#.........#
#####.#####

1
0
#####.#####
#.........#
#.........#
#.........#
#.#.......#
#..#.......
#..#......#
#.........#
#.........#
#.........#
#####d#####

6
2
###########
#.........#
#.........#
#.........#
#.........#
d....e.#..#
#......#..#
#...#.#...#
#.....##.##
#.........#
#####.#####
boss
enemies 1

7
2
#####.#####
#......##.#
#...#.....#
#...#.###.#
#.....##..#
.....#....#
#.........#
#.........#
#.........#
#........X#
###########

7
0
#####.#####
#.........#
#.........#
#.........#
#.........#
#.........d
#.........#
#.........#
#.........#
#.........#
#####.#####

3
0
#####.#####
#.........#
#s#.#.#.#.#
#.........#
#e#.#...#.#
#.e.......d
#e#.#.#.#.#
#.........#
#...#.#...#
#.........#
#####.#####
enemies 3
switch 0 : 0

4
2
###########
#.#.....#k#
#.........#
#...#.#.#.#
#.........#
....#.....#
#.........#
#.#.#.#.#.#
#.........#
#.#.......#
###########
key : 3

4
0
#####.#####
#.........#
#.........#
#.........#
#.........#
#?...@.....
#.........#
#.........#
#.........#
#.........#
#####.#####
sign Those who search shall find.

3
1
#####.#####
#.........#
#.........#
#.#..#..#.#
#.........#
d.........#
#.#..#..#.#
#.........#
#.........#
#.#.....#.#
#####.#####

2
0
#####d#####
#.........#
#......#..#
#.......#.#
#.........#
#.........l
#.........#
#.........#
#.........#
#.........#
#####.#####

2
1
#####.#####
#.........#
#.#.......#
#.........#
#.........#
l..#..#...#
#.........#
#.........#
#.#.....#.#
#.........#
#####.#####
locked : 2

8
0
#####.#####
#.........#
#.........#
#.........#
#.........#
#.........#
#.........#
#..#......#
#?....#...#
#e....e..e#
###########
enemies 3
sign The dungeon remembers all who enter.

6
1
#####.#####
#k........#
#.........#
#.........#
#.........#
..........d
#.........#
#.......#.#
#......#..#
#.........#
#####.#####
key : 6

7
1
#####.#####
#.........#
#.#.....#.#
#.........#
#.........#
d....#.....
#.........#
#.........#
#.#.....#.#
#.........#
###########

