2
1
#####D#####
#.........#
#.........#
#.........#
#.........#
#....#....d
#..###....#
#...#.....#
#...#.....#
#.........#
#####D#####

5
2
###########
#.........#
#.........#
#.........#
#.........#
D...##....#
#.####....#
###..#....#
#...#.....#
#.........#
#####d#####

4
1
#####D#####
#.........#
#.....#...#
#.........#
#.........#
D..#......#
#.........#
#.#.....#.#
#..#......#
#.........#
#####d#####

6
1
#####D#####
#e.......e#
#.........#
#.........#
#.........#
D.........D
#.........#
#.........#
#.........#
#e.......s#
#####D#####
enemies 3
switch 0 : 0

6
2
#####d#####
#.........#
#.........#
#.........#
#...####..#
D...####..#
#...###...#
#....#k.#.#
#.....#...#
#.........#
#####d#####
key : 3

1
3
###########
#.........#
#.........#
#.........#
#.........#
D...####..#
#...###...#
#...#######
#......#.##
#........X#
###########

1
1
###########
#.........#
#..#......#
#...##....#
#..###....#
#...#.....l
#...##....#
#.........#
#.........#
#.........#
#####D#####

7
2
#####d#####
#.........#
#.........#
#....#..#.#
#.........#
D.........#
#..#..#...#
#.........#
#.........#
#.#.......#
#####D#####

3
0
###########
#.........#
#.........#
#.........#
#.........#
#.........l
#.........#
#.........#
#.........#
#.........#
#####l#####
locked : 0

1
2
#####D#####
#.........#
#.........#
#.....#...#
#..##.....#
l...##....D
#..#e#....#
#.#.......#
#..##.#...#
#.........#
#####D#####
locked : 3
boss
enemies 1

2
2
#####D#####
#.........#
#.........#
#.....#...#
#...#.....#
d...#.....#
#.........#
#.........#
#.........#
#.........#
###########

6
0
#####D#####
#.........#
#.........#
#.........#
#.........#
#....###..D
#..#.#.#..#
##.#.#.#..#
#.........#
#k........#
###########
key : 1

4
0
#####l#####
#.........#
#.........#
#.........#
#.........#
#?...@....D
#..#......#
#.........#
#.........#
#.........#
#####D#####
sign This door will not yield without a key.

8
2
#####D#####
#.........#
#.........#
#...####..#
#....#.#..#
#...#..#..#
#..#...#..#
#..#...#..#
#e........#
#e?......e#
###########
enemies 3
door 0 : 0
sign Beware what lurks ahead.

0
2
###########
#k........#
#.........#
#..#..#...#
#.........#
#.........#
#..#..#...#
#.........#
#.........#
#..#......#
#####D#####
key : 4

5
0
#####D#####
#.........#
#.........#
#.........#
#.........#
#k........D
#.........#
#.........#
#.........#
#.........#
#####D#####
key : 0

5
1
#####d#####
#.........#
#.........#
#...#..#..#
#.........#
D.........D
#......#..#
#.........#
#.........#
#.........#
#####D#####

3
1
#####D#####
#.........#
#.........#
#.........#
#.........#
l.........#
#.........#
#.........#
#.........#
#.........#
#####D#####
locked : 1

7
1
#####D#####
#.........#
#.........#
#.........#
#.........#
#.........D
#.........#
#.......#.#
#......#..#
#.........#
###########

