3
1
#####D#####
#.........#
#.#.....#.#
#.........#
#.........#
D....#....d
#.........#
#.........#
#.#.......#
#.........#
#####D#####

2
0
###########
#?........#
#..#..#...#
#....###..#
#...#..#..#
#...@#....D
#..##.##..#
#.........#
#.........#
#........##
#####D#####
sign What you seek is close.

0
1
###########
#k........#
#...#...#.#
#.........#
#...#.#...#
#.........#
#.#.#.#...#
#.........#
#.#.#.#.#.#
#.........#
#####D#####
key : 3

5
2
#####D#####
#.........#
#.........#
##.....#..#
#.........#
d.........#
#...#..#..#
#.........#
#.........#
#......#..#
#####D#####

2
3
#####D#####
#......#..#
#......#..#
#....#....#
#.........#
#.........#
#.........#
#.........#
#s........#
#e.......e#
###########
enemies 2
switch 0 : 0 1

6
0
###########
#X.#......#
#p........#
#p.##.....#
#.........#
#.........D
#.........#
#.........#
#.........#
#.........#
###########

4
2
#####D#####
#.........#
#......#..#
#.......#.#
#.........#
l.........#
#.........#
#.......#.#
#......#..#
#.........#
#####D#####
locked : 2

7
1
#####D#####
#.........#
#..#..#..##
#.........#
#.........#
#...#..#..#
#.........#
#........?#
#..#..#..##
#e.e.....e#
###########
enemies 3
door 0 : 0 1
sign A locked path — look elsewhere first.

3
2
###########
#.........#
#.........#
#.........#
#.........#
d.........#
#.........#
#.#.......#
#..#......#
#.........#
#####D#####

5
1
#####d#####
#.........#
#.........#
#.........#
#.........#
#.........d
#.........#
#.#.....#.#
#..#...#..#
#.........#
#####l#####

4
1
#####D#####
#k........#
#......#..#
#.......#.#
#.........#
D.........l
#.........#
#.........#
#.........#
#.........#
#####d#####
key : 2

1
3
###########
####......#
#####.....#
###.#.....#
#.#.......#
D...#.....#
#.........#
#.........#
#.........#
#.........#
#####D#####

6
1
#####l#####
#..#......#
#.........#
#.#..#....#
#.###.###.#
D....e#...D
#.......#.#
#........##
#........##
#.........#
#####D#####
locked : 3
boss
enemies 1

2
1
#####D#####
#.........#
#.........#
#....#....#
#.........#
D........k#
#.........#
#.#..#....#
#..#......#
#.........#
#####D#####
key : 0

1
2
###########
#.........#
#.........#
#.........#
#......#..#
d...###...D
#...#.#...#
#...#..##.#
#...#..##.#
#.........#
###########

1
1
#####D#####
#.........#
#.........#
#.........#
#.........#
#.........d
#.........#
#.........#
#.........#
#.........#
#####D#####

3
0
#####D#####
#.........#
##.#......#
#....#....#
#.#.###.#.#
#..###....D
#.#.##....#
#....#....#
#.....##..#
#.........#
#####D#####

4
0
#####D#####
#.##......#
#.........#
###.#.....#
#.........#
#..#......D
#.........#
#.##......#
#......p..#
#.........#
###########

6
2
#####D#####
##.#...#..#
#.....#...#
#..#.###..#
#.........#
D..###....#
#......#..#
#.........#
#.........#
#........k#
###########
key : 4

