3
3
#####d#####
#.........#
#.........#
#.........#
#.........#
#.........#
#.........#
#.........#
#.........#
#.........#
###########

1
1
###########
#k........#
#..#......#
#.#.......#
#.........#
#..........
#.........#
#.........#
#.........#
#.........#
#####.#####
key : 2

5
2
###########
#.........#
#.........#
#.........#
#.........#
d....e#...#
#.....##..#
#.......#.#
#.........#
#.........#
#####.#####
boss
enemies 1

1
2
#####.#####
#s........#
#.........#
#.#.......#
#.........#
...........
#....#..#.#
#.........#
#.........#
#e#.....#e#
#####.#####
enemies 2
switch 0 : 0 1

0
2
###########
#e........#
#.....###.#
#......##.#
#..#..###.#
#..........
#e##......#
##.#......#
#.........#
#.........#
#####.#####
enemies 2

1
4
###########
#.........#
#.........#
#...#.#...#
#.........#
d....##...#
#.#.......#
#.##......#
#.........#
#.........#
###########

3
0
#####.#####
##........#
#.........#
#.........#
#.........#
#..........
#.........#
#.#..#..###
#..#...#..#
#.........#
#####.#####

1
3
#####l#####
#e........#
#.........#
#....#..#.#
#.........#
..........d
#.#.....#.#
#.........#
#.........#
#?......#e#
#####.#####
enemies 2
door 0 : 0 1
sign Seek the matching key before you proceed.

6
2
#####.#####
#.........#
#.........#
#.........#
#.........#
#.........#
#.........#
#.........#
#.........#
#X........#
###########

2
2
#####.#####
#.#.....#.#
#.........#
#...#...#.#
#.........#
d...#.#....
#.........#
#.#.#...#.#
#.........#
#.#.....#.#
###########

2
3
#####.#####
#.........#
#..#......#
#.#.......#
#.........#
.........k#
#.........#
#.........#
#.........#
#.........#
#####d#####
key : 3

2
1
#####.#####
#........k#
#..#..#..##
#.........#
#.........#
....#..#..d
#.........#
#.........#
#..#.....##
#.........#
#####.#####
key : 0

4
1
#####.#####
#.........#
#.........#
#.........#
#.........#
..........#
#.........#
#.........#
#.........#
#.........#
#####.#####

0
3
###########
#.........#
#......#..#
#.......#.#
#.........#
..........#
#.........#
#.#.......#
#..#......#
#.........#
#####l#####
locked : 3

5
0
#####l#####
#.........#
#.....#...#
#....#.##.#
#......#..#
#...####...
#....#.##.#
#......##.#
#...#.##..#
#......#.##
###########
locked : 0

2
0
###########
#?........#
#........##
#......#..#
#.........#
#....@.....
#.........#
#.........#
#.........#
#.........#
#####.#####
sign Those who search shall find.

4
0
#####.#####
#.........#
#.........#
#.........#
#.#.......#
#..##......
#..#..#...#
#...###...#
#.###.#...#
#.##......#
#####l#####

3
1
#####.#####
#.........#
#.........#
##........#
#.........#
.........k#
#.#..#....#
#.........#
#.........#
##.....#..#
#####.#####
key : 1

5
1
#####.#####
#.........#
#.........#
#.........#
#.........#
..........d
#.........#
#.#.......#
#..##.....#
#.........#
###########

