3
1
#####.#####
#.#.......#
#.##......#
#.#..#....#
#.##.#....#
#...#......
#.##......#
#.........#
###.......#
##........#
#####.#####

1
2
#####d#####
##e#...#s##
#.........#
#.#.#.#.#.#
#.........#
...#.#.#...
#.........#
#.#...#.#.#
#.........#
#..#...#?##
#####.#####
enemies 1
switch 0 : 0 1
sign Those who search shall find.

4
2
#####.#####
#........##
#.........#
#.#.#.#...#
#.........#
d....#.#..#
#.........#
#...#.#.#.#
#.........#
#..#......#
###########

1
5
###########
#........k#
#.........#
##.....#..#
#.........#
..........#
#.#..#..#.#
#.........#
#.........#
##.....#..#
###########
key : 3

1
4
#####.#####
#.........#
#..#...#..#
#.#.....#.#
#.........#
d..........
#.........#
#.#.......#
#..#......#
#.........#
#####l#####

2
2
#####.#####
#.........#
#......#..#
#.......#.#
#.........#
..........d
#.........#
#.#.......#
#..#......#
#.........#
#####.#####

2
0
###########
#.........#
#.........#
#.........#
#.........#
#....@.....
#.........#
#.........#
#.........#
#.........#
###########

1
3
###########
#..k......#
#..#......#
#.#.......#
#.........#
..........d
#.........#
#.........#
#.........#
#.........#
#####.#####
key : 1

3
2
#####.#####
#.......#e#
#.........#
#.#...#...#
#.........#
......#...#
#.........#
#...#.#.#?#
#.........#
#.......#e#
#####.#####
enemies 2
door 0 : 0 1
sign The dungeon remembers all who enter.

0
2
###########
#.........#
#.........#
#.........#
#.........#
..........#
#...#.....#
#.##......#
#..#......#
#.........#
#####d#####

2
1
#####.#####
#.........#
#.........#
#.........#
#.........#
...........
#.........#
#.........#
#.........#
#.........#
#####.#####

4
1
#####.#####
#..#...#..#
#.#.#..##.#
#?#..#..#.#
#e#.###.#.#
#.........d
#.........#
#.........#
#.........#
#.........#
#####.#####
enemies 1
sign A useful tool lies just ahead.

3
4
#####.#####
#.......#.#
#...#...#.#
#...##..#.#
#...##..#.#
#...#.##..#
#.........#
#.........#
#.........#
#X........#
###########

2
4
#####l#####
#.........#
#.........#
#.........#
#.........#
.....e....#
#.........#
#.........#
#.........#
#.........#
#####.#####
locked : 2
boss
enemies 1

2
3
#####.#####
#.........#
#.........#
#.........#
#.........#
d..........
#.........#
#.........#
#.........#
#.........#
###########

0
4
###########
#k#.....#.#
#.........#
#.........#
#.#..#..#.#
#.........#
#.........#
#.#..#....#
#.........#
#.........#
#####.#####
key : 4

0
1
###########
#.........#
#......#..#
#.......#.#
#.........#
#..........
#.........#
#.........#
#.........#
#.........#
#####.#####

1
1
#####.#####
#.........#
#.#.....#.#
#.........#
#.........#
#..........
#.........#
#.........#
#.#.....#.#
#.........#
#####.#####

5
1
#####.#####
#.........#
#.........#
#.........#
#.........#
#.........#
#.........#
#.........#
#........##
#........k#
###########
key : 2

