0
1
###########
#k........#
#.........#
#.........#
#.........#
#.........D
#.........#
#.........#
#.........#
#.........#
#####D#####
key : 4

2
2
#####D#####
#..#......#
#...#.#...#
##p.......#
#.###.....#
D...##....#
#.#.#.....#
##........#
#.........#
#.........#
#####D#####

1
2
#####D#####
#.........#
#.........#
#....##...#
#...e#....#
l....#.#..#
#.........#
#.........#
#.........#
#.........#
#####D#####
locked : 4
boss
enemies 1

3
1
#####d#####
##.#...#.##
#.........#
##...#.#.##
#.........#
#..#.#.#..D
#.........#
##.#.#.#.##
#.........#
##.#...#.##
#####D#####

0
2
###########
#........X#
#.........#
#.........#
#.........#
D....p....#
#.........#
#.........#
#.........#
#.........#
#####D#####

2
1
#####d#####
#.........#
#..#......#
#.#.......#
#.........#
#.........D
#.........#
#.....#...#
#.........#
#.........#
#####d#####

6
2
#####D#####
#.........#
#......#..#
#.......#.#
#.........#
D.........#
#.........#
#.#.......#
#..#......#
#.........#
#####D#####

4
1
#####D#####
#.........#
#.........#
##..#..#..#
#.........#
#.........d
#.......#.#
#.........#
#.........#
##.....#..#
#####D#####

3
2
#####D#####
#.........#
#..#...#..#
#.#.....#.#
#.........#
D.........#
#.........#
#.......#.#
#......#..#
#.......#.#
#####d#####

7
1
#####D#####
#.........#
#...#.....#
#.....#...#
#.........#
#.........D
#.....###.#
#......##.#
#.......#.#
#k........#
###########
key : 2

7
2
#####D#####
#.........#
##..#..#..#
#.........#
#.........#
D.........#
#.........#
#.........#
##.....#..#
#........e#
###########
enemies 1

4
2
#####d#####
#.........#
#.........#
#.........#
#..#......#
d.........D
#.........#
#.#.....#.#
#..#...#..#
#.........#
#####D#####

4
3
###########
#.........#
#..#......#
#.#.......#
#.........#
D.........#
#.........#
#.......#.#
#......#..#
#.........#
#####D#####

5
1
#####D#####
#k........#
#.#.#.#...#
#.........#
#.#.#.#.#.#
D.........l
#.#.#...#.#
#.........#
#.#.#...#.#
#.........#
#####D#####
key : 0

5
2
#####D#####
#.........#
#.........#
#.....#..##
#.........#
l.........l
#..#..#...#
#.........#
#.........#
#..#......#
#####D#####
locked : 0

6
1
#####D#####
#.........#
#.........#
#.........#
#.........#
#.........D
#.........#
#k#.....#.#
#..#...#..#
#.........#
#####D#####
key : 1

5
3
#####D#####
#.........#
##.#.....##
#.........#
#.........#
l.........#
#..#.#....#
#.........#
##.....#.##
#.........#
###########
locked : 1

5
0
###########
#.........#
#.........#
#.....#...#
#.##..###.#
#....@#...D
#.#.#.#.#.#
#..##...#.#
#..##.#...#
#.........#
###########

1
1
#####D#####
##.#.....##
#.........#
#.#.#.#.#.#
#.........#
#..#.#.#..l
#.........#
#.#.#...#.#
#.........#
##.#...#.##
#####d#####

