5
0
#####D#####
#.........#
#k#.......#
#.........#
#.........#
#.....#...D
#.........#
#.........#
#.#.....#.#
#.........#
#####D#####
key : 0

1
0
#####d#####
#.........#
#.........#
#...###...#
#...##e.#.#
#....###..D
#.....###.#
#....#.##.#
#......#e##
#........s#
#####D#####
enemies 2
switch 0 : 0 1

6
0
#####D#####
#......#..#
#..#......#
#..###.#..#
#..e##....#
#e..?###..D
#.........#
#....#....#
#.........#
#.........#
#####d#####
enemies 2
sign The brave are rewarded.

0
0
###########
#.......#.#
#.....#.#.#
#......#..#
#....#....#
#.........#
#.........#
#....#....#
#.........#
#.........#
#####d#####

2
1
#####D#####
#.........#
#..#......#
#.#.......#
#.........#
D........k#
#.........#
#.#.......#
#..#......#
#......#..#
#####D#####
key : 1

1
1
###########
#.......ee#
#........e#
#.........#
#.........#
D...#.....#
#..#......#
#.#.......#
#.........#
#.........#
#####D#####
enemies 3
door 0 : 0 1

2
0
#####D#####
#.........#
#.........#
#....##...#
#....#....#
#....###..D
#...#..#..#
#..#.#.##.#
#..#......#
#.........#
#####D#####

4
1
#####D#####
#.........#
#......#..#
#.......#.#
#.........#
d.........D
#.........#
#.#.......#
#..#......#
#.........#
#####D#####

4
2
#####D#####
#..#.....##
#.........#
#.........#
#......#..#
D.........l
#.........#
#..#.....##
#.........#
#.........#
#####D#####

5
1
#####D#####
#.........#
#.........#
#..#..#..##
#.........#
D.........D
#...#..#..#
#.........#
#.........#
#..#.....##
#####D#####

6
1
#####D#####
#.........#
##.......##
#.........#
#..#.#.#..#
D.........#
#..#...#..#
#.........#
##.#.....##
#........k#
###########
key : 5

7
0
#####d#####
#.........#
#.........#
#.........#
#.........#
#....e....#
#.........#
#.........#
#.........#
#.........#
#####D#####
boss
enemies 1

8
0
#####D#####
#.........#
#.........#
#..#......#
#.#.......#
#..#......#
#.........#
#.........#
#.........#
#X........#
###########

3
0
#####D#####
#..#......#
#.###.#...#
#.###.....#
#.#####...#
#...###...D
#...@.....#
#.........#
#.........#
#.........#
#####D#####

3
2
###########
#.........#
#...#..#..#
#.........#
#.........#
d....#....#
#.........#
#.........#
#...#..#..#
#.........#
#####D#####

4
0
#####D#####
#.........#
#.........#
#.........#
#.........#
#..##..#..d
#....#....#
#...##.#..#
#..##.....#
#.........#
#####D#####

5
2
#####D#####
#.........#
#.....#...#
#.........#
#.......#.#
D.........#
#.........#
#.........#
#.........#
#........k#
###########
key : 3

4
3
###########
#.........#
#.........#
#.........#
#.........#
l.........#
#.........#
#.........#
#.........#
#.........#
###########
locked : 3

3
1
#####D#####
#.........#
#......#..#
#.......#.#
#.........#
D.........d
#.........#
#.........#
#.........#
#.........#
#####D#####

