2
0
#####D#####
#.........#
#.........#
#.........#
#.........#
#.........D
#.........#
#.......#.#
#......#..#
#.........#
#####D#####

2
1
#####D#####
#.........#
#..#...#..#
#.#.....#.#
#.........#
D.........l
#......#..#
#.#.....#.#
#..#...#..#
##........#
#####D#####

1
4
###########
#X........#
#.........#
#.........#
#.........#
#...#.....#
#.###..#..#
#...#.#.#.#
##........#
####......#
#####D#####

3
0
#####D#####
#?........#
#.........#
#.........#
#.........#
#e........D
#.........#
#.........#
#.........#
#.........#
#####D#####
enemies 1
sign The brave are rewarded.

3
3
###########
#.........#
#...#.....#
#.........#
#....##...#
D.........D
#.........#
#.........#
#.........#
#.........#
#####d#####

3
4
#####d#####
#.........#
#..#......#
#.#.......#
#.........#
D.........#
#.......#.#
#.#.......#
#..#......#
#.........#
###########

1
1
###########
#.....k...#
#..#..#..##
#.........#
#.........#
D...#..#..D
#.........#
#.........#
#........##
#.........#
#####D#####
key : 2

4
0
#####D#####
#.........#
#......#..#
#.......#.#
#.........#
#.........l
#.........#
#.#.......#
#..#......#
#k........#
###########
key : 0

2
2
#####D#####
#.........#
#.........#
#.........#
#.........#
l.........#
#.........#
#.........#
#.........#
#.........#
#####D#####
locked : 0

4
1
#####D#####
#.........#
#..#......#
#.#.......#
#.........#
l.........D
#.........#
#.........#
##........#
#.........#
###########
locked : 2

0
0
###########
#.........#
#......#.##
#.......#.#
#.........#
#.........#
#.........#
#.......#.#
#.#....#..#
#.........#
#####D#####

2
4
#####D#####
#.........#
#.........#
#.........#
#.........#
#....e....#
#.........#
#.........#
#.........#
#.........#
#####d#####
boss
enemies 1

4
2
#####D#####
#e........#
#.........#
#.........#
#.........#
D.........D
#.....?#..#
#.....##..#
#.....##..#
#e........#
#####d#####
enemies 2
sign Seek the matching key before you proceed.

3
1
#####D#####
#.........#
#.........#
#.#..#..#.#
#.........#
D.........d
#.#.....#.#
#.........#
#.........#
#.......#k#
#####D#####
key : 1

4
3
#####d#####
#.#.....#.#
#.........#
#....#...##
#.........#
D.....#...#
#.........#
#..#......#
#.........#
#.........#
###########

3
2
#####D#####
#.........#
#.........#
#.......#.#
#.........#
d.........D
#..#......#
#.........#
#.........#
#.#.....#.#
#####D#####

1
2
###########
#........k#
#......#..#
#.......#.#
#.........#
D.........#
#.........#
#.......#.#
#......#..#
#.........#
#####D#####
key : 3

5
2
#####d#####
#.........#
#.........#
#.........#
#.........#
#.........#
#.........#
#.......#.#
#......#..#
#.........#
###########

1
0
#####D#####
#.........#
#.........#
#.........#
#.........#
#?...@....D
#.........#
#.........#
#.........#
#.........#
#####D#####
sign What you seek is close.

