1
0
###########
#k........#
##.#...#.##
#.........#
#..#...#..#
#..........
#..#.#.#..#
#.........#
#..#...#..#
#.........#
#####.#####
key : 0

0
2
###########
#.......#.#
#......#..#
#......##.#
#.........#
#..........
#.........#
#.#.....#.#
#......#..#
#.........#
#####.#####

2
1
#####.#####
#e........#
#.........#
#.........#
#....##...#
.....e#....
#.....##..#
#.....#?..#
#...#.#...#
#e........#
#####l#####
enemies 3
sign This door will not yield without a key.

1
1
###########
#.........#
#.........#
#......#..#
#.........#
...........
#.#..#....#
#.........#
#.........#
##........#
#####.#####

2
2
#####d#####
#..#......#
#.........#
#...#.....#
#..##.....#
...###....#
#.#.##....#
#...##....#
####......#
###.......#
#####.#####

1
2
#####.#####
#.........#
#......#..#
#.......#.#
#.........#
...........
#.........#
#.......#.#
#......#..#
#.........#
#####d#####

4
2
#####.#####
#.........#
#.........#
#.........#
#...##.#..#
l..##.##..#
#..##..#..#
#..###.#..#
#..##.....#
#.........#
#####.#####
locked : 1

3
2
#####.#####
#k#.....#.#
#.........#
#.#.#...#.#
#.........#
....#.#...d
#.........#
#.#.#.#.#.#
#.........#
#.#.....#.#
#####.#####
key : 2

5
1
#####.#####
#.........#
#...#.#.#.#
#.........#
#....#.#..#
#.........d
#.#.#.#.#.#
#.........#
#..#...#.##
#.........#
#####.#####

7
1
#####l#####
#.........#
#.........#
#.##.#....#
#.#.......#
#....e#...#
#.#.###...#
#..##.....#
#.........#
#.#.......#
#####.#####
locked : 2
boss
enemies 1

2
0
#####.#####
#.........#
#.........#
#.........#
#.....#...#
#....@.....
#.........#
#.#.#.....#
#.#.#...#.#
#.........#
###########

3
1
#####l#####
#.........#
#.........#
##.....#..#
#.........#
#..........
#...#..#..#
#.........#
#.........#
##........#
#####.#####
locked : 0

3
3
###########
#.........#
#.........#
#.........#
#.#####...#
d....#....#
#.###.#...#
#..##.....#
#...#.....#
#.........#
###########

4
1
#####.#####
#.........#
#.........#
#.........#
#.........#
#k........l
#.........#
#.........#
#.........#
#.........#
#####.#####
key : 1

8
1
#####.#####
#.........#
#.........#
#.........#
#.........#
#.........#
#.........#
#.........#
#.........#
#X........#
###########

5
2
#####.#####
#.........#
#..#...#..#
#.#.....#.#
#.........#
d.........#
#.........#
#.......#.#
#......#..#
#.........#
###########

1
3
#####d#####
#.........#
#.........#
#.........#
#.........#
..........#
#.........#
#.#.....#.#
#..#...#..#
#........k#
###########
key : 4

6
1
#####.#####
#.........#
#.........#
#...#.#...#
#...e#?#..#
#...#.....#
#.....#...#
#....##.#.#
#.........#
#.........#
#####l#####
enemies 1
sign Only the prepared may pass.

0
3
###########
#.........#
#.........#
#.........#
#.........#
..........#
#.........#
#.........#
#.........#
#.........#
#####d#####

