5
2
#####D#####
#.........#
#.....#..##
#.........#
#.........#
d.........#
#.........#
#.........#
#..#..#..##
#.........#
###########

5
0
#####D#####
#.........#
#.........#
#.........#
#.........#
#.........D
#.........#
#.#.......#
#..#......#
#.........#
#####l#####

2
4
###########
#.........#
#.........#
#.#.#.#.#.#
#.........#
d...#.#...#
#.........#
#.#.#...#.#
#.........#
#.#.......#
###########

4
0
#####D#####
#.........#
#..#......#
#.........#
#.........#
#k........D
#.........#
#.....#...#
#.........#
#.........#
#####D#####
key : 0

2
3
#####d#####
#k........#
##.....#.##
#.........#
#.#.#.#.#.#
D.........d
#..#.#....#
#.........#
#.#.#.#...#
#.........#
#####D#####
key : 3

6
0
#####l#####
#.........#
#.........#
#.........#
#.........#
#.........D
#.........#
#.........#
#.........#
#.........#
###########
locked : 1

4
2
#####D#####
#........##
#.........#
#.........#
#...#..#..#
l.........d
#.........#
#.....#..##
#.........#
#.........#
#####D#####
locked : 2

6
1
#####D#####
#.........#
####......#
##..##....#
#..#.#....#
D..#......#
#..##.....#
#.........#
#.........#
#.......ee#
###########
enemies 2
door 0 : 0

3
2
#####l#####
#.........#
#..p......#
#####.....#
#..k#.....#
D..##.....D
#.......p.#
#..#......#
#.........#
#.........#
#####D#####
key : 2

3
0
#####D#####
#.........#
#.........#
#.........#
#.........#
#?...@....D
#.........#
#.........#
#.........#
#.........#
#####D#####
sign Something glints behind that door…

3
1
###########
#...k.....#
#.#.#.#.#.#
#.........#
#..#.#....#
D.........D
#.#...#.#.#
#.........#
#..#...#.##
#.........#
#####D#####
key : 1

4
1
#####D#####
#.........#
#......#..#
#.......#.#
#.........#
D.........l
#.........#
#.#.....#.#
#..#...#..#
#.........#
#####D#####

2
0
###########
#e.......s#
#.#.....#.#
#.........#
#.........#
#.........#
#.........#
#.........#
#.#.......#
#.........#
#####D#####
enemies 1
switch 0 : 0

2
2
###########
#.........#
#.........#
#..#......#
#.##......#
#..#......D
#.........#
#p........#
#.........#
#......p..#
#####l#####
locked : 0

3
3
#####D#####
#.........#
#.#.#.#.#.#
#.........#
#..#.#.#..#
D.........#
#.#...#.#.#
#.........#
#......#..#
#.........#
#####D#####

1
3
#####D#####
#.........#
#.........#
#.........#
#.........#
#....e....#
#.........#
#.........#
#.........#
#.........#
#####d#####
boss
enemies 1

4
3
#####D#####
#.........#
#.........#
#.........#
#.........#
d.........#
#.........#
#.........#
#.........#
#.........#
###########

5
1
#####D#####
#.#.....#.#
#.........#
#..#.#.#.##
#.........#
D.....#...d
#.........#
#....#.#.##
#.........#
#.#.....#.#
#####D#####

0
3
###########
#X........#
#.........#
#.........#
#.........#
#.........#
#.........#
#.........#
#.........#
#.........#
#####D#####

