2
3
#####d#####
#.........#
#........##
#.........#
#.........#
...........
#.........#
#.........#
#......#..#
#.........#
#####.#####

4
0
#####.#####
#.........#
#..#......#
#.#.......#
#.........#
#.........d
#.........#
#.......#.#
#......#..#
#k#.......#
#####.#####
key : 1

2
1
#####.#####
#..#...#.##
#.........#
##.#.#....#
#.........#
...#...#...
#.........#
##.#...#.##
#e........#
##.#......#
#####.#####
enemies 1

0
1
###########
#.........#
#.........#
#.....#..##
#.........#
#.........#
#...#.....#
#.........#
#.........#
#..#.....##
#####d#####

3
3
#####.#####
#.........#
#..#......#
#.#.......#
#.........#
d.........#
#...#.....#
#.......#.#
#......#..#
#........##
#####.#####

2
0
###########
#?........#
#......##.#
#.....#...#
#.....###.#
#....@#....
#.....###.#
#......##.#
#.......#.#
#.........#
#####.#####
sign What you seek is close.

1
4
###########
#.........#
#.....###.#
#.#..#.#..#
#.#.#..##.#
l..##e##..#
#...#..##.#
#.........#
#.........#
#.........#
#####.#####
locked : 1
boss
enemies 1

3
2
#####.#####
#.........#
##.#...#.##
#.........#
#.#.#...#.#
..........d
#....#.#..#
#.........#
#.#.#.#.#.#
#.........#
###########

4
3
#####.#####
#.........#
#.........#
#.........#
#.........#
#.........#
#.........#
#.........#
#.........#
#k........#
###########
key : 4

3
0
#####.#####
#.........#
#.........#
#....#..#.#
#.........#
#.........l
#..#..#...#
#.........#
#.........#
#.......#k#
#####.#####
key : 0

1
3
###########
#.........#
#.....#...#
#.........#
#.........#
..........l
#.........#
#.........#
#.........#
#........##
#####d#####

2
2
#####.#####
#.........#
#......#..#
#.......#.#
#.........#
...........
#.........#
#.........#
#.........#
#.........#
#####.#####

5
0
#####.#####
#.........#
#e##......#
##?###....#
#....#....#
#..##......
#.........#
#.........#
#s........#
#e........#
###########
enemies 2
switch 0 : 0
sign What you seek is close.

4
1
#####.#####
#.........#
#.#.....#.#
#.........#
#.........#
d....#....#
#.........#
#.........#
#.#.....#.#
#.........#
#####.#####

3
1
#####.#####
#.........#
#.........#
#.........#
#.........#
l..........
#.........#
#.........#
#.........#
#.........#
#####.#####
locked : 0

1
1
#####d#####
#.........#
#.........#
#.........#
#.........#
#..........
#.........#
#.#.......#
#..#......#
#.........#
#####.#####

2
4
#####.#####
###.......#
#..#......#
#...#.....#
#..##.....#
..........#
#.........#
#.........#
#.........#
#........X#
###########

5
1
#####.#####
#.........#
#..#......#
#.#.......#
#.........#
..........#
#.........#
#.#.......#
#..#......#
#........k#
###########
key : 2

1
2
###########
#.........#
#e#.......#
######....#
#.#.......#
.....#e#...
#.....#...#
#......#..#
#.........#
#.........#
#####.#####
enemies 2
door 0 : 0

