3
4
###########
#.........#
#.........#
#.........#
#.........#
l....e....#
#.........#
#.........#
#.........#
#.........#
#####D#####
locked : 3
boss
enemies 1

4
4
#####D#####
#.........#
#.#......##
#.........#
#.........#
D.....##..#
#.......#.#
#.....##.##
#.....#..##
#........X#
###########

1
3
###########
#.........#
#.........#
#.........#
#.........#
l.........#
#.........#
#.......#.#
#......#..#
#.........#
#####D#####
locked : 2

2
3
#####D#####
#e........#
#.........#
#.........#
#.........#
D........e#
#.........#
#...#.....#
#.........#
#.......#e#
#####D#####
enemies 3

2
1
#####D#####
#k........#
#.........#
#.........#
#.........#
D.........D
#.........#
#.#.....#.#
#..#...#..#
#..#......#
#####d#####
key : 1

1
2
#####D#####
#.......#.#
#.........#
#.........#
#.....#...#
d.........l
#.........#
#.#..#....#
#.........#
#.........#
#####D#####

2
2
#####D#####
#.........#
#.........#
#.........#
#.........#
D.........D
#.........#
#.........#
#.........#
#.........#
#####d#####

0
1
###########
#.........#
#..#......#
#.#.......#
#.........#
#.........D
#.........#
#.........#
#.........#
#.........#
#####l#####
locked : 0

3
3
#####D#####
#.........#
#.........#
#.##..#...#
#..#e#....#
D..###....l
#..##?#...#
#..##.#...#
#.........#
#.........#
#####D#####
enemies 1
sign Only the prepared may pass.

3
0
#####D#####
#.........#
#......#..#
#.......#.#
#.........#
#k........D
#.........#
#.........#
#.........#
#.........#
#####D#####
key : 2

4
2
#####D#####
#.........#
#.........#
#.........#
#.........#
#.........D
#.........#
#.........#
#.........#
#.........#
###########

2
0
#####D#####
#..#......#
#.........#
#.........#
#.........#
#..##.....D
#..k##....#
#..#.#....#
##.#......#
###....#..#
#####D#####
key : 0

3
1
#####d#####
#.........#
#...#.....#
#...#.....#
#.........#
D..#......D
#.........#
#.........#
#.........#
#.........#
###########

1
0
###########
#.........#
#.........#
#.........#
#.........#
#....@....D
#.........#
#..##.....#
#..#......#
#.........#
#####D#####

4
0
#####D#####
#.........#
#.........#
#.........#
#.........#
#.........#
#.##......#
#..#......#
##.#......#
#.........#
###########

3
2
#####d#####
#.........#
#.#.....#.#
#.........#
#.........#
D.........D
#.........#
#.........#
#.#.....#.#
#.........#
#####D#####

1
1
#####l#####
#.........#
#.........#
#.........#
#.........#
D.........d
#.........#
#.#.......#
#..#......#
#.........#
#####D#####

4
3
#####D#####
#e........#
#.........#
#.........#
#.........#
D.........D
#.........#
#.........#
#.........#
#e...e....#
###########
enemies 3

0
2
###########
#.......k##
###...###.#
##.##.....#
#...#..#..#
D.........#
#.#.#.....#
#.........#
#.........#
#.........#
#####D#####
key : 3

