4
2
#####.#####
#.........#
#.........#
#.........#
#.........#
..........l
#.........#
#.........#
#.........#
#....k....#
###########
key : 1

2
2
#####d#####
#.........#
#..#...#..#
#.#.....#.#
#....#....#
#.........l
#.........#
#.#.......#
#..#......#
#.........#
#####.#####

3
4
#####.#####
#.........#
#.........#
#....#..#.#
#.........#
..........#
#.#..#....#
#.........#
#.........#
#.#.....#.#
#####d#####

2
4
###########
#.........#
##..#..#..#
#.........#
#.........#
d...#.....#
#.........#
#.........#
##..#..#..#
#.........#
#####.#####

1
3
#####.#####
#.........#
#.........#
#.........#
#.........#
.....e....#
#.........#
#.........#
#.........#
#.........#
#####l#####
locked : 0
boss
enemies 1

5
1
#####.#####
#.........#
#.........#
#.........#
#.........#
..........#
#.........#
#.........#
#.........#
#.........#
###########

4
4
#####d#####
#.........#
#.........#
#.........#
#.........#
..........#
#.........#
#.........#
#.........#
#.........#
###########

3
0
###########
#..#......#
#.#.#.#...#
#.#.##....#
#.#.......#
#.....#....
#.........#
#.........#
#.........#
#.........#
#####.#####

4
1
#####.#####
#k........#
#.#.#.#...#
#.........#
#...#.#.#.#
...........
#.....#.#.#
#.........#
#.#.#...#.#
#.........#
#####.#####
key : 0

5
0
#####d#####
#.........#
##.....#.##
#.........#
#....#.#..#
#..........
#.........#
#.........#
##.#......#
#.........#
#####.#####

3
1
###########
#.......#.#
#.....#...#
#......##.#
#....####.#
......##...
#.........#
#.........#
#.........#
#.........#
#####.#####

4
3
#####.#####
#.#.....#.#
#.........#
#...#.#.#.#
#.........#
l..........
#.........#
#.....#.#.#
#.........#
#.......#.#
###########
locked : 1

2
3
#####l#####
#.........#
#..#...#..#
#.#....##.#
#.........#
l.........d
#.........#
#.........#
#.........#
#.........#
#####.#####
locked : 2

1
2
###########
#.........#
#.........#
#.........#
#.........#
#..........
#.........#
#.........#
#.........#
#.........#
#####d#####

4
0
#####.#####
#.........#
#.........#
#.....#.#.#
#...@##...#
#....##....
#......#..#
#.........#
#.........#
#.........#
#####d#####

3
2
#####.#####
#k.#......#
#..##.....#
#..###....#
#....#.#..#
...........
#.........#
#.........#
#.........#
#.........#
#####.#####
key : 2

6
0
#####.#####
#.........#
#.........#
#.........#
#.........#
#.........#
#.........#
#.#.....#.#
#..#...#..#
#.........#
###########

3
3
#####.#####
#k........#
#.........#
#.........#
#.........#
...........
#.........#
#.#.....#.#
#..#...#..#
#.........#
#####.#####
key : 3

0
3
###########
#X........#
#.........#
#....##...#
#...#.#...#
#...#.....#
#.........#
#.........#
#.........#
#.........#
#####.#####

