5
2
#####D#####
#.........#
#..##.##.##
#....####k#
#..#.#....#
D....#....#
#....##...#
#.........#
#.........#
#.........#
#####D#####
key : 1

3
3
###########
#.....e#.e#
#.....##..#
#.......#.#
#.....###.#
D....###..#
#.....#.#.#
#.......#.#
#.........#
#........e#
###########
enemies 3
door 0 : 0 1

3
1
#####d#####
#.........#
#.........#
#.........#
#.........#
l.........D
#.........#
#.#.....#.#
#..#...#..#
#.........#
#####D#####
locked : 0

1
0
#####D#####
#......#..#
#......##.#
#....##...#
#...####..#
#...#e#...#
#...#.###.#
#...#..#..#
#.........#
#.........#
#####d#####
boss
enemies 1

4
2
#####D#####
#.........#
#.........#
#.........#
#.........#
D........k#
#.........#
#.........#
#.........#
#.........#
#####D#####
key : 3

2
1
###########
#.........#
#......#..#
#.......#.#
#.........#
D.........D
#.........#
#.#.......#
#.##......#
#.........#
#####d#####

5
0
#####D#####
#..#......#
#.....#...#
#..##.#...#
#?####....#
#...##....D
#...@.....#
#.........#
#.........#
#.........#
#####d#####
sign A useful tool lies just ahead.

2
0
#####d#####
#.........#
#.........#
#.........#
#.........#
#.........D
#.........#
#.........#
#.........#
#.........#
#####d#####

5
1
#####D#####
#.........#
#..#...#..#
#.#.....#.#
#.........#
D.........D
#.........#
#.........#
#.........#
#.........#
#####D#####

6
1
#####D#####
##.....#..#
#.........#
#.........#
#.#..#..#.#
D.........D
#.........#
#...#..#..#
#.........#
#.........#
#####D#####

0
0
###########
#X........#
#.........#
#....#.#..#
#..#...#..#
#..#.#....#
#.....#...#
#...#..#..#
#.........#
#.........#
#####D#####

2
2
###########
#......#.e#
#..#...#..#
#.....#e..#
#..#.###..#
D...#.....#
#...#.....#
#.........#
#.........#
#.........#
#####D#####
enemies 2

6
0
#####d#####
#.........#
#...#.....#
#.........#
#.........#
#.........D
#.........#
#.......#.#
#......#..#
#.........#
###########

6
2
#####D#####
#.........#
#..##.....#
#..#.#....#
#.........#
D..##.#...#
#....##...#
#....##...#
#.###.....#
#.#......k#
###########
key : 2

4
0
#####l#####
#..#......#
#.........#
#.........#
#.....#...#
#k........D
#.........#
#..#..#...#
#.........#
#.........#
#####D#####
key : 0

4
1
#####D#####
#.........#
#.........#
#..#..#..##
#.........#
D.........D
#..#..#...#
#.........#
#.........#
#..#.....##
#####D#####

3
0
#####d#####
#.........#
#......#..#
#.......#.#
#.........#
#.........l
#.........#
#.#.....#.#
#..#...#..#
#.........#
#####l#####
locked : 1

7
1
#####D#####
#.........#
#.........#
#.........#
#.#..#....#
#.........#
#.........#
#...#..#..#
#.........#
#.........#
###########

3
2
#####D#####
#e#.....#e#
#.........#
#.#...#...#
#.........#
D...#.#...D
#.........#
#...#.#.#.#
#.........#
#s......#e#
#####D#####
enemies 3
switch 0 : 0 1

