3
2
#####d#####
#k........#
#.........#
#.........#
#.........#
D.........D
#.........#
#.#.......#
#..#......#
#.........#
#####l#####
key : 4

3
4
###########
#.........#
#.........#
#.........#
#..#......#
d..#.#....#
#..#......#
###..#....#
##........#
#.........#
###########

3
0
#####D#####
#........e#
#.....#..##
#.........#
#.........#
#?.#......D
#.........#
#.........#
#.....#..##
#........e#
#####D#####
enemies 2
sign A useful tool lies just ahead.

5
0
#####D#####
#......##.#
#.....##..#
#...#..##.#
#...#.....#
#...#..#..D
#.........#
#.........#
#.........#
#.........#
#####D#####

4
1
#####D#####
#.#.....#.#
#.........#
#.#.#...#.#
#.........#
D.....#...D
#.........#
#.#.#.#.#.#
#.........#
#.#.....#.#
#####l#####
locked : 1

1
2
#####D#####
#.........#
#...#.....#
#.....#p..#
#..##.....#
#....e....D
#.###.....#
#.........#
#.........#
#.........#
#####d#####
boss
enemies 1

3
3
###########
#.........#
#..#..#..##
#.........#
#.........#
D...#.....d
#.........#
#.........#
#..#..#..##
#.........#
###########

5
2
#####D#####
#.........#
#.........#
#.#..#..#.#
#.........#
d.........#
#..#..#...#
#.........#
#.........#
#.......#.#
###########

4
0
#####D#####
#.........#
#.........#
#.........#
#.........#
#...#@....D
#?###.....#
#...#.....#
#...#.....#
#.#.......#
#####D#####
sign A locked path — look elsewhere first.

3
1
#####D#####
#k........#
#.........#
#.#..#....#
#.........#
D.........D
#.#.....#.#
#.........#
#.........#
#.........#
#####D#####
key : 2

2
2
#####d#####
#.........#
#......#..#
#.......#.#
#.........#
D.........#
#.........#
#.#.......#
#..#......#
#.........#
#####d#####

6
1
#####D#####
#.........#
#..#...#..#
#..#......#
#....#....#
D......#..#
#..##.##..#
#.........#
#.........#
#.........#
###########

0
2
###########
#X........#
#.........#
#.........#
#.........#
#.........#
#.........#
#.........#
#.........#
#.........#
#####D#####

4
2
#####l#####
#.........#
#.........#
#.........#
#.........#
D.........#
#.........#
#.........#
#.........#
#.#.......#
#####D#####
locked : 0

2
0
###########
#k........#
#.........#
#.........#
#.........#
#.........D
#.........#
#.........#
#.........#
#.........#
#####D#####
key : 1

6
0
#####D#####
#.........#
#.........#
#.........#
#.........#
#.........D
#.........#
#.........#
#.........#
#.........#
###########

5
1
#####l#####
#.........#
#.........#
#.........#
#.........#
D.........d
#.........#
#.#.......#
#..#.....##
#........k#
#####D#####
key : 0

1
3
###########
#.......ee#
#.........#
#.........#
#.........#
D.........#
#...#.....#
#..#......#
#.##......#
#.......?e#
###########
enemies 3
sign Beware what lurks ahead.

2
1
###########
##.....#..#
#.........#
#.........#
#.#.......#
D.........D
#.........#
##..#..#..#
#.........#
#.........#
#####D#####

