3
4
#####.#####
#.........#
#.........#
#.........#
#.........#
..........#
#.........#
#.........#
#.........#
#........X#
###########

4
2
#####l#####
#.........#
#.........#
#..#..#..##
#.........#
...........
#...#.....#
#.........#
#.........#
#........##
#####.#####

3
1
#####.#####
#.......#.#
#.##......#
#..#......#
#..#......#
...........
#.........#
#.........#
#.........#
#.........#
#####d#####

3
3
#####.#####
#.........#
#.........#
#.........#
#...##.##.#
......##...
#...####..#
#....####.#
#.........#
#.........#
#####.#####

2
2
#####.#####
#k........#
#......#..#
#.......#.#
#.........#
..........l
#.........#
#.........#
#.........#
#.........#
#####.#####
key : 2

0
2
###########
#e.......?#
#.........#
#.........#
#.........#
#.........#
#.#.......#
#.........#
#.........#
#.........#
#####.#####
enemies 1
door 0 : 0
sign A useful tool lies just ahead.

3
2
#####.#####
#.........#
#..#......#
#.#.......#
#.........#
...........
#.........#
#.......#.#
#......#..#
#.........#
#####l#####
locked : 1

5
0
#####.#####
#.......#.#
#.........#
#.........#
#.........#
#....@#...#
#.........#
#.........#
#.........#
#.........#
###########

5
2
#####.#####
#.........#
#..#...#..#
#.#.......#
#.........#
#.........#
#.........#
#.......#.#
#......#..#
#......#..#
###########

4
0
#####l#####
#.........#
#.........#
#.....#...#
#..#.#.#..#
#..##......
#.........#
#.........#
#.........#
#.........#
#####.#####

2
1
#####d#####
#.........#
#.........#
#.........#
#.........#
d..........
#.........#
#.#.......#
#..#......#
#.........#
#####.#####

1
2
#####.#####
#.........#
#.........#
#..#..#..##
#........k#
..........#
#..#..#...#
#.........#
#.........#
#..#.....##
#####.#####
key : 3

2
4
###########
#.##......#
#.#.......#
#.#.......#
#.........#
d..#.e....#
#.........#
#.........#
#.........#
#.........#
#####.#####
boss
enemies 1

4
1
#####d#####
#.........#
#...#..#..#
#.........#
#.........#
.....#.....
#.........#
#.........#
##..#..#..#
#k........#
###########
key : 0

1
1
###########
#.........#
#.#....#..#
#.......#.#
#.........#
#..........
#.........#
#.#.......#
#..#......#
#.........#
#####d#####

4
3
#####.#####
#.........#
#.........#
#......#..#
#....#.#..#
......##..#
#....##...#
#....####.#
#.....#..##
#........k#
###########
key : 1

2
3
###########
#.........#
#.........#
#.........#
#.........#
l.........d
#.........#
#.........#
#.........#
#.........#
#####.#####
locked : 3

2
0
###########
#e#e......#
#e........#
#s....#.#.#
#.........#
#.....#...d
#.........#
#.#.#.#.#.#
#.........#
#?#.....#.#
#####.#####
enemies 3
switch 0 : 0
sign Turn back; you are not yet ready.

3
0
#####.#####
#.........#
#.........#
#.###.#...#
#..##.....#
#.....#....
#.##......#
#..#.#....#
#.........#
#.........#
#####l#####
locked : 0

