3
0
#####d#####
#.........#
#......#..#
#.#.....#.#
#.........#
#...#......
#.........#
#.#.......#
#..#......#
#......#..#
#####.#####

5
0
#####.#####
#.........#
##..#.....#
#..######.#
#...###...#
#..........
#.........#
#.........#
#.........#
#.........#
###########

2
0
#####.#####
#.........#
#......#..#
#.......#.#
#.........#
#..........
#.........#
#.#.....#.#
#..#...#..#
#.........#
#####d#####

1
0
#####l#####
#.........#
#e##......#
######....#
#e##.#....#
#.e#.#.#...
#?##......#
#.........#
#.........#
#.........#
#####.#####
enemies 3
door 0 : 0 1
sign A locked path — look elsewhere first.

6
1
#####.#####
#.........#
#.........#
#.........#
#.........#
#.........#
#.........#
#.........#
#.........#
#k........#
###########
key : 0

3
2
#####.#####
#........k#
#.....#..##
#.........#
#.........#
......#...#
#.........#
#.........#
#.....#..##
#.........#
#####.#####
key : 5

2
2
#####.#####
#.........#
#.........#
#.........#
#.........#
...#.....X#
#.........#
#.........#
#.........#
#.........#
#####.#####

0
0
###########
#.........#
#...#..#..#
#.........#
#.........#
#....#....#
#.........#
#.........#
##..#.....#
#.........#
#####l#####
locked : 0

4
1
#####.#####
#.........#
#.........#
#.........#
#.........#
...........
#.........#
#.........#
#.........#
#.........#
#####d#####

1
2
###########
#.........#
#.........#
#.........#
#.........#
l....e....#
#.........#
#.........#
#.........#
#.........#
#####.#####
locked : 1
boss
enemies 1

4
0
#####.#####
#.........#
#.........#
#.........#
#.........#
#?...@.....
#.........#
#.........#
#.........#
#.........#
#####.#####
sign The dungeon remembers all who enter.

5
1
#####d#####
#e.......s#
#.........#
#.........#
#.........#
..........d
#...e#....#
######....#
#.........#
#e........#
#####.#####
enemies 3
switch 0 : 0 1

2
1
#####.#####
#.........#
#.........#
##..#.#...#
#..#......#
....#......
#..#....#.#
###...###.#
#.....#.#.#
#.........#
#####.#####

5
2
#####.#####
#.........#
#.........#
#....#..#.#
#.........#
d.........d
#....#..#.#
#.........#
#.........#
#.#.....#.#
###########

4
2
#####.#####
#k........#
#.........#
#.........#
#.........#
...........
#.......#.#
##........#
#.........#
#.........#
#####.#####
key : 1

5
3
#####.#####
#.........#
#..#......#
#.#.......#
#.........#
d.........#
#.........#
#.........#
#.....#...#
#.........#
###########

3
1
#####.#####
#k........#
#.........#
#.........#
#.........#
...........
#.........#
#.........#
#.........#
#.........#
#####.#####
key : 2

4
3
###########
#.........#
#.....#.#e#
#....#..e##
#....####.#
.....##...#
#.....#.#.#
#.........#
#.........#
#.........#
#####.#####
enemies 2

1
1
###########
#.........#
#.........#
##........#
#.........#
..........l
#.........#
#.#.......#
#..##.....#
#.........#
#####.#####

