4
2
#####l#####
#.........#
#.........#
#.........#
#.........#
..........#
#.........#
#.......#.#
#......#..#
#.........#
#####l#####

3
0
#####.#####
#.........#
#.........#
#.........#
#.........#
#..........
#.........#
#.........#
#.........#
#.........#
#####.#####

1
1
#####.#####
#.........#
####...#..#
#.##...####
#.#.....#X#
.....#.#..#
#.........#
#.........#
#.........#
#.........#
#####.#####

0
1
###########
#.........#
#.........#
#.........#
#.........#
l....e....#
#.........#
#.........#
#.........#
#.........#
#####.#####
locked : 3
boss
enemies 1

3
2
###########
#.#.....#.#
#......#..#
#.......#.#
#.........#
..........#
#.........#
#.#.......#
#..#......#
#.........#
#####l#####
locked : 0

5
3
###########
#......##.#
#...#k#...#
#...##....#
#...#.#.#.#
....#..#...
#.........#
#.........#
#.........#
#.........#
#####.#####
key : 2

6
3
#####.#####
#......##.#
#.....#...#
#....#..###
#....#.##e#
.....#....#
#.........#
#.........#
#........?#
#.......ee#
###########
enemies 3
door 0 : 0
sign Something glints behind that door…

4
0
#####.#####
#.........#
#.........#
#.........#
#.........#
#....@.....
#.........#
#.........#
#.........#
#?........#
###########
sign The dungeon remembers all who enter.

5
4
###########
#........k#
#..#...#..#
#.#..#....#
#.........#
.......#..#
#.........#
#.........#
#.........#
#.........#
###########
key : 3

5
2
#####l#####
#.........#
#.........#
#.........#
#.........#
...........
#.........#
#.......#.#
#......#..#
#.........#
#####.#####
locked : 1

6
2
#####.#####
#s........#
#.........#
#.........#
#.........#
#e.........
#.........#
#.........#
#.........#
#.........#
#####.#####
enemies 1
switch 0 : 0

5
1
#####.#####
#.........#
#.#.#.#...#
#.........#
#..#.#.#..#
#..........
#...#...#.#
#.........#
#..#...#.##
#k........#
###########
key : 0

3
1
#####.#####
#.........#
#.........#
#.#.......#
#.........#
...........
#.....#...#
#.........#
#.........#
#k#.....#.#
#####.#####
key : 1

2
0
#####d#####
#......#..#
#......#..#
#.........#
#.........#
#.........d
#....#....#
#.........#
#.........#
#.........#
#####.#####

7
2
#####.#####
#.......#.#
#.........#
#.........#
#..#......#
#.........#
#.........#
#....#..#.#
#.........#
#.........#
###########

2
1
#####.#####
#.........#
#.#.....#.#
#.........#
#.........#
d.....#...#
#.........#
#.........#
#.#.......#
#.........#
#####.#####

0
0
###########
#.........#
#..#......#
#.#.......#
#.........#
#.........l
#.........#
#.......#.#
#......#..#
#.........#
#####l#####
locked : 2

4
1
#####.#####
#?........#
#......#..#
#.........#
#...#..##.#
...##......
#...e##.#.#
#..####e#.#
#...#.##..#
#.........#
#####.#####
enemies 2
sign Those who search shall find.

1
0
#####l#####
#.........#
#..#......#
#.#.......#
#.........#
#..........
#.........#
#.........#
#.........#
#.........#
#####d#####

