1
3
#####D#####
#.........#
#.........#
#.........#
#.........#
#....e....#
#.........#
#.........#
#.........#
#.........#
#####l#####
locked : 2
boss
enemies 1

3
4
#####d#####
#.........#
#..#..#..##
#.........#
#.........#
D...#.....#
#.........#
#.........#
#..#..#...#
#........e#
###########
enemies 1

2
2
###########
#.........#
#.........#
#...#.....#
#.........#
D.........D
#.........#
#.........#
#.........#
#.........#
#####l#####
locked : 1

1
1
###########
#.........#
#.........#
#.........#
#.##......#
D....#....#
#..#.#.#..#
#.######..#
#..##.#...#
#.........#
#####D#####

4
2
#####D#####
#.........#
#.........#
#.........#
#.........#
D.........D
#.........#
#.........#
#.........#
#....k....#
###########
key : 1

2
0
#####D#####
#.#.......#
#.........#
#.#.#.#.#.#
#.........#
#...#.#...d
#.........#
#.#...#...#
#.........#
#.#.....#.#
#####D#####

3
1
#####D#####
#.........#
#.........#
#.........#
#.........#
D.........D
#.........#
#.........#
#.........#
#.........#
#####D#####

4
1
#####D#####
#.......#.#
#.#.....#.#
#.........#
#.........#
D.........D
#.........#
#.#.....#.#
#..#...#..#
#.........#
###########

2
4
###########
#.........#
#...#....##
#.........#
#...#.....#
D.........#
#.........#
#.......#.#
#......#..#
#.........#
#####d#####

5
0
#####D#####
#.........#
#..##.....#
#.#.......#
#.........#
#.........#
#.........#
#.........#
#.........#
#k........#
###########
key : 4

4
0
#####d#####
#.........#
#.........#
#.........#
#.........#
#.........D
#.........#
#..#.....##
#.........#
#.........#
#####D#####

2
3
#####l#####
#k........#
#..#......#
#.#.......#
#.........#
D.........D
#.........#
#.#.......#
#..#......#
#.........#
#####D#####
key : 2

1
0
###########
#.........#
#.........#
#.....##..#
#....##...#
#....#.#..D
#.........#
#.........#
#.........#
#.........#
#####D#####

3
0
#####D#####
#.........#
##.#......#
#?#.##....#
#.#.@#....#
#....#....D
#.#..#....#
#.#.......#
#...#.....#
#.........#
#####d#####
sign Beware what lurks ahead.

3
3
#####D#####
#.......#.#
#.........#
#####.....#
#..#......#
l..#......D
#.........#
#.....#...#
#.........#
#.........#
#####l#####
locked : 0

0
3
###########
#X........#
#.........#
#.........#
#.........#
#.........#
#.........#
#.........#
#.........#
#.........#
#####D#####

3
2
#####l#####
#k........#
#..#......#
#.#.......#
#.........#
D.........l
#.........#
#.#.......#
#..#....#.#
#.........#
#####D#####
key : 0

2
1
#####D#####
#.........#
#......#.##
#.........#
#..#.#.#..#
d.........D
#..#.#.#..#
#.........#
##.#...#..#
#.........#
#####D#####

4
3
#####l#####
#.........#
#.........#
#.........#
#.........#
D.........#
#.........#
#.........#
#.........#
#.........#
###########
locked : 4

