1
1
###########
#........k#
#.........#
#.........#
#.........#
..........#
#.........#
#.........#
#.........#
#.........#
#####.#####
key : 0

2
2
###########
#.........#
#.........#
#.........#
#.........#
..........#
#.........#
#.........#
#.........#
#.........#
#####.#####

2
0
#####.#####
#.........#
#.........#
#....##.#.#
#.........#
#...#@##...
#...###?#.#
#...###...#
#.........#
#.........#
#####.#####
sign The dungeon remembers all who enter.

3
2
#####.#####
#.........#
#.........#
#.........#
#.......#.#
d......#..#
#.........#
#.........#
#.........#
#.........#
#####.#####

5
2
#####.#####
#.........#
#.........#
#..#..#..##
#.........#
l.........#
#..#..#...#
#.........#
#.........#
#..#......#
#####.#####
locked : 5

7
2
#####.#####
#.........#
#...#.....#
#....#....#
#....##...#
..........#
#.........#
#.........#
#.........#
#......#.X#
###########

3
0
#####.#####
#.........#
#.........#
#..##.....#
#.........#
#..#.......
#..##.....#
##..#.....#
##.#......#
##........#
###########

5
1
#####.#####
#.........#
#......#..#
#.......#.#
#.........#
#k........l
#.........#
#.........#
#.........#
#.........#
#####d#####
key : 5

2
1
#####.#####
#e........#
##..#.....#
#.........#
#.........#
.....#.....
#.........#
#.........#
##.....#..#
#?........#
#####.#####
enemies 1
sign A useful tool lies just ahead.

6
2
#####.#####
#.##......#
#..#......#
#.#.......#
#.####....#
l..##e....#
#.........#
#.........#
#.........#
#.........#
#####.#####
locked : 6
boss
enemies 1

4
2
#####.#####
##.#...#.##
#.........#
#.#...#.#.#
#.........#
d..#......d
#.........#
#.#.#.....#
#.........#
##.....#..#
#####.#####

4
1
#####.#####
#.........#
#......#..#
#.......#.#
#.........#
#.........d
#.........#
#.#.......#
#..#......#
#.........#
#####.#####

1
0
#####l#####
#......#..#
#..#...#..#
#.#.....#.#
#.........#
#..........
#.........#
#.........#
#...#.....#
#.........#
#####.#####

4
3
###########
#.........#
#......#..#
#.......#.#
#.........#
d.........#
#.........#
#.........#
#.........#
#.........#
###########

6
1
#####d#####
#.........#
#.........#
###.......#
#..#......#
#.........l
#.........#
#.........#
#.........#
#.........#
#####.#####

3
1
#####.#####
#k........#
#####.....#
#.#.#.....#
#.....#...#
.....##...d
#.....###.#
#....#..#.#
#...#.....#
#......#..#
#####.#####
key : 1

0
0
###########
#.........#
#......#..#
#...#...#.#
#.........#
#.........#
#.........#
#.#.....#.#
#..#...#..#
#.........#
#####l#####
locked : 0

7
1
#####.#####
#k........#
##.##.....#
##..#.....#
#...#.....#
#...##.....
#.........#
##....#...#
#.........#
#.........#
#####.#####
key : 6

8
1
#####.#####
#.........#
#.........#
#.........#
#.........#
#.........#
#.........#
#.........#
#.........#
#e.......?#
###########
enemies 1
sign Those who search shall find.

