0
0
###########
#.........#
#.........#
#.........#
#.........#
#.........#
#.........#
#.........#
#.........#
#.........#
#####l#####
locked : 0

4
1
#####D#####
#.........#
#.........#
#.........#
#.........#
#.........d
#.........#
#.........#
#.........#
#.........#
#####D#####

8
1
#####D#####
###.......#
#.##......#
#.#.......#
#.##......#
#....#.#..#
#....###..#
#....####?#
#.....#.###
#........e#
###########
enemies 1
sign Those who search shall find.

1
1
###########
#........k#
#.....#...#
#...#.....#
#..###....#
D...#.....#
#....#....#
#.........#
#.........#
#.........#
#####D#####
key : 0

4
2
#####D#####
#.........#
#.........#
#.........#
#.........#
d.........d
#.........#
#.......#.#
#......#..#
#.........#
#####D#####

6
1
#####d#####
#.........#
#.........#
#.........#
#.........#
#.....#...l
#....##.#.#
#.....#...#
#.....##.##
#......#..#
#####D#####

1
0
#####l#####
#.........#
#...#.....#
#.........#
#.....#...#
#.........D
#.........#
#.#.....#.#
#..#..##..#
#.........#
#####D#####

2
2
###########
#........##
#..#...#..#
#.#.....#.#
#.##......#
D.........#
#.........#
#.......#.#
#......#..#
#.........#
#####D#####

3
1
#####D#####
#k........#
##.#...#.##
#.........#
#.#...#.#.#
D.........d
#..#.#.#..#
#.........#
#.#.#.#.#.#
#.........#
#####D#####
key : 1

6
2
#####D#####
#.........#
#.........#
#.........#
#......p..#
l....e....#
#.........#
#.........#
#.........#
#.........#
#####D#####
locked : 6
boss
enemies 1

5
2
#####D#####
##........#
#.........#
#.........#
#...#..#..#
l.........#
#.........#
##........#
#.........#
#.........#
#####D#####
locked : 5

5
1
#####D#####
#.........#
#..#......#
#.#.......#
#.........#
#.........l
#.........#
#.........#
#........##
#........k#
#####d#####
key : 5

4
3
###########
#......#..#
#..#...#..#
#.#.....#.#
#.........#
d.........#
#.........#
#.........#
#...#.....#
#.........#
###########

3
0
#####D#####
#.........#
#......#..#
#.......#.#
#.........#
#.........D
#.........#
#.........#
#.........#
#.........#
###########

2
1
#####D#####
#e........#
#.........#
###.......#
#..#......#
D.........D
#.........#
#.........#
#.........#
#?........#
#####D#####
enemies 1
sign A useful tool lies just ahead.

7
2
#####D#####
#.........#
#.........#
#.........#
#.........#
D.........#
#.........#
#.........#
#.........#
#........X#
###########

7
1
#####D#####
#.........#
#.........#
#.........#
#...#..#..#
#k........D
#.........#
#.........#
#.........#
#.........#
#####D#####
key : 6

3
2
#####D#####
#......#..#
#.....##..#
#.....#...#
#......##.#
d.....#...#
#....##...#
#....#..#.#
#.....#..##
#.........#
#####D#####

2
0
#####D#####
#.........#
#.........#
#.........#
#.........#
#?...@....D
#.........#
#.........#
#.........#
#.........#
#####D#####
sign The dungeon remembers all who enter.

