3
3
#####D#####
#.........#
#.........#
#.........#
#.........#
D.........D
#.........#
#.........#
#.........#
#.........#
###########

5
1
#####d#####
#.#.....#.#
#.........#
#.........#
#.#..#..#.#
D.........d
#.........#
#.#..#..#.#
#.........#
#.........#
#####d#####

4
1
#####D#####
#.........#
#.........#
#.........#
#.........#
D.........D
#..#......#
#..#......#
#.........#
#.........#
#####d#####

6
1
#####d#####
#.........#
#..#...#.##
#.........#
#..#.#.#..#
D.........D
#..#.#.#..#
#.........#
##.....#..#
#.........#
#####D#####

3
4
###########
#.##.....k#
#.###.#...#
#.###.....#
#..###....#
D.........#
#.........#
#.........#
#.........#
#.........#
###########
key : 2

2
2
###########
#..#......#
#..##.....#
#...#.....#
#.........#
D.........D
#.#.......#
#..#......#
####......#
#.........#
#####D#####

1
3
#####D#####
#.........#
#...#.#...#
#.........#
#....##...#
#....e....#
#...#.....#
#.........#
#.........#
#.........#
#####d#####
boss
enemies 1

2
3
#####d#####
#.........#
#.........#
#.........#
#.........#
D........k#
#.........#
#.........#
#.........#
#.........#
#####D#####
key : 3

3
1
#####D#####
#......#..#
#.........#
#e###.....#
#e#?......#
#e........l
#.......#.#
#.........#
#.........#
#.........#
#####D#####
enemies 3
sign A locked path — look elsewhere first.

0
3
###########
#X........#
#.........#
#.........#
#.........#
#.........#
#.........#
#.........#
#.........#
#.........#
#####D#####

2
1
###########
##.#...#.##
#k........#
##.#.#....#
#.........#
#..#.#.#..D
#.........#
##.#.#.#.##
#.........#
#..#...#..#
#####D#####
key : 1

6
0
#####D#####
#.........#
#..#......#
#.#.......#
#.........#
#.........D
#.........#
#.#.....#.#
#..#...#..#
#.........#
###########

4
0
###########
#.........#
#.........#
##..#..#..#
#.........#
#.........D
#.#.....#.#
#.........#
#.........#
##........#
#####D#####

5
2
#####D#####
#.........#
#.........#
#.#.#...#.#
#.........#
d...#.....#
#.........#
#.#.#.....#
#.........#
#.#.......#
#####D#####

6
2
#####D#####
#.........#
#.........#
#.........#
#.........#
D.........#
#.........#
#.........#
#........e#
#......?ee#
###########
enemies 3
sign The dungeon remembers all who enter.

3
2
#####D#####
#..#......#
#..##.....#
#.....#...#
#..###....#
l...#.....D
#....##...#
#.........#
#.........#
#.........#
#####l#####
locked : 0

4
2
#####l#####
#.........#
#.........#
#...##....#
#.##.##.#.#
D....##...#
#..###..#.#
#...#...#.#
#...#.....#
#.........#
#####D#####
locked : 1

7
1
#####D#####
#.........#
#......#..#
#.......#.#
#.........#
#.........#
#.....#...#
#.#...##..#
#..#......#
#k........#
###########
key : 0

5
0
#####D#####
#.........#
#.........#
#.........#
#.........#
#....@....D
#.........#
#.........#
#.........#
#.........#
#####D#####

