3
3
###########
#.........#
#.........#
#.........#
#.........#
d....e....#
#.........#
#.........#
#.........#
#.........#
#####D#####
boss
enemies 1

0
2
###########
#.........#
##..#..#..#
#.........#
#.........#
D...#.....D
#.........#
#.........#
##..#..#..#
#.........#
#####D#####

0
3
###########
#....k....#
#.........#
#.........#
#.........#
D.........d
#.........#
#.#.......#
#..#......#
#.........#
#####D#####
key : 7

3
1
#####D#####
##.#...##.#
#..##.##..#
#..##.#.#.#
#..###....#
D.........D
#.........#
#.........#
#.........#
#.........#
###########

1
1
#####D#####
#........##
#.........#
#.........#
#.........#
D.........D
#.........#
#.#.......#
#..#.....##
#........k#
#####d#####
key : 0

0
4
###########
#.........#
#.........#
#.........#
#.........#
d.........#
#.........#
#.#.......#
#..#......#
#.........#
#####D#####

4
3
#####D#####
#.........#
#.........#
#...#.....#
#.........#
D.........#
#.........#
#.........#
#.........#
#........X#
###########

2
1
#####d#####
#..#......#
#.........#
#.........#
#..#..#...#
D.........D
#.........#
#..#..#..##
#.........#
#.........#
#####D#####

4
0
#####d#####
#.........#
#.........#
#.........#
#.........#
#.........#
#.........#
#.........#
#.........#
#.........#
###########

3
0
#####D#####
#e........#
#.........#
#....p....#
#e........#
#e...p....D
#?........#
#.........#
#.........#
#.........#
#####d#####
enemies 3
sign The dungeon remembers all who enter.

3
2
#####D#####
#e#.....#e#
#.........#
#.#.#.#.#.#
#.........#
D.....#...d
#.........#
#...#.#.#.#
#.........#
#.......#?#
#####D#####
enemies 2
sign What you seek is close.

2
0
#####D#####
#.......#.#
#.........#
#.........#
#.#..#..#.#
#.........D
#.........#
#.#..#..#.#
#.........#
#.........#
#####D#####

1
0
###########
#.........#
#.........#
#.........#
#.........#
#....@....D
#.........#
#.........#
#.........#
#.........#
#####D#####

4
2
#####D#####
#p........#
#.........#
#...p.....#
#.........#
#.........D
#.##......#
#.#.#.....#
#.#.......#
#e........#
###########
enemies 1

2
2
#####D#####
#k........#
##.#...#.##
#.........#
#.#.#...#.#
D.........#
#..#...#..#
#.........#
#.#.#.#.#.#
#.........#
#####D#####
key : 3

1
2
#####D#####
##.....#..#
#.........#
#.........#
#.......#.#
D.........D
#.........#
##..#..#..#
#.........#
#k........#
#####D#####
key : 1

1
3
#####D#####
#e........#
#.........#
#.........#
#.........#
D.........l
#.........#
#.........#
#.........#
#e...e....#
###########
enemies 3

1
4
#####D#####
#.........#
#.#.#...#.#
#.........#
#......#..#
l.........#
#.#.#.#...#
#.........#
#......#.##
#.........#
###########
locked : 7

0
1
###########
#.........#
#.#...#.#.#
#.........#
#..#.#.#..#
#.........D
#.#.#.#.#.#
#.........#
#........##
#.........#
#####D#####

