2
2
#####.#####
#.........#
#.........#
#...#.....#
#.#.......#
......#...d
#.........#
#.#.......#
#..#......#
#.........#
#####l#####

1
3
###########
#.......#.#
#.........#
#...#.....#
#.........#
l.........#
#.....#...#
#.......#.#
#......#..#
#.........#
#####.#####
locked : 2

3
1
#####.#####
#k........#
#.........#
#.........#
#.........#
...........
#.........#
#.........#
#.........#
#.........#
#####.#####
key : 0

2
0
#####.#####
#.#.......#
#.........#
#....#.#.##
#.........#
#...#.#....
#.........#
#..#.#.#.##
#.........#
#.......#.#
#####d#####

1
0
###########
#?........#
#.........#
##........#
#.........#
#...#@.....
#..##.....#
#...#.....#
#..##.....#
#.........#
#####.#####
sign You feel a chill that has nothing to do with the cold.

0
2
###########
#k........#
#...#..#..#
#.......#.#
#.........#
#.........#
#.........#
##........#
#...#.....#
#.........#
#####.#####
key : 4

2
1
#####.#####
#.........#
#..#......#
#.#.......#
#.........#
...........
#.........#
#.........#
#.........#
#.........#
#####.#####

2
3
#####.#####
#.........#
#.........#
#.........#
#.........#
d.........#
#.........#
#.........#
#.........#
#.........#
#####d#####

4
0
#####l#####
#..#......#
#..#...#..#
#.#.....#.#
#.........#
#...#......
#.........#
#.........#
#.........#
#.........#
#####d#####
locked : 0

5
1
#####l#####
#.........#
#.........#
#.........#
#.........#
.....e....#
#.........#
#.........#
#.........#
#.........#
#####.#####
locked : 4
boss
enemies 1

3
0
#####d#####
#.........#
#.........#
#.........#
#.........#
#..........
#.........#
#.......#.#
#......#..#
#.........#
#####l#####

6
1
#####.#####
#.........#
#.........#
#.........#
#.#.#.#.#.#
#...###...#
#.......#.#
#.....##.##
#......#.##
#........X#
###########

4
2
#####.#####
#.........#
#..#......#
#.#.......#
#.........#
..........#
#.........#
#.#.....#.#
#..#...#..#
#.........#
###########

1
1
###########
#.........#
#......#..#
#.......#.#
#.........#
...........
#.........#
#.#.....#.#
#..#...#..#
#.........#
#####.#####

4
1
#####.#####
#k........#
#.........#
#.........#
#.........#
...........
#.........#
#.........#
#.........#
#.........#
#####l#####
key : 2

5
0
#####d#####
#.........#
#......#..#
#.......#.#
#.....#...#
#..........
#.........#
#.......#.#
#......#..#
#.........#
###########

3
2
#####l#####
#.........#
#........##
#.........#
#.#.#.#.#.#
...........
#..#.#.#..#
#.........#
#.#.#.#.#.#
#.........#
#####.#####
locked : 1

3
3
#####d#####
#.........#
#.........#
#.........#
#.##......#
....#.#...#
#..#......#
####......#
#.###.....#
#.........#
###########

1
2
#####.#####
#.........#
#.#.......#
#.........#
#.........#
..........l
#.........#
#.#.......#
##.#......#
#k........#
#####.#####
key : 1

