6
0
#####D#####
#.........#
#.........#
#.........#
#.........#
#.........d
#.........#
#.........#
#.........#
#k........#
###########
key : 2

6
1
###########
#.........#
#..#......#
#.#.......#
#.........#
d.........#
#.........#
#.#.......#
#..#......#
#.........#
###########

4
0
#####D#####
#.........#
#.........#
#.........#
#.........#
#?...@....D
#.........#
#.........#
#.........#
#.........#
#####D#####
sign Those who search shall find.

4
4
###########
#.........#
#.........#
#.........#
#.........#
d.........#
#.........#
#.........#
#.........#
#..#......#
#####D#####

3
1
#####D#####
##.....#.##
#.........#
#....#.#.##
#.........#
D..#.#.#..D
#.........#
##.#.#...##
#.........#
##.#...#..#
#####D#####

5
2
#####l#####
#.........#
#..#...#..#
#.#.....#.#
#.........#
#.........D
#.........#
#.......#.#
#......#..#
#.........#
###########
locked : 1

1
1
#####l#####
#.........#
#.........#
#.........#
#.........#
#.........#
#.........#
#.........#
#.........#
#.........#
#####l#####
locked : 0

2
1
#####l#####
#.........#
#.........#
#.........#
#..#......#
#e.#......d
#.........#
#.........#
#.........#
#.........#
#####D#####
enemies 1

3
0
###########
#.........#
#.....#...#
#......##.#
#......##.#
#.........D
#.##......#
#.#.......#
#.##......#
#.........#
#####D#####

0
1
###########
#..#.....##
#.........#
#.........#
#.........#
#.........#
#.........#
#..#..#...#
#.........#
#.........#
#####l#####
locked : 2

2
2
###########
#.........#
#.........#
#.....#...#
#.........#
d.........#
#.........#
#.........#
#.........#
#.........#
#####D#####

5
3
#####D#####
#.........#
#.#.....#.#
#.........#
#.........#
D..#......d
#.........#
#.........#
#.......#.#
#.........#
###########

5
0
#####D#####
##........#
##....#...#
#.##......#
#.#.......#
#..#.#....#
#....#....#
#.........#
#.........#
#.........#
#####D#####

4
1
#####D#####
#.........#
#.....##..#
#......#..#
#....###..#
D.........D
#.........#
#.........#
#p........#
#k........#
###########
key : 0

4
2
#####D#####
##.#...#.##
#k........#
##.#...#.##
#.........#
D....#.#..l
#.........#
##.#.#...##
#.........#
##.#.....##
#####l#####
key : 1

4
3
###########
#.........#
#.........#
#..#......#
#.........#
l.........d
#.........#
#.........#
#.........#
#.........#
#####D#####
locked : 3

5
4
#####D#####
#.........#
#.........#
#.........#
#.........#
d....e....#
#.........#
#p........#
#.........#
#.......p.#
#####D#####
boss
enemies 1

6
4
#####D#####
#..#......#
#.........#
#.........#
#.........#
#.........#
#.........#
#.........#
#.........#
#X........#
###########

3
2
#####D#####
##k#...#.##
#.........#
#.#.#.....#
#.........#
D....#.#..#
#.........#
#.#.#.#.#.#
#.........#
#......#.##
#####D#####
key : 3

