4
1
###########
#........k#
#.........#
#.........#
#....##...#
...#.#....#
#..##..#..#
#..#..##..#
#...#.##..#
#.........#
#####.#####
key : 0

2
0
###########
#.........#
#.........#
#.........#
#.........#
#.........l
#.........#
#.......#.#
#......#..#
#.........#
#####l#####
locked : 1

1
2
#####.#####
#.........#
#.........#
##.#......#
#..#......#
.....e....#
#.........#
#.....#...#
#.........#
#.........#
#####d#####
boss
enemies 1

2
1
#####l#####
#.........#
#.........#
#.........#
#.........#
l.........l
#.........#
#.........#
#.........#
#.........#
###########
locked : 2

4
0
#####.#####
#.........#
#.........#
#.........#
#.........#
#....@.....
#.........#
#.........#
#.........#
#.........#
#####.#####

5
0
#####.#####
#.........#
#.........#
#...#..#..#
#.........#
#..........
#.#..#..#.#
#.........#
#.........#
#......#..#
#####d#####

8
1
#####.#####
#.#.....#.#
#.........#
#.........#
#..#..#...#
..........#
#.........#
#.#..#..#.#
#.........#
#........e#
###########
enemies 1
door 1 : 1

6
1
#####.#####
#s........#
#.........#
#.........#
#.........#
...........
#.........#
#.#.......#
#..#......#
#?........#
#####.#####
switch 0 : 0
sign The brave are rewarded.

7
2
#####.#####
#.........#
#..#......#
##........#
#......#..#
......#e..#
#......##?#
#.........#
#.........#
#........e#
###########
enemies 2
sign Beware what lurks ahead.

6
0
#####d#####
#.........#
#..#......#
#.#.......#
#.........#
#..........
#.........#
#.........#
#.........#
#.........#
#####.#####

7
0
#####.#####
#.........#
#......#..#
#.......#.#
#.........#
#k.........
#.........#
#.........#
#.#.......#
#.........#
#####.#####
key : 3

5
1
#####.#####
#.........#
#...#.....#
#.....#...#
#.........#
...#.....k#
#..#......#
#.#.......#
#.........#
#.........#
#####.#####
key : 2

2
2
#####d#####
#.........#
#.........#
#.........#
#.........#
l.........#
#.........#
#.#.....#.#
#..#...#..#
#.........#
###########
locked : 0

7
1
#####.#####
#.........#
#......#..#
#.......#.#
#.........#
......#....
#.........#
#.#.....#.#
#..#...#..#
#.........#
#####.#####

6
2
###########
#........e#
#.........#
#.........#
#.........#
..........#
#.........#
#.........#
#.........#
#.........#
#####.#####
enemies 1
door 0 : 0

1
1
###########
#.........#
#.......#.#
#.........#
#.........#
#..........
#.........#
#.#.......#
#..#......#
#.........#
#####l#####
locked : 3

0
2
###########
#X........#
#.........#
#..###....#
#.#.####..#
#....##...#
#.#..##...#
#.#.......#
#.........#
#.........#
#####.#####

3
0
#####l#####
#.........#
#..#.....##
#.........#
#k#.#.#.#.#
#.........#
#..#.#....#
#.........#
#.#.#.#...#
#.........#
#####.#####
key : 1

8
0
#####.#####
#.........#
#.#.......#
#.........#
#.........#
#.....#....
#.........#
#s........#
#e......#.#
#ee.......#
###########
enemies 3
switch 1 : 1

