4
0
#####D#####
#.......#.#
#.....#.#.#
#.....#...#
#......#..#
#....#.#..D
#.........#
#.........#
#.........#
#k........#
###########
key : 1

8
1
#####D#####
#.........#
#.........#
#.........#
#.........#
#.........#
#...#.....#
#.........#
#..#......#
#X........#
###########

3
1
#####D#####
#k........#
#......#..#
#.......#.#
#.........#
D.........D
#.........#
#.........#
#.........#
#.........#
#####l#####
key : 0

5
1
#####D#####
#k#.....#.#
#.........#
#.........#
#..#..#...#
#.........D
#.........#
#.#.....#.#
#.........#
#.........#
#####d#####
key : 3

2
3
###########
##.#...#..#
#.........#
#.#.#.#.#.#
#.........#
d....#....#
#.........#
#.#...#.#.#
#.........#
#..#.....##
#####D#####

4
2
#####D#####
#.........#
#..#......#
#..##.....#
#..###....#
D..##.....#
#.##......#
##.##.....#
#.........#
#.........#
#####l#####

0
0
###########
#.........#
#..#...#.##
#.........#
#....#....#
#.........#
#..#.#.#..#
#.........#
##.....#.##
#.........#
#####D#####

1
0
#####D#####
#.........#
#.#.....#.#
#.........#
#.........#
#.....#...#
#.........#
#.........#
#.......#.#
#.........#
#####d#####

3
2
#####D#####
#........##
#...#.....#
#..###....#
#.........#
D.........l
#.........#
#.........#
#..#......#
#.........#
#####D#####

5
2
#####l#####
#.........#
#..#......#
#.#.......#
#.........#
D.........#
#.....#...#
#.........#
##........#
#.........#
###########
locked : 0

3
0
#####D#####
#.........#
#.........#
#.........#
#...@.....#
#..###....D
#...#.....#
###.......#
#?..#.....#
####......#
#####D#####
sign A useful tool lies just ahead.

4
1
#####l#####
#.........#
#.........#
#.........#
#.........#
D.........D
#.........#
#.........#
#.........#
#.........#
#####D#####
locked : 1

1
2
###########
#.........#
#.........#
#.........#
#.........#
#.........#
#.........#
#.........#
#.........#
#.........#
#####D#####

2
0
#####d#####
#.........#
#..#...#..#
#.#.....#.#
#.........#
#.........D
#.........#
#.......#.#
#......#..#
#.........#
#####D#####

3
3
#####D#####
#.........#
#.........#
#.........#
#.........#
l.........#
#.........#
#.........#
#.........#
#.........#
###########
locked : 3

2
2
#####D#####
##.#.....##
#.........#
#....#...##
#.........#
D..#.#.#..d
#.........#
##...#.#.##
#.........#
##.#...#.##
#####D#####

6
1
#####d#####
#.........#
#.......#.#
#.........#
#.........#
#..#..#...#
#.........#
#.........#
#.........#
#.........#
#####d#####

7
1
#####d#####
#.........#
#.........#
#.........#
#.........#
#...#e....#
#.#.......#
#.#.#.....#
#.........#
#.........#
#####D#####
boss
enemies 1

2
1
###########
#k........#
##.....#.##
#.........#
#..#.#.#..#
D.........D
#.........#
#.........#
##.#.....##
#.........#
#####D#####
key : 2

