6
2
#####.#####
#.........#
#.........#
#.....#..##
#.........#
..........#
#..#......#
#.........#
#.........#
#..#.....##
###########

2
1
#####d#####
#.........#
#......#..#
#.........#
#..#......#
#..........
#..#.#.#..#
#.........#
##.#...#.##
#.........#
#####.#####

6
1
#####.#####
#k........#
#.........#
#.........#
#.........#
...........
#.........#
#.........#
#.........#
#.........#
#####.#####
key : 1

1
2
###########
#........k#
#.#.#.#...#
#.........#
#.#.#.#.#.#
..........#
#.#...#...#
#.........#
#...#...#.#
#.........#
#####.#####
key : 4

0
1
###########
#X........#
#.........#
#.#.#.....#
#.#..#....#
#..####...#
#.###.#...#
#.........#
#.........#
#.........#
#####.#####

1
1
#####.#####
#.........#
#.....#.###
#....###.##
#....#.#..#
#....e.....
#.........#
#.........#
#.........#
#.........#
#####d#####
boss
enemies 1

4
1
#####.#####
#.........#
#.........#
##...#....#
#.........#
...........
#.........#
#.........#
#.........#
#.........#
#####d#####

5
3
###########
#.......?e#
#.........#
#.........#
#.........#
..........#
#.........#
#.........#
#.........#
#........s#
###########
enemies 1
switch 0 : 0
sign This door will not yield without a key.

5
2
#####d#####
#.........#
#.........#
#.........#
#.........#
l..........
#.........#
#.......#.#
#......#..#
#.........#
#####.#####
locked : 1

6
0
#####.#####
#.........#
#.........#
##..#..#..#
#k........#
#..........
#.#..#....#
#.........#
#.........#
##.....#..#
#####l#####
key : 0

4
0
###########
#e?#.....##
#.........#
#.........#
#......#..#
#..........
#.........#
#..#..#...#
#.........#
#.........#
#####.#####
enemies 1
sign Many have walked this path.

2
2
#####.#####
#.........#
#......#..#
#.......#k#
#.........#
..........#
#.........#
#.#.......#
#..#......#
#.........#
#####.#####
key : 2

7
0
#####l#####
#.........#
#..#......#
#.##......#
#.........#
#..........
#.....#...#
#.#.......#
#..#...#..#
#.........#
###########
locked : 0

5
1
#####d#####
#.........#
#.........#
#.......#.#
#.........#
..........l
#.......#.#
#.........#
#.........#
#.........#
#####.#####

3
2
#####.#####
#.........#
#.........#
#.........#
#.........#
d.........#
#.........#
#.........#
#.........#
#.........#
#####.#####

7
1
#####.#####
#.........#
#.........#
#.........#
#.........#
..........#
#.........#
#.........#
#...#....?#
#.......ee#
###########
enemies 2
door 0 : 0
sign This door will not yield without a key.

4
2
#####.#####
#.#.....#.#
#.........#
#.........#
#..#..#...#
..........#
#.........#
#.#..#..#.#
#.........#
#.........#
#####d#####

3
1
#####.#####
#.........#
#.....#...#
#.........#
#..#.#.#..#
#.........d
#.......#.#
#.........#
#......#.##
#.........#
#####.#####

5
0
#####.#####
#.........#
#.........#
#.........#
#.........#
#..#.@.....
#......##.#
#......#..#
#.....#?#.#
#.........#
#####.#####
sign Something glints behind that door…

