3
1
#####.#####
#.........#
#...#.#.#.#
#.........#
#..#...#..#
..........#
#.#.#.#.#e#
#.........#
#..#...#.##
#.........#
#####.#####
enemies 1

6
1
#####l#####
#......#..#
#......#..#
#..#..#...#
#..##..#..#
....#..#...
#...#.....#
#.........#
#.........#
#.........#
###########
locked : 1

2
0
#####.#####
#.........#
#.........#
##..#..#..#
#.........#
#..........
#...#..#..#
#.........#
#.........#
#......#..#
#####d#####

4
3
###########
#.........#
#......#..#
#.......#.#
#.........#
d.........#
#.........#
#.........#
#.........#
#.........#
#####.#####

4
0
#####.#####
#k#.....#.#
#.........#
#..#...#.##
#.........#
#.....#....
#.........#
#..#.#.#.##
#.........#
#.#.....#.#
#####.#####
key : 1

0
1
###########
#........X#
#.........#
#..#......#
#.##.#....#
....##....#
#.#.#.....#
#.#.......#
#..#......#
#.........#
#####.#####

5
3
#####.#####
#.........#
#..#......#
#.#.......#
#.##......#
d.........#
#.........#
#.........#
#.........#
#.........#
###########

6
0
#####.#####
#.........#
#......#..#
#........##
#.........#
#..........
#.........#
#.......#.#
#......#..#
#k........#
###########
key : 0

4
2
###########
##........#
#......#..#
#..#....#.#
#.........#
..........d
#.........#
#.......#.#
#......#..#
#.........#
#####.#####

5
2
#####.#####
#.........#
#.#.....#.#
#.........#
#.........#
l..#..#...d
#.........#
#.........#
#.#.....#.#
#.........#
#####d#####
locked : 0

2
1
#####.#####
#..#.....##
#.........#
#.........#
#..#..#...#
..........#
#........k#
#..#.....##
#.........#
#.........#
#####.#####
key : 2

6
2
#####d#####
#.........#
#.........#
#.........#
#.........#
..........#
#.........#
#.......#.#
#......#..#
#.........#
###########

5
0
#####.#####
#.........#
#.........#
#.........#
#.........#
#?...@.....
#.........#
#.........#
#.........#
#.........#
#####.#####
sign A useful tool lies just ahead.

1
0
#####.#####
#.........#
#.#.......#
#.........#
#.........#
#.........l
#.........#
#.........#
#.#.......#
#.........#
#####.#####

4
1
#####.#####
#.........#
#.........#
#.........#
#.........#
...........
#.........#
#.........#
#.........#
#.........#
#####.#####

3
0
#####d#####
#.........#
#.........#
#.........#
#.........#
#..........
#.........#
#.........#
#.........#
#.........#
#####.#####

5
1
#####.#####
#..#......#
#.........#
#.........#
#...#..#..#
..........l
#.........#
#.....#..##
#.........#
#.........#
#####l#####

1
1
#####.#####
#.........#
#.........#
#.........#
#...e.....#
l....#....#
#.##.#....#
#.##......#
#..##.#...#
#.##......#
#####.#####
locked : 2
boss
enemies 1

0
0
###########
#k........#
#.#.#.#...#
#.........#
#.#.#.#.#.#
#..........
#.#.#.....#
#.........#
#.#.#.#...#
#.........#
#####.#####
key : 3

