1
1
#####d#####
##.#......#
##.#......#
#..#......#
#..#......#
#...#.....D
#.#.#.....#
###.#.....#
##........#
##.#......#
#####D#####

0
2
###########
#.........#
#.........#
#.........#
#.........#
D.........#
#.........#
#.......#.#
#......#..#
#.........#
#####D#####

4
5
#####D#####
#......#e##
#......#..#
#.....###e#
#.........#
#e........#
#...#.....#
#.........#
#.........#
#.........#
#####D#####
enemies 3

2
4
###########
#.........#
#..#...#..#
#.#.....#.#
#.........#
d.........D
#.........#
#.........#
#.........#
#.........#
#####D#####

5
5
#####D#####
#.........#
#...#.##..#
#....#..#.#
#.....#...#
#.........#
#.........#
#.........#
#.........#
#X........#
###########

2
0
###########
#?........#
#.........#
#.........#
#.........#
#....@....D
#.........#
#.........#
#.........#
#.........#
###########
sign A faint humming emanates from the walls.

1
3
###########
#.........#
#..#...#..#
#.#.....#.#
#.........#
d.........#
#.........#
#.........#
#.........#
#.........#
#####D#####

3
3
#####D#####
#.........#
#.........#
#..#......#
#...#.....#
D.........D
#.##......#
#.....#...#
#.........#
#....k...##
###########
key : 3

2
1
#####D#####
#.........#
#.....#?#.#
#....#e##.#
#....#.##.#
D.........D
#.........#
#.........#
#.........#
#.........#
#####d#####
enemies 1
sign What you seek is close.

1
2
#####D#####
#.........#
#.#.#...#.#
#.........#
#....#....#
D.........d
#.#.#.#.#.#
#.........#
#..#.....##
#.........#
#####D#####

0
1
###########
##........#
#......#..#
#.......#.#
#.........#
#.........D
#.........#
#.......#.#
#......#..#
#.........#
#####d#####

3
6
###########
#.......ee#
#.........#
#.........#
#.........#
D.........#
#.........#
#.........#
#.........#
#.......?e#
###########
enemies 3
sign Seek the matching key before you proceed.

2
5
###########
#........k#
#.........#
#.........#
#...#.....#
D......#..#
#.....#...#
#.......#.#
#......#..#
#.........#
#####D#####
key : 4

3
4
#####D#####
#?........#
#.........#
#.........#
#.........#
D.........l
#.........#
#.........#
#.........#
#....e....#
###########
enemies 1
sign A locked path — look elsewhere first.

3
5
#####D#####
#......##.#
#.........#
#....##.###
#...e#..#.#
l....#.#..D
#.........#
#.........#
#.........#
#.........#
#####D#####
locked : 1
boss
enemies 1

2
2
#####D#####
#k........#
#.........#
#.........#
#.......#.#
D.........D
#.........#
##..#..#..#
#.........#
#.........#
#####D#####
key : 0

3
1
#####d#####
#..#...##.#
#.##..###.#
#.######..#
#.###.....#
#...#.#...D
#.........#
#.........#
#.........#
#.........#
###########

2
3
#####D#####
#k........#
#..#...#..#
#.#.....#.#
#.........#
D.........d
#.........#
#......##.#
#......#..#
#.........#
#####D#####
key : 1

3
2
#####D#####
#.......#.#
#.........#
#..#.#...##
#.........#
D...#.....D
#.........#
#..#...#.##
#.........#
#.#.......#
###########

