2
2
#####.#####
#.........#
##..#..#..#
#.........#
#.........#
l...#.....l
#.........#
#.........#
##..#..#..#
#.........#
#####.#####
locked : 0

0
1
###########
#k.#......#
#.........#
#.###...#.#
#.#.###...#
#...##....#
#.###..##.#
#...#.##..#
#.........#
#.........#
#####.#####
key : 0

1
2
###########
#.........#
##..#..#..#
#.........#
#.........#
.......#..#
#.........#
#.........#
##..#..#..#
#.........#
#####.#####

6
4
#####.#####
#.........#
#..#...#.##
#.........#
#.....#...#
..........#
#..#...#..#
#.........#
#...#.#.#.#
#.......?e#
###########
enemies 1
door 0 : 0 1
sign Those who search shall find.

4
3
#####d#####
#.........#
#.........#
#.........#
#.........#
#..........
#.........#
#.#.......#
#..#......#
#.........#
#####d#####

2
3
###########
#.........#
#...#.#...#
#.........#
#..#.#....#
l.........#
#.#.#.#.#.#
#.........#
#..#...#..#
#.........#
#####.#####
locked : 1

3
2
#####.#####
#.........#
#...#.....#
#.........#
#.........#
...........
#.........#
#.#.......#
#.........#
#....k....#
###########
key : 1

4
5
###########
#.......se#
#.#.#...#?#
#.........#
#..#.#.#..#
..........#
#.#.#.#.#.#
#.........#
#..#...#.##
#........e#
###########
enemies 2
switch 0 : 0 1
sign Those who search shall find.

3
3
#####.#####
#.........#
#.........#
#..#.....##
#.........#
..........d
#...#..#..#
#.........#
#.........#
#..#.....##
#####d#####

7
3
#####.#####
#.........#
#.........#
#.........#
#.........#
#.....##..#
#....##...#
#.........#
#.....##..#
#.......#X#
###########

5
3
#####d#####
#.........#
#.#.#.#.#.#
#.........#
#.#.#.#.#.#
#..........
#.#.#.#.#.#
#.........#
#.#.#.....#
#.........#
#####d#####

2
1
#####.#####
#..#...#..#
#..##.###.#
#..###....#
#..##.#...#
#...#.....l
#.....#...#
#.........#
#.........#
#.........#
#####.#####

4
4
#####.#####
#k.#......#
#.........#
#.........#
#...#..#..#
...........
#.........#
#..#..#..##
#.........#
#.........#
#####.#####
key : 2

6
3
#####d#####
#.........#
#.........#
#.........#
#.........#
#....e.....
#.........#
#.........#
#.........#
#.........#
#####.#####
boss
enemies 1

5
4
#####.#####
#k#.......#
#.........#
#..#.#....#
#.........#
....#.#...#
#.........#
#..#.#.#..#
#.........#
#.......#.#
#####.#####
key : 3

1
0
###########
#.........#
#.........#
#.........#
#.........#
#....@.....
#.........#
#.........#
#.........#
#.........#
###########

3
4
###########
#.#.......#
#......#..#
#.......#.#
#..#......#
d.........#
#.........#
#.........#
##........#
#.........#
#####.#####

3
1
#####.#####
#.........#
#..#......#
#.#.......#
#.........#
#..........
#.........#
#.........#
#.........#
#.........#
###########

1
1
#####.#####
#.........#
#.........#
#.........#
#.........#
...........
#.........#
#.......#.#
#......#..#
#.........#
#####.#####

