1
1
###########
#k........#
#p........#
#.........#
#.........#
D.........D
#.......p.#
#.........#
#.........#
#.........#
#####D#####
key : 0

2
1
#####D#####
#.........#
#.....#.#.#
#.....#...#
#.........#
D...#.....D
#.###.....#
##..#.....#
###.......#
#.........#
#####d#####

2
2
#####D#####
##.....#.##
#.........#
##.#.....##
#.........#
D..#.#.#..D
#.........#
##.#.#.#.##
#.........#
#..#...#.##
#####d#####

7
1
#####D#####
#.........#
#.........#
#.........#
#.........#
#.........#
#.........#
#.........#
#.........#
#X........#
###########

1
3
###########
#..#s...e##
#........e#
#.........#
#...#..#..#
D.........#
#.........#
#..#..#...#
#.........#
#.........#
#####D#####
enemies 2
switch 0 : 0 1

0
0
###########
#.........#
#.........#
#.#.#.....#
#.####....#
#..##.#...#
#...#.#...#
#.#.#..#..#
#.#.#.....#
#..#......#
#####D#####

3
1
#####d#####
#.......#.#
#.........#
#..#...#..#
#.........#
D...#.#...D
#.........#
#..#.#.#..#
#.........#
#.#.......#
#####D#####

2
0
#####d#####
#.........#
#.........#
#.p.......#
#...@.....#
#....p....D
#.........#
#.........#
#.........#
#.........#
#####D#####

5
1
#####l#####
#.........#
#..#...#..#
#.#.....#.#
#.........#
#.........#
#.........#
#.........#
#.........#
#.........#
#####d#####
locked : 3

0
2
###########
#.........#
#......#..#
#.......#.#
#....#....#
#.........#
#.........#
#.........#
#.........#
#.........#
#####l#####
locked : 2

4
1
#####D#####
#.........#
#..##.....#
#...#.....#
#.........#
#k........D
#.........#
#.........#
#.........#
#.........#
#####l#####
key : 3

3
2
#####d#####
#k........#
#.........#
#.........#
#.........#
D.........D
#.........#
#.........#
#.........#
#.........#
#####D#####
key : 2

1
0
#####D#####
#.........#
#.........#
#.#..#..#.#
#.........#
#.........D
#.....#...#
#.........#
#.........#
#.#.....#.#
#####d#####

3
0
#####D#####
#.........#
##.....#.##
#.........#
#.#.#.#...#
#.........D
#..#...#..#
#.........#
#.#...#.#.#
#.........#
###########

2
3
#####D#####
#.........#
#........?#
#........##
#........e#
D.........#
#.........#
#.........#
#.........#
#..#.....##
#####D#####
enemies 1
sign The dungeon remembers all who enter.

1
2
#####l#####
#k........#
#.........#
#........##
#.#.......#
D.........D
#.........#
#.#.....#.#
#..#......#
#.........#
#####D#####
key : 1

3
3
#####D#####
#.........#
#..#...#..#
#.......#.#
#.........#
D.........#
#.........#
##........#
#..#......#
#.........#
###########

4
2
#####D#####
#.#.....#.#
#.........#
#.........#
#.........#
D.........#
#.........#
#....#..#?#
#.........#
#........e#
###########
enemies 1
door 0 : 0 1
sign A useful tool lies just ahead.

6
1
#####d#####
#.........#
#..##.#...#
#..#.###..#
#....#....#
#....e....#
#....##...#
#...###...#
#.........#
#..#....#.#
#####D#####
boss
enemies 1

