3
5
#####D#####
#.........#
#.........#
#.........#
#.........#
#.........#
#.........#
#.p.......#
#.........#
#X........#
###########

2
1
###########
#.........#
#.........#
#.........#
#.........#
D.........d
#.........#
#.........#
#.........#
#.........#
###########

2
0
#####D#####
#.........#
#.........#
#.#.##....#
#.####....#
#..#@#....D
#.#.......#
#p#p.##...#
#.........#
#.........#
#####D#####

3
0
#####D#####
#.........#
#.........#
#.........#
#.........#
#.........#
#..##.....#
#.#.#.....#
#.#.......#
#e.......s#
###########
enemies 1
switch 0 : 0 1

2
5
#####l#####
#.........#
#.........#
#.........#
#.........#
#....e....#
#.........#
#.........#
#.........#
#.........#
#####D#####
locked : 0
boss
enemies 1

0
3
###########
#....k....#
#.........#
#.........#
#.........#
D.........D
#.........#
#.#.....#.#
#..#...#..#
#.........#
#####D#####
key : 5

1
4
#####d#####
#.........#
#p........#
##...#.#.##
#.#.##....#
d.........d
#.#..##.#.#
##..#.#..##
#.........#
#.p.......#
###########

1
2
#####l#####
#.........#
#.........#
#.........#
#.........#
#.........D
#.........#
#.........#
#.........#
#k#.......#
#####D#####
key : 0

2
3
#####D#####
#.........#
#.#.#.....#
#.#.......#
#.#.......#
D.........#
#....#....#
#.........#
#.........#
#........k#
###########
key : 2

1
6
###########
#.......ee#
#.........#
#.........#
#.........#
D.........#
#.........#
#.........#
#.........#
#.......?e#
###########
enemies 3
sign Many have walked this path.

0
2
###########
#.#.....#.#
#.........#
#..#.#.#.##
#.........#
#...#.#...D
#.........#
#..#.#.#.##
#.........#
#.#.......#
#####l#####
locked : 1

0
4
###########
#.........#
#.........#
#.........#
#.........#
D.........D
#.........#
#.#.......#
#..#......#
#.........#
#####d#####

0
5
###########
#.......ee#
#.........#
#.........#
#.....p...#
D.........#
#.........#
#.........#
#.........#
#.........#
#####D#####
enemies 2
door 0 : 0 1

1
0
#####D#####
#.........#
#.#.....#.#
#.........#
#.........#
#..#..#...#
#.........#
#.........#
#.#.......#
#.........#
#####D#####

1
3
#####D#####
#.........#
#.........#
#.........#
#.........#
D.........d
#.........#
#.......#.#
#......#..#
#.........#
#####D#####

1
5
#####D#####
#.........#
#.....#..##
#.........#
#.........#
d..#..#...D
#.........#
#.........#
#..#.....##
#.........#
#####l#####

2
2
#####D#####
#.........#
#......#..#
#.......#.#
#.........#
d.........D
#.........#
#.......#.#
#......#..#
#.........#
#####D#####

0
0
###########
#.........#
#.........#
#.........#
#....p....#
#.........#
#.........#
#.........#
#.........#
#.........#
#####D#####

3
2
#####D#####
#.........#
#......#..#
#.......#.#
#.........#
#.........#
#.........#
#.......#.#
##.....#..#
#k........#
###########
key : 1

