2
0
#####.#####
#.........#
#.........#
#.........#
#.........#
#....@.....
#.........#
#.#.......#
#.........#
#.........#
#####.#####

3
2
#####.#####
#.........#
#.........#
#.........#
#.........#
#.........#
#.........#
#.........#
#.........#
#k........#
###########
key : 1

0
2
###########
#.........#
#..#..#..##
#.........#
#.........#
#..#..#....
#.........#
#.........#
#..#..#...#
#.........#
#####l#####
locked : 1

1
4
#####d#####
#.........#
#...#.#.#.#
#.........#
#....#....#
d.........d
#.#...#.#.#
#.........#
#..#...#.##
#.........#
###########

0
4
###########
#.........#
#.........#
#.........#
#.........#
...........
#.........#
#.........#
#.........#
#.........#
#####d#####

1
6
###########
#.......ee#
#.........#
#.........#
#.........#
..........#
#.........#
#.........#
#.........#
#.......?e#
###########
enemies 3
sign Many have walked this path.

0
5
###########
#.......ee#
#.........#
###.......#
#.##......#
..........#
#...#.....#
#.#.......#
#.........#
#.........#
#####.#####
enemies 2
door 0 : 0 1

2
3
#####.#####
#.........#
#..#......#
#.#.......#
#.........#
..........#
#.........#
#.#.....#.#
#..#...#..#
#........k#
###########
key : 2

0
0
###########
#.........#
#......#..#
#.......#.#
#.........#
#.........#
#..#......#
#.......#.#
##.....#..#
#.........#
#####.#####

1
5
#####.#####
#..#.....##
#.........#
#.........#
#..#......#
d..........
#.........#
#.....#..##
#.........#
#.........#
#####l#####

3
0
#####.#####
#.........#
#.........#
#.........#
#.........#
#.........#
#.........#
#.........#
#.........#
#e.......s#
###########
enemies 1
switch 0 : 0 1

3
5
#####.#####
#.........#
#.........#
####......#
#..##.....#
#...##....#
#.####....#
#...##....#
#.........#
#X........#
###########

0
3
###########
#......k..#
#......#..#
#.......#.#
#.........#
...........
#.........#
#.....#...#
#.........#
#.........#
#####.#####
key : 5

2
1
###########
#.........#
#.........#
#.....#...#
#.........#
..........d
#...#.....#
#.........#
#.........#
#..#.....##
###########

1
3
#####.#####
#.........#
#.#.......#
#.........#
#.........#
.....#....d
#.........#
#.........#
#.#.....#.#
#.........#
#####.#####

1
0
#####.#####
#.........#
##.#...#.##
#.........#
#.#.#.#.#.#
#.........#
#..#.#.#..#
#.........#
#.#.#.#.#.#
#.........#
#####.#####

2
5
#####l#####
#.........#
#.........#
#.........#
#.........#
#..#.e....#
#.##......#
##........#
#.........#
#.........#
#####.#####
locked : 0
boss
enemies 1

2
2
#####.#####
#.........#
#..#..#...#
#..###....#
#....#....#
d...#......
#..##..#..#
#.........#
#.........#
#.........#
#####.#####

1
2
#####l#####
#.........#
#.........#
#.........#
#.........#
#k.........
#.........#
#.........#
#.........#
##........#
#####.#####
key : 0

