3
0
###########
#.........#
#......#..#
#.......#.#
#.........#
#..........
#.........#
#.#.......#
#..#......#
#.........#
#####.#####

4
5
#####.#####
#.#.......#
#.###.....#
#.#...#...#
#.#.......#
d.........#
#.........#
#.........#
#.........#
#.........#
#####.#####

2
4
#####.#####
#.........#
#.#...#...#
#.........#
#..#...#..#
#..........
#k#.#.#...#
#.........#
#..#...#..#
#.........#
#####.#####
key : 2

5
2
#####l#####
#.........#
#..#......#
#.##......#
#.........#
#..........
#.........#
#.......#.#
#......#..#
#........##
#####d#####
locked : 0

4
4
#####d#####
#.........#
#......#..#
#.......#.#
#.........#
..........d
#.........#
#.#.......#
#..#......#
#.........#
#####.#####

5
4
#####.#####
#......####
#.....#####
#.....##..#
#....#k##.#
.....#.....
#.........#
#.........#
#.........#
#.........#
###########
key : 1

1
4
#####.#####
#.........#
#k#.......#
#.........#
#.........#
#....#....#
#.........#
#.........#
#.#.......#
#.........#
#####.#####
key : 3

0
4
###########
#e........#
#.........#
#.........#
#.........#
#.........#
#.........#
#.........#
#.........#
#.........#
#####.#####
enemies 1
door 0 : 0

5
5
#####.#####
#.#.......#
#.........#
#...#...#.#
#.........#
....#.#...#
#.........#
#.....#.#?#
#.......s.#
#......e#e#
###########
enemies 2
switch 0 : 0
sign A useful tool lies just ahead.

4
2
###########
#.........#
#......#..#
#.......#.#
#.........#
d..........
#.........#
#.........#
#.........#
#.........#
#####l#####

5
3
#####.#####
#.........#
#......#..#
#.......#.#
#.........#
...........
#.........#
#.........#
#.........#
#.........#
###########

4
1
#####.#####
#.........#
#.........#
#...#.....#
#...#.....#
...#......d
#....#.#..#
#..#.#....#
#..#..#...#
#..#e.e#..#
###########
enemies 2

3
5
#####.#####
#.........#
#.........#
#.........#
#.........#
l..##e#...#
#.#....#..#
#.####....#
#.....##..#
#..#......#
#####.#####
locked : 1
boss
enemies 1

3
1
###########
#.........#
#..#...#.##
#.........#
#..#.#.#..#
..........#
#....#.#..#
#.........#
##.#.....##
#.........#
#####.#####

2
5
###########
#........X#
#.........#
#.........#
#.........#
..........#
#.........#
#.........#
#.........#
#.........#
#####.#####

3
4
#####.#####
#.........#
#.........#
##...#.####
#..#...#..#
#....#.#..l
#....#.##.#
#......##.#
#.........#
#.........#
#####d#####

4
3
###########
#k#.....#.#
#.........#
#.........#
#.#..#....#
...........
#.........#
#....#..#.#
#.........#
#.........#
#####.#####
key : 0

6
2
#####d#####
#.........#
#......#..#
#.......#.#
#.........#
#.........#
#.........#
#.#.....#.#
#..#...#..#
#.........#
###########

4
0
#####.#####
#.........#
#.........#
#.#..#....#
#...@#....#
#....#.....
#.#.##....#
#.#.##....#
#.........#
#.........#
###########

