3
5
#####D#####
#.........#
#.........#
#.........#
#....#....#
d....e....#
#.........#
#.........#
#........##
#.........#
#####D#####
boss
enemies 1

1
4
#####D#####
#k........#
#..#......#
#.#.......#
#.........#
D.........D
#.........#
#.......#.#
#......#..#
#.........#
#####D#####
key : 3

0
4
###########
#e.......e#
##.#...#.##
#?........#
#.#.#.#.#.#
#.........#
#..#...#..#
#.........#
#...#.#.#.#
#.........#
#####D#####
enemies 2
sign What you seek is close.

2
3
#####D#####
#.........#
#......#..#
#.......#.#
#.........#
d.........l
#.........#
#.........#
#.........#
#.........#
#####D#####

3
2
#####D#####
#.........#
#.........#
#....#.#..#
#....#?#..#
D..####...D
#..#e.....#
#...##....#
#.........#
#.........#
###########
enemies 1
sign Those who search shall find.

3
4
#####D#####
#.........#
#.......#.#
#.........#
#.........#
d....#....d
#.........#
#.........#
#.#.......#
#.........#
###########

4
3
#####l#####
#.#.......#
#.........#
#.#.#.#.#.#
#.........#
#...#.#...#
#.........#
#.#.#.#.#.#
#.........#
#.......#.#
###########
locked : 2

3
1
#####D#####
#.........#
#.........#
#.........#
#.........#
#.........D
#.......p.#
#.........#
#.......p.#
#.........#
###########

2
1
#####D#####
#.........#
#.........#
#.........#
#.........#
D.........D
#.........#
#.#.......#
#..#......#
#.........#
#####D#####

1
3
###########
#k........#
##..#..#..#
#.........#
#.........#
D....#....D
#.........#
#.........#
##..#.....#
#.........#
#####D#####
key : 1

2
2
#####d#####
#.........#
#.........#
#....#....#
#.........#
D..##.....d
#.........#
#.........#
#.........#
#.........#
#####D#####

1
2
###########
#.........#
#.....#...#
#.........#
#.........#
D.........D
#.........#
#.......#.#
#......#..#
#.........#
#####d#####

1
1
###########
#.........#
#.........#
#.........#
#.........#
#.........D
#..###....#
#..##.....#
#..#......#
#.........#
#####D#####

1
5
###########
#........k#
#.........#
#.........#
#.........#
D.....#...#
#.###.###.#
#...#...#.#
#.###.....#
#.........#
#####D#####
key : 4

4
5
#####D#####
#.........#
#.........#
#.........#
#.........#
#.........#
#.........#
#.........#
#.........#
#X........#
###########

3
3
#####D#####
#k#.....#.#
#.........#
#....#.#.##
#.........#
D...#.....d
#.........#
#..#.#.#.##
#.........#
#.#.....#.#
#####l#####
key : 2

2
0
###########
#.........#
#.##......#
#.##......#
#..##.....#
#..##@....D
#.........#
##..#.....#
#?###.....#
#.........#
###########
sign Many have walked this path.

2
4
#####D#####
#.........#
#.........#
#.........#
#.........#
l.........l
#.........#
#.........#
#.........#
#.........#
#####D#####
locked : 1

2
5
#####D#####
#.........#
#..#..#...#
#.........#
#.........#
l...#.....#
#.........#
#.........#
#.....#...#
#.........#
#####D#####
locked : 3

