6
0
#####.#####
#.........#
#..#......#
#.#.......#
#.........#
#..........
#.........#
#.#.......#
#..#......#
#.........#
#####.#####

8
1
#####.#####
#......#..#
#...#.....#
#...####..#
#....###..#
..........#
#.........#
#.........#
#.........#
#........k#
###########
key : 1

3
2
#####d#####
#.........#
#..#......#
#.#.......#
#...#.....#
#.........#
#.......#.#
#.......#.#
#......#..#
#.........#
#####l#####
locked : 4

9
0
#####.#####
#.........#
#.........#
####......#
#..#......#
#.........#
#.........#
#.........#
#e........#
#e.......e#
###########
enemies 3

4
0
###########
#.........#
##..#.....#
#.........#
#.........#
#...#.....#
#.........#
#.........#
##..#..#..#
#.........#
#####d#####

0
2
###########
#X........#
#.........#
##..#.###.#
#.######..#
#..###....#
#..#.##...#
#.##..#.#.#
#.........#
#.........#
#####.#####

5
2
#####.#####
##.#...#..#
#.........#
##.#...#.##
#.........#
...#.#....#
#.........#
##.#.#.#.##
#.........#
##.#...#.##
#####.#####

6
2
#####.#####
#.........#
#.........#
#......#..#
#.....#...#
d......#..#
#.........#
#.........#
#...#.....#
#..#......#
#####.#####

2
2
#####d#####
#.........#
#...#..#..#
#.........#
#.........#
#...#..#..#
#.........#
#.........#
##..#..#..#
#.........#
#####d#####

1
2
#####.#####
#.........#
#.........#
#.........#
#.........#
#....e....#
#.........#
#.........#
#.........#
#.........#
#####d#####
boss
enemies 1

7
2
#####.#####
#.........#
#..#..#..##
#...#.#...#
#....#.#..#
.....#....#
#.....#.#.#
#.........#
#.........#
#........k#
###########
key : 3

7
0
#####.#####
#.........#
#.........#
#.........#
#.........#
#....@....l
#.........#
#.........#
#.........#
#.........#
#####.#####

4
3
###########
#.........#
##.#.....##
#.........#
#.#...#.#.#
..........#
#..#.#.#..#
#.........#
#.....#.#.#
#.........#
###########

5
0
#####d#####
#......####
#......####
#....###.##
#....##...#
#......#...
#.........#
#.........#
#.........#
#.........#
#####.#####

6
1
#####.#####
#e.......e#
#.........#
#.....#..##
#.........#
..........d
#..#..#...#
#.........#
#.........#
#e.#......#
#####.#####
enemies 3

5
1
###########
#.........#
#.#.......#
#...#.....#
#.........#
...........
#.........#
#.........#
#.........#
#.........#
#####.#####

4
2
#####l#####
#.........#
#..#...#..#
#k##....#.#
#.........#
#..........
#.........#
#.......#.#
#......#..#
#.........#
#####.#####
key : 4

7
1
#####.#####
#.........#
##.#...#..#
#.........#
#.....#.#.#
l..........
#..#.#.#..#
#.........#
#...#.#.#.#
#.........#
#####.#####
locked : 0

8
0
#####.#####
#.........#
#......#..#
#.......#.#
#.........#
#...#......
#.........#
#k#.......#
#..#......#
#.........#
#####.#####
key : 0

