0
0
###########
#k........#
#.........#
#..#.#....#
#...#.....#
#..#......#
#.........#
#.........#
#...#.....#
#.........#
#####.#####
key : 2

4
2
#####.#####
#.........#
#.#.#.#.#.#
#.........#
#.#.#.#.#.#
...........
#.#.#...#.#
#...e.....#
#...#.....#
#...e.....#
###########
enemies 2
door 0 : 0

4
3
#####.#####
#.........#
#.........#
#.........#
#.........#
..........#
#.......#.#
#.........#
#........##
#.........#
###########

3
3
#####.#####
#.........#
#.......#.#
#.........#
#.........#
..........#
#.........#
#.#....##.#
#..#...#.##
#.........#
#####.#####

7
1
#####.#####
#.........#
#.........#
#.........#
#.........#
#.........#
#.........#
#.........#
#.........#
#X........#
###########

3
1
#####l#####
#.........#
#.........#
#.........#
#....#....#
...#.#.....
#.####....#
#.##.##...#
#.#.......#
#.........#
#####l#####
locked : 0

3
2
#####d#####
#........##
#.........#
#.........#
#.........#
...........
#.........#
#.........#
#.........#
#......#..#
#####.#####

1
3
###########
##s....#e##
#e........#
#.#.#.#.#.#
#.........#
#..#.#.#..#
#.........#
#...#.#...#
#.........#
#..#...#.##
#####.#####
enemies 2
switch 0 : 0

1
0
#####.#####
#.........#
#..#...#..#
#.........#
#....#.#..#
#..........
#....#.#..#
#.........#
##.#...#.##
#.........#
#####.#####

2
2
###########
#.........#
#.........#
#.........#
#.........#
...#.##....
#.#.##....#
#.#.......#
#.##..#...#
#.k#......#
#####d#####
key : 1

2
3
#####.#####
#k........#
#.........#
#.........#
#.........#
..........d
#.........#
#.........#
#.........#
#.........#
#####.#####
key : 3

2
4
###########
#.........#
#...#.#...#
#.....#.#.#
#....###..#
d....#....#
#.........#
#.........#
#.........#
#.........#
###########

2
1
#####.#####
#e.......e#
##..#.....#
#.........#
#.........#
.....#.....
#.........#
#.........#
##..#..#..#
#e........#
#####l#####
enemies 3

2
0
#####.#####
#.........#
#.........#
#.........#
#...@.....#
#?...#.....
#....###..#
#....##...#
#.........#
#.........#
#####.#####
sign The brave are rewarded.

1
1
###########
#.........#
#.........#
#.........#
#.........#
..........#
#.........#
#.........#
#.........#
#.......#.#
#####.#####

4
1
#####l#####
#.........#
#.........#
#.........#
#.........#
#..........
#.........#
#.........#
#.........#
#.........#
#####d#####
locked : 2

3
0
#####.#####
#.........#
#.........#
#.#..#..#.#
#.........#
#..........
#..#......#
#.........#
#.........#
#k#.....#.#
###########
key : 0

6
1
#####d#####
#.........#
#.........#
#.........#
#......##.#
#....e....#
#.....#.#.#
#..#......#
#.........#
#.........#
#####.#####
boss
enemies 1

5
1
#####d#####
#.........#
#...#.###.#
#...#..##.#
#..##.##..#
#.........#
#.........#
#.........#
#.........#
#.........#
#####d#####

