4
3
#####D#####
#.........#
#.........#
##..#.....#
#.........#
D.........#
#.#..#....#
#.........#
#.........#
##....?#ee#
###########
enemies 2
door 0 : 0 1
sign A locked path — look elsewhere first.

4
1
###########
##k#...#.##
#.........#
##.#.#.#.##
#.........#
D....#....l
#.........#
##.....#.##
#.........#
#......#.##
#####l#####
key : 0

5
1
#####l#####
#.........#
#.........#
#...#.....#
#.........#
#.........D
#.........#
#.........#
#..#......#
#.........#
#####D#####
locked : 0

1
4
#####D#####
#k........#
#.#.#.#.#.#
#.........#
#.#.#.#.#.#
D.........D
#...#...#.#
#.........#
#.#.#.#.#.#
#.........#
#####D#####
key : 3

2
3
#####D#####
#.........#
#.........#
#..#..#..##
#.........#
D.........D
#...#.....#
#.........#
#.........#
#..#.....##
#####D#####

4
2
#####D#####
#.........#
#.........#
#.........#
#.........#
l....e....D
#.........#
#.........#
#.........#
#.........#
#####D#####
locked : 1
boss
enemies 1

1
5
###########
#.#......?#
#......#..#
#.......#.#
#.........#
D..#...#..#
#.........#
#.........#
#.........#
#.........#
###########
sign What you seek is close.

3
2
#####D#####
#e........#
#.........#
#.........#
#.........#
#e........D
#.........#
#.........#
#.........#
#.........#
#####D#####
enemies 2

0
4
###########
#e.......?#
#.........#
#.........#
#.........#
#.........#
#.........#
#.........#
#.........#
#.........#
#####D#####
enemies 1
sign A useful tool lies just ahead.

6
2
#####D#####
#.........#
#.........#
#.........#
#.........#
D.........#
#.........#
#.........#
#.........#
#........X#
###########

3
0
###########
#k........#
#...#.....#
##..#.....#
#.#.##....#
#..####...#
#..####...#
#.....#...#
#.........#
#.........#
#####D#####
key : 1

1
3
###########
##........#
#.........#
#.........#
#.........#
#.........D
#.........#
#...#.....#
#.........#
#.........#
#####D#####

3
4
#####D#####
#.........#
#.........#
#.........#
#.........#
D..#......#
#.##......#
###.......#
#.........#
#........k#
###########
key : 2

2
2
###########
#e........#
##.#...#.##
#s........#
#.#.#.#.#.#
#.........D
#......#..#
#.........#
#...#.#.#.#
#.........#
#####D#####
enemies 1
switch 0 : 0 1

3
3
#####D#####
#?........#
#......#..#
#.......#.#
#.........#
D.........D
#.........#
#.......#.#
#......#..#
#.........#
#####D#####
door 1 : 2 3
sign Something glints behind that door…

5
2
#####D#####
#.........#
#.........#
#....#....#
#.#.......#
D.........#
#.....#...#
#.......#?#
#......#..#
#.........#
#####D#####
sign This door will not yield without a key.

2
4
#####D#####
#.........#
#..#......#
#.#.......#
#.........#
D.........#
#.........#
#.......#s#
#......#..#
#.........#
#####D#####
switch 1 : 2 3

6
1
#####D#####
#.........#
#.........#
#.........#
#.........#
#.........D
#.........#
#.......#.#
#......#..#
#?........#
###########
sign Only the prepared may pass.

4
0
#####D#####
#.........#
#.p.......#
#.........#
#.........#
#..##@....D
#.#.#.....#
#.p..#....#
#..#......#
###.......#
###########

