2
1
###########
#.........#
#.........#
#...#k#...#
#....###..#
.....#.#...
#...##.##.#
#.........#
#.........#
#.........#
###########
key : 0

1
7
###########
#.........#
#.#.......#
#..#......#
#..##...#.#
d...###...#
#....##...#
#....##...#
#.........#
#.........#
###########

0
4
###########
#.........#
#.........#
#.........#
#.........#
#...#......
#.###.....#
##.##.....#
#.........#
#.........#
#####d#####

4
3
#####.#####
#.........#
#.........#
#.#..#..#.#
#.........#
#.........#
#....#..#.#
#.........#
#.........#
#.#.....#.#
###########

3
6
#####.#####
#......##.#
#...#.#.#.#
#....##.#.#
#....#..#.#
#....#....#
#.........#
#.........#
#.........#
#X........#
###########

1
3
###########
#.........#
#.........#
#.........#
#.........#
#..........
#.........#
#.........#
#.........#
#.........#
#####.#####

2
0
###########
#.......#.#
#.........#
#...##.##.#
#.#.@#....#
#..###.....
#.##.#....#
#..#.#....#
##.#......#
#.........#
###########

3
3
#####.#####
#..#......#
#.........#
#..#.#.#.##
#.........#
#..#.#.#...
#.........#
##.#.#.#..#
#e........#
##.....#.##
#####.#####
enemies 1

1
4
#####d#####
#.........#
#.#.#.#...#
#.........#
#.#...#.#.#
..........l
#...#.....#
#.........#
#...#...#.#
#.........#
#####.#####

3
4
#####l#####
#.#.......#
#.........#
#...#.#.#.#
#.........#
....#.#...#
#.........#
#.#.#.#...#
#.........#
#.......#.#
###########
locked : 0

0
5
###########
#.........#
#.........#
#.....#...#
#...#.#...#
.....#.....
#.........#
#.........#
#.........#
#.........#
#####d#####

0
6
###########
#..#.....k#
#..#......#
#.#.......#
#.........#
..........#
#.........#
#........##
#.........#
#.........#
#####.#####
key : 4

2
3
#####.#####
#k........#
#.........#
#.........#
#.........#
......#....
#.......#.#
#.......#.#
#......#..#
#.........#
#####.#####
key : 2

2
6
#####l#####
#.........#
#..##.#...#
#.#...#...#
#.#.#.#...#
...###....#
#.##e#....#
#.#.......#
##..#.....#
#.........#
#####.#####
locked : 1
boss
enemies 1

2
5
#####d#####
#.........#
#.........#
##.....#..#
#.........#
...........
#....#..#.#
#.........#
#.........#
##........#
###########

2
2
###########
#..#k.....#
#...#..##.#
#...#.###.#
#...#..#..#
...........
#.........#
#.........#
#.........#
#.........#
###########
key : 1

1
6
#####.#####
#......#..#
#.........#
#.........#
#.......#.#
..........d
#.........#
#.........#
#.........#
#.........#
#####l#####

2
4
#####.#####
#e........#
#.........#
#.#..#..#.#
#.........#
...........
#..#..#...#
#.........#
#.........#
#e#.....#e#
#####l#####
enemies 3

1
5
#####d#####
#.........#
#.#.....#.#
#.........#
#.........#
l.....#....
#.........#
#.........#
#.#.....#.#
#.........#
#####d#####
locked : 2

