4
2
#####D#####
#........##
#.........#
#.........#
#..#......#
D.........#
#.........#
#..#......#
#.........#
#........k#
###########
key : 2

3
1
#####l#####
#.........#
#...#.....#
#.........#
#.#...#...#
D.........D
#.#...#.#.#
#.........#
#.#...#.#.#
#.........#
#####D#####

4
0
#####d#####
#.........#
#.........#
#.........#
#.........#
#.........D
#.........#
#.#.....#.#
#..#...#..#
#.........#
###########

2
2
#####D#####
####......#
#...#.....#
###.#.....#
#.#.#.....#
D.........d
#.........#
#.........#
#.........#
#.........#
#####d#####

2
1
###########
#.........#
#..#......#
#.#.......#
#.........#
D.........D
#.........#
#.......#.#
#......#..#
#.........#
#####l#####
locked : 0

1
3
#####D#####
#.........#
#.........#
#.........#
#...e.....#
l....###..#
#.....###.#
#.....#.###
#.....#.#.#
#.........#
#####D#####
locked : 2
boss
enemies 1

1
0
#####D#####
#.........#
#.........#
#.......#.#
#.........#
#.........#
#.........#
#.#.......#
#..#......#
#.........#
#####D#####

0
3
###########
#........X#
#.........#
#.........#
#.........#
D.........#
#.........#
#.........#
#.........#
#.........#
#####D#####

4
1
#####D#####
#.........#
#..#......#
#.#.......#
#.........#
D.....#...D
#......#..#
#.......#.#
#......#..#
#.........#
#####D#####

5
1
#####D#####
#.........#
#..#...#.##
#.........#
#......#..#
#.........#
#..#.#.#..#
#.........#
##.#...#.##
#k........#
###########
key : 1

2
0
#####D#####
#k........#
##.....#..#
#.........#
#.........#
#....#....D
#.........#
#.........#
##..#.....#
#.........#
#####D#####
key : 0

0
0
###########
#.........#
#.#.#.#...#
#.........#
#.#...#.#.#
#.........#
#.....#.#.#
#.........#
#.#.#...#.#
#.........#
#####D#####

2
4
###########
#.........#
#......#..#
#.......#.#
#.........#
D.........#
#.#.#.....#
#.#.......#
#..#......#
#.........#
###########

2
3
#####D#####
#.........#
#.........#
#.........#
#.........#
d.........D
#......p..#
#.........#
#.........#
#.........#
#####D#####

0
2
###########
#ee#?.....#
#.........#
#.........#
#......#..#
#.........D
#.........#
#..#......#
#.........#
#.........#
#####D#####
enemies 2
sign Those who search shall find.

3
2
#####d#####
#.........#
#......#..#
#.......#.#
#.........#
D.........d
#.........#
#.......#.#
#......#..#
#.........#
#####D#####

3
3
#####D#####
#.........#
#..#......#
#.........#
#.........#
d.........#
#.........#
#.........#
#..#..#..##
#.........#
###########

3
0
#####D#####
#.........#
#.........#
#..##.....#
#...#.....#
#?...@....D
#.........#
#.........#
#.........#
#.........#
#####d#####
sign What you seek is close.

1
2
#####D#####
#.........#
#.......#.#
#.........#
#..#......#
#.........l
#.........#
#.......#.#
#......#k.#
#.......#.#
#####D#####
key : 4

