6
2
#####.#####
#.........#
#.........#
#.........#
#.........#
l.........#
#.........#
#.#.....#.#
#.........#
#.........#
#####.#####
locked : 2

3
3
###########
#.......#.#
#.........#
#..#.#.#..#
#.........#
d...#.#...#
#.........#
#....#....#
#.........#
#.#.....#.#
###########

4
2
#####.#####
#.#.....#.#
#.........#
#.#...#.#.#
#.........#
....#.#...#
#.........#
#.#.#.#.#.#
#.........#
#.#.....#.#
#####.#####

3
1
#####.#####
#.........#
#......#..#
#.........#
#.........#
...........
#.........#
#.........#
#.........#
#.........#
#####.#####

0
1
###########
#.........#
##.#.....##
#.........#
#..#.#.#..#
#.........#
#..#.#.#..#
#.........#
##.....#.##
#.........#
#####d#####

2
1
#####.#####
#.........#
#.###...#.#
#.#.#...#.#
#.#.#.###.#
#...##.#..l
#.#..#..#.#
#.........#
#.........#
#.........#
#####.#####

1
1
#####d#####
#.........#
#.........#
#...#.....#
#.........#
#.........#
#.....#...#
#.......#.#
#......#..#
#.........#
#####.#####

5
2
#####.#####
#.........#
#..#......#
#.#.......#
#.#.......#
d.........#
#.........#
#.........#
#...#.....#
##........#
#####.#####

6
1
#####.#####
#.........#
#......#..#
#.......#.#
#.........#
#k........l
#.........#
#.......#.#
#......#..#
#.........#
#####.#####
key : 2

4
1
#####.#####
#.........#
#.........#
#.........#
#.........#
...........
#.........#
#.........#
#.........#
#.........#
#####l#####

7
2
#####.#####
#......##.#
#.......#.#
#.......#.#
#...#.##..#
d..#.e##..#
#.#..#....#
#...##....#
#.###.....#
#.........#
#####.#####
boss
enemies 1

7
1
#####.#####
#.........#
#.........#
#..#......#
#k##......#
#.........d
#.........#
#.........#
#.........#
#.........#
#####.#####
key : 3

8
2
#####.#####
#......#..#
#.........#
#.........#
#.........#
..........#
#.........#
#.........#
#.........#
#........X#
###########

5
1
#####l#####
#.........#
#.........#
#.........#
#.........#
#...##....d
#.##......#
#.##.#....#
#.#.......#
####......#
#####.#####
locked : 1

8
1
#####.#####
#.........#
#.........#
#..####...#
#...##.##.#
#...#..#...
#..#..##..#
#.....#...#
#?........#
#e........#
###########
enemies 1
sign A useful tool lies just ahead.

4
0
#####.#####
#.........#
#.........#
#.........#
#.........#
#..........
#.........#
#.........#
#.........#
#k........#
###########
key : 0

2
2
###########
#.........#
#.........#
#.........#
#...#.##..#
l....###..#
#.....#...#
#..#.#.#..#
#..##..#..#
#.........#
#####.#####
locked : 0

3
0
###########
#?........#
#.........#
#.........#
#.........#
#....@.....
#.........#
#.........#
#.#.......#
#.........#
#####.#####
sign Something glints behind that door…

3
2
#####.#####
#k........#
#.........#
#.........#
#.........#
..........d
#.........#
#.........#
#.........#
#.........#
#####.#####
key : 1

