4
3
#####.#####
#......#..#
#.....##..#
#....###..#
#....#.#..#
d..#......#
#.........#
#.........#
#.#.......#
#.........#
###########

3
1
#####.#####
#.........#
#.........#
#.........#
#.........#
......#...l
#.....##..#
#.....###.#
#.....##k.#
#......##.#
#####d#####
key : 1

5
0
#####.#####
#..#...#..#
#.........#
#...#.#.#.#
#.........#
#....#.....
#.........#
#.#.#.#.#.#
#k........#
##.....#.##
###########
key : 3

2
1
#####d#####
#.........#
#..#......#
#.#.......#
#.........#
...........
#.........#
#.#.......#
#..#......#
#.........#
#####.#####

4
1
#####d#####
#.........#
##.#...#..#
#.........#
#..#.#.#..#
...........
#....#.#..#
#.........#
##.#...#.##
#.........#
#####.#####

5
1
#####.#####
#.........#
#..#...#..#
#.#.....#.#
#.........#
...........
#.........#
#.#.......#
#..#......#
#.........#
###########

5
2
#####l#####
#.........#
#.........#
#.........#
#.........#
....#e....#
#...#.....#
#.#.......#
#..#......#
#.#.......#
#####.#####
locked : 5
boss
enemies 1

2
2
#####.#####
#.........#
#..#......#
#.#.......#
#.........#
..........#
#.........#
#.#.....#.#
#..#...#..#
#.........#
#####d#####

2
0
#####.#####
#.........#
#...#.#...#
#.....#...#
#...##....#
#...##.....
#...@.....#
#....#....#
##..#.....#
#?........#
#####.#####
sign The brave are rewarded.

1
2
###########
#........k#
#.#.....#.#
#.........#
#.........#
.....#....#
#.........#
#.........#
#.......#.#
#.........#
#####.#####
key : 5

0
0
###########
#..#...#.##
#.........#
#.#.#...#.#
#.........#
#..#.#.#..#
#.........#
#.#.#.#...#
#.........#
#..#...#.##
#####.#####

3
2
#####d#####
#.........#
#..#......#
#.#...#...#
#.........#
l..........
#.....#...#
#.#.....###
#..#...#..#
#.........#
#####.#####
locked : 3

4
2
#####.#####
#e........#
#.........#
#...#.....#
#..#e#....#
...#......d
#.........#
#.........#
#.........#
#?........#
#####l#####
enemies 2
sign This door will not yield without a key.

1
1
###########
#..#......#
#.........#
#.........#
#...#..#..#
...........
#.........#
#..#..#...#
#.........#
#.........#
#####d#####

4
0
#####l#####
#.........#
#.#.#.#.#.#
#.........#
#.#.#.#.#.#
#..........
#.#.#.#...#
#.........#
#.#.#.#...#
#.........#
#####.#####
locked : 0

3
0
#####.#####
##.#.....##
#k........#
##...#.#.##
#.........#
#..#.#.#...
#.........#
##.#.#.#.##
#.........#
##.#.....##
#####l#####
key : 0

1
0
#####.#####
#.........#
#.........#
##..#..#..#
#.........#
#..........
#....#..#.#
#.........#
#.........#
##........#
#####.#####

6
2
#####.#####
#.........#
#.........#
#....##...#
#....##...#
#.........#
#.........#
#.........#
#.........#
#X........#
###########

3
3
###########
#......e#e#
#........e#
#..#.#.#..#
#.........#
......#...#
#.........#
#..#.#.#.##
#.........#
#.#.....#.#
#####.#####
enemies 3

