4
4
#####.#####
#.........#
#.........#
#.........#
#.........#
...##.#...#
#.#..#....#
#.##......#
#.....#...#
#..#.....X#
###########

0
2
###########
#....k....#
#.........#
#.........#
#.........#
...........
#.........#
#.........#
#.........#
#.........#
#####.#####
key : 1

0
1
###########
#.........#
#..#...#..#
#.#.....#.#
#.........#
#..........
#.........#
#.........#
#.........#
#.........#
#####.#####

4
3
#####.#####
#.........#
#.........#
#.........#
#.........#
#..........
#.........#
#.........#
#.........#
#k........#
###########
key : 5

3
4
#####.#####
#.........#
#.........#
#.........#
#...e#....#
d....#.#..#
#.....#.#.#
#.........#
#.........#
#.........#
#####.#####
boss
enemies 1

0
4
###########
#........k#
#..#...#..#
#......##.#
#.#.......#
..........#
#.........#
#.#.....#.#
#..#...#..#
#.........#
#####.#####
key : 4

2
2
#####.#####
#.........#
#.........#
#..#.....##
#.........#
...........
#.........#
#.........#
#.........#
#..#.....##
###########

1
1
#####.#####
#.........#
#......#..#
#.......#.#
#.........#
#..........
#.........#
#.........#
#.........#
#.........#
#####d#####

2
4
#####.#####
#.........#
#.........#
#.........#
#.........#
..........#
#....#....#
#.........#
#.........#
#.........#
#####.#####

3
0
#####.#####
#........e#
#..#.....##
#........s#
#.........#
#.........#
#.........#
#........?#
#..#..#..##
#........e#
#####.#####
enemies 2
switch 0 : 0 1
sign Beware what lurks ahead.

2
1
#####d#####
#.........#
##........#
#.##......#
#.#.......#
...........
#.........#
#.........#
#.........#
#.........#
###########

3
3
#####l#####
#.........#
#.........#
#.........#
#.........#
#.........d
#.........#
#.......#.#
#......#..#
#.........#
#####.#####
locked : 2

2
0
###########
###.......#
#.#.......#
#.###.....#
#.##......#
#...#@.....
#.........#
#.#.......#
#.........#
#.........#
#####.#####

4
0
#####.#####
#.......#.#
#.........#
#.........#
#.#.....#.#
#.........#
#.........#
#.#..#..#.#
#.........#
#.........#
###########

1
2
#####.#####
#e........#
#.........#
#...#.....#
#..#......#
..........d
#..##.....#
##.#......#
#.........#
#e........#
#####.#####
enemies 2

2
3
#####.#####
#k........#
#..#......#
#.#.......#
#.........#
...........
#.........#
#.#.......#
#..#......#
#.........#
#####l#####
key : 2

1
4
#####.#####
#e##......#
#.?##.....#
##..#.....#
#.........#
.........e#
#.........#
#.........#
#.........#
#e........#
#####.#####
enemies 3
door 0 : 0 1
sign Those who search shall find.

0
3
###########
#.........#
#.........#
#.........#
#.........#
...........
#.........#
#.........#
#.........#
#.........#
#####d#####

1
3
#####d#####
#.........#
#......#..#
#.......#.#
#.........#
d..........
#.........#
#.........#
#.........#
#.........#
#####.#####

