3
1
#####D#####
#.........#
#.........#
##.....#..#
#.........#
D.........D
#...#..#..#
#.........#
#.........#
##....k#..#
###########
key : 0

1
2
###########
#.........#
#.......#.#
#.........#
#.........#
D..#......D
#.........#
#.........#
#.........#
#.........#
#####l#####
locked : 2

2
2
#####l#####
#......p..#
#.........#
#.#.......#
#.........#
l.........D
#..###....#
#...#.....#
#.........#
#.........#
#####D#####
locked : 0

5
4
#####D#####
#.........#
#.......pp#
#.........#
#.........#
#.........#
#.........#
#.........#
#.........#
#X........#
###########

4
4
#####d#####
#.........#
#.........#
#.........#
#.........#
#....e....#
#.........#
#.........#
#.........#
#.........#
#####D#####
boss
enemies 1

3
3
#####D#####
##.#...#.##
#.........#
#.#.#.#.#.#
#.........#
d......#..D
#.........#
#...#.#.#.#
#.........#
##.....#..#
###########

1
3
###########
#.........#
#.........#
#.........#
#.........#
D.........#
#.........#
#.........#
#.........#
#.........#
#####d#####

2
3
#####d#####
#k........#
#.........#
#.........#
#.........#
D.........l
#.........#
#.........#
#.........#
#.........#
#####D#####
key : 2

3
5
###########
#.#.......#
#.........#
#.#...#.#.#
#.........#
D.....#...#
#.........#
#.#.#...#.#
#.........#
#.#.....#.#
###########

1
1
#####l#####
#........k#
#........##
#.........#
#.........#
#...#..#..D
#.........#
#.........#
#..#..#..##
#.........#
#####D#####
key : 1

2
4
###########
#.#.....#.#
#.........#
#.#.#...#.#
#.........#
l...#.#...#
#.........#
#.#.#.#...#
#.........#
#.........#
#####d#####
locked : 3

3
2
#####D#####
#.p.......#
#.........#
#.........#
#.........#
D.........d
#.p.#.#...#
#...#.....#
#...#.#...#
#.........#
#####D#####

2
1
#####D#####
#.........#
#......#.##
#.........#
#..#.#.#..#
D.........l
#..#.#.#..#
#.........#
##.....#..#
#e........#
#####D#####
enemies 1

2
0
###########
#?.....#..#
#......#..#
#...##.#..#
#...#.##..#
#....@....D
#...##....#
#...#.....#
#...#.#...#
#.........#
#####D#####
sign The dungeon remembers all who enter.

3
0
#####D#####
#.........#
#..#......#
#.#.......#
#.........#
#.........D
#.........#
#.#.......#
#..#......#
#.........#
#####D#####

4
0
#####D#####
#.........#
#.........#
#.........#
#.........#
#.........#
#.........#
#.........#
#.........#
#.........#
###########

3
4
#####d#####
#.#.....#.#
#.........#
#.........#
#.........#
D.........D
#.........#
#.#.....#.#
#.........#
#.........#
#####d#####

0
1
###########
#.........#
#.........#
#....###..#
#....##...#
#.....##..#
#.........#
#.........#
#.........#
#.........#
#####l#####
locked : 1

4
2
#####D#####
#.........#
#.........#
#.........#
#.........#
#.........#
#.........#
#.........#
#.........#
#k........#
###########
key : 3

