4
0
#####D#####
#.........#
#.........#
#.........#
#.........#
#.........D
#.........#
#.......#.#
#......#..#
#.........#
#####l#####

3
1
#####D#####
#.........#
#......#..#
#.........#
#..#......#
D.........D
#......#..#
#.......#.#
#......#..#
#.........#
#####D#####

1
0
###########
#.........#
#......#..#
#.......#.#
#.........#
#.........D
#.........#
#.#.......#
#..#......#
#.........#
#####d#####

3
2
#####D#####
#......##e#
#...#.#.#.#
#.....#.#.#
#...###.#.#
D...#e#...D
#.........#
#.........#
#.........#
#.........#
#####D#####
enemies 2

2
1
#####D#####
#........k#
#..#...#.##
#.........#
#.#.#.....#
D.........d
#..#...#..#
#.........#
#.#.#.#.#.#
#.........#
#####D#####
key : 1

5
1
#####D#####
#......#..#
#...#..##.#
#......e#.#
#...#.##..#
D.........D
#.#.......#
###.......#
#s##......#
#.........#
###########
enemies 1
switch 0 : 0

4
2
#####D#####
#.........#
#.........#
#.........#
#.........#
D...pk#...D
#....#....#
#....#....#
#.........#
#.........#
#####d#####
key : 2

4
1
#####D#####
#.#.......#
#......#..#
#....#..#.#
#.........#
D.........D
#.........#
#.........#
#.........#
#.........#
#####D#####

4
3
#####D#####
#.........#
#.........#
#.........#
#.........#
D.........#
#.........#
#.........#
#........e#
#.......ee#
###########
enemies 3

3
3
###########
##.....#e##
#........e#
#.#.#.#.#e#
#.........#
D....#.#..#
#.........#
#.#.....#.#
#.........#
##.....#.##
#####D#####
enemies 3
door 0 : 0

2
2
#####d#####
#.........#
#.........#
#.........#
#.........#
d....##...#
#....##...#
#....##.#.#
#.....#.###
#........##
#####D#####

5
2
#####d#####
#.#.....#.#
#.........#
#.........#
#.....#...#
D.........#
#.........#
#.#.......#
#.........#
#.........#
###########

1
1
###########
#........##
#.........#
#.........#
#.........#
D.........D
#.......#.#
#.......#.#
#......#..#
#.........#
#####D#####

0
2
###########
#.......#k#
#......#..#
#......##.#
#.........#
#.........#
#.........#
#.........#
#.....#...#
#.........#
#####D#####
key : 7

3
0
#####D#####
#.........#
#.........#
#.........#
#.........#
#?...@....D
#.........#
#.......p.#
#.........#
#.........#
#####D#####
sign What you seek is close.

1
2
#####D#####
#.........#
#.........#
#.........#
#...###...#
D...e##...D
#...#.....#
#.........#
#.........#
#.........#
#####d#####
boss
enemies 1

2
0
#####d#####
#.........#
#.........#
#.........#
#.........#
#k........D
#.........#
#.........#
#.........#
#.........#
#####D#####
key : 0

1
3
###########
#........X#
#.....###.#
#.....##..#
#.........#
D.........#
#.........#
#.........#
#.........#
#.........#
###########

5
0
#####l#####
#.........#
#..#...#..#
#.#.....#.#
#.........#
#.........D
#.........#
#.........#
#.........#
#.........#
###########
locked : 0

