5
0
#####.#####
#.........#
#.#.#.....#
#...#.....#
#..##.....#
#..........
#.........#
#.........#
#.........#
#e........#
###########
enemies 1

1
3
###########
#........##
#.........#
#.........#
#.........#
d.........#
#.........#
#.#.......#
#..##.#...#
#.........#
###########

2
0
###########
#?........#
#.........#
#.........#
#.........#
#....@.....
#...#.....#
#....#....#
#.........#
#.........#
#####.#####
sign Beware what lurks ahead.

0
2
###########
#.........#
#..#......#
#.#.......#
#......#..#
#...#.....#
#.........#
#.#.......#
#..#......#
#.........#
#####d#####

6
2
#####l#####
#.........#
#.........#
#.........#
#..#e#....#
#...##....#
#..#.#....#
#.........#
#.........#
#.........#
#####.#####
locked : 4
boss
enemies 1

5
1
#####.#####
##.....#?##
#e........#
##.#.#.#.##
#.........#
...#.#.#...
#.........#
#..#...#.##
#.........#
##....e#e##
###########
enemies 3
sign What you seek is close.

4
2
#####.#####
#e.......e#
#.........#
#.........#
#.........#
...........
#.........#
#.........#
#.........#
#e........#
#####d#####
enemies 3

3
1
#####.#####
#......##k#
#.....#.#.#
#.....#...#
#....##.#.#
...........
#.........#
#.........#
#.........#
#.........#
#####.#####
key : 0

4
3
###########
#........k#
#.........#
#.........#
#.........#
..........#
#.........#
#.......#.#
#......#..#
#.........#
###########
key : 4

1
1
###########
#.........#
#..#...#..#
#.#.....#.#
#.........#
#..........
#.........#
#.......#.#
#......#..#
#.........#
#####.#####

3
2
#####.#####
#........##
#.....#.###
#....######
#......##k#
..........#
#.........#
#.........#
#.........#
#.........#
#####.#####
key : 5

3
0
#####.#####
#.........#
#.........#
#.#..#..#.#
#.........#
#..........
#.........#
#.........#
#.........#
#e#.....#.#
#####d#####
enemies 1

2
2
#####.#####
#.........#
#.........#
#.........#
#.........#
..........#
#.........#
#.#.......#
#..#......#
#.........#
#####.#####

1
2
#####d#####
#.........#
#.........#
#.........#
#.........#
..........d
#.........#
#.#.......#
#..#......#
#.#.......#
#####.#####

5
2
#####d#####
##.....#..#
#.........#
#.........#
#...#.....#
..........#
#.........#
##..#.....#
#.........#
#.........#
#####l#####

2
1
#####.#####
#.........#
#...#.#...#
#.........#
#.#.....#.#
...........
#.....#...#
#.........#
#.....#.#.#
#.........#
#####.#####

4
0
#####d#####
#.........#
#.........#
#.....#...#
#.........#
#..........
#.........#
#.........#
#.........#
#.........#
#####.#####

4
1
#####.#####
#k........#
#.........#
#..#..#..##
#.........#
...........
#..#..#...#
#.........#
#.........#
#..#.....##
#####.#####
key : 1

7
2
#####.#####
#.........#
#.........#
#.........#
#.........#
#....##...#
#....##...#
#....###..#
#.........#
#X........#
###########

