4
3
#####D#####
#.........#
#......#..#
#.........#
#.#.#.#.#.#
#.........#
#..#.#.#..#
#.........#
#.#.#.#.#.#
#k........#
###########
key : 7

0
2
###########
#.........#
#.##......#
##........#
#.###.....#
D.........D
#.........#
#.........#
#.........#
#.........#
#####l#####
locked : 1

1
4
###########
#........k#
#.........#
#.........#
#.........#
D.........#
#.........#
#.........#
#.........#
#.........#
#####D#####
key : 3

0
1
###########
#.........#
#.........#
#.........#
#..#..##..#
D...##....D
#...#.##..#
#..##.##..#
#..##.#...#
#.........#
#####D#####

0
0
###########
#.........#
#.........#
#.........#
#.........#
#.........D
#.........#
#.#.....#.#
#..#...#..#
#.........#
#####D#####

2
3
#####l#####
#.........#
#.........#
#..#..#..##
#.........#
D.........D
#...#..#..#
#.........#
#.........#
#........##
#####d#####
locked : 3

1
1
#####D#####
#k.....#..#
#......#..#
#.....##..#
#.....##..#
D...#.....D
#.........#
#.........#
#.........#
#..#......#
#####d#####
key : 1

2
0
#####D#####
##.....#..#
#.........#
#.........#
#......#..#
#.........D
#.........#
##..#..#..#
#.........#
#.........#
#####d#####

3
3
#####d#####
#.........#
#.........#
#.........#
#.........#
#....e....D
#.........#
#.........#
#.........#
#.........#
#####D#####
boss
enemies 1

2
1
#####d#####
#.........#
#.........#
#.........#
#.........#
D.........D
#.........#
#.#.....#.#
#..#...#..#
#.........#
###########

1
2
#####l#####
#e.......e#
#.........#
#.........#
#.........#
D.........D
#.........#
#.........#
#.........#
#e.......?#
#####D#####
enemies 3
door 0 : 0 1
sign A locked path — look elsewhere first.

3
0
#####d#####
###.......#
#?#.#.....#
#...#.....#
#..#@#....#
#....#....#
#.........#
#.........#
#.........#
#.........#
#####D#####
sign Beware what lurks ahead.

4
0
#####D#####
#.........#
#.........#
#.........#
#.........#
#....#....#
#.........#
#.......#.#
#......#..#
#.........#
###########

2
2
#####D#####
#.........#
##.#...#.##
#.........#
#.#.#.#...#
D.........D
#....#.#..#
#.........#
#.#.....#.#
#.........#
###########

1
0
#####D#####
#s........#
#?........#
#....#e#..#
#.....#...#
#e........D
#.........#
#.........#
#.........#
#.........#
#####D#####
enemies 2
switch 0 : 0 1
sign The brave are rewarded.

3
4
#####D#####
#.........#
#.........#
#.........#
#.........#
D.........#
#.........#
#.........#
#.........#
#........X#
###########

0
3
###########
#.........#
#.........#
#.........#
#.........#
D.........#
#.........#
#.........#
#.........#
#.........#
#####d#####

1
3
#####d#####
###e......#
##e#......#
#..###....#
#...##....#
D.........D
#.........#
#.........#
#.........#
#?........#
#####l#####
enemies 2
sign Only the prepared may pass.

2
4
#####D#####
#.........#
#.........#
#.........#
#.........#
D........k#
#.........#
#.#.......#
#..#......#
#.........#
#####D#####
key : 6

