6
0
#####.#####
#.........#
#..#......#
#.....##..#
#....###..#
#..#.#.#..#
#...##....#
#.........#
#s........#
#e?......e#
###########
enemies 2
switch 0 : 0 1
sign The dungeon remembers all who enter.

2
0
#####.#####
#.........#
#.........#
#.........#
#.........#
#?...@.....
#.........#
#.........#
#.........#
#.........#
#####.#####
sign The brave are rewarded.

3
2
#####.#####
#.........#
#.....#...#
#....######
#....###..#
.......#..l
#....#..#.#
#....##...#
#.........#
#.........#
###########

1
3
#####.#####
#.........#
#.........#
#.........#
#.........#
d....e....#
#.........#
#.........#
#.........#
#.........#
#####.#####
boss
enemies 1

2
3
#####.#####
#k........#
##..#..#..#
#.........#
#.........#
....#.....#
#.........#
#.........#
##........#
#.........#
#####.#####
key : 3

2
1
#####.#####
#k........#
#.........#
#.........#
#.........#
...........
#.........#
#.........#
#.........#
#.........#
#####.#####
key : 0

5
1
###########
#........e#
#.....#...#
#......####
#....####?#
.....###..#
#....###..#
#.........#
#.........#
#.........#
###########
enemies 1
door 0 : 0 1
sign Beware what lurks ahead.

1
2
###########
##.#.....##
#.........#
##.#.#.#..#
#.........#
...#...#..d
#.........#
##...#....#
#.........#
##.....#.##
#####d#####

5
0
#####d#####
#.........#
#......#..#
#.......#.#
#.........#
#..........
#.........#
#.........#
#.........#
#.........#
#####.#####

1
0
#####d#####
#.........#
#......#..#
#.......#.#
#.........#
#k........l
#.........#
#.......#.#
#......#..#
#.........#
#####.#####
key : 1

4
0
#####.#####
#.........#
#.........#
#.#.....#.#
#.........#
#.........#
#.#..#....#
#.........#
#.........#
#.#.....#.#
#####d#####

0
1
###########
#.........#
#......#..#
#.......#.#
#.........#
..........#
#.........#
#.......#.#
#......#..#
#.........#
#####l#####
locked : 0

2
2
#####d#####
#.........#
#......#..#
#.......#.#
#.........#
...........
#.........#
#.......#.#
#......#..#
#.........#
#####.#####

3
1
#####.#####
#.........#
#.........#
#.........#
#.........#
...........
#.........#
#.........#
#.........#
#.........#
###########

1
1
#####l#####
#.........#
#...#..#..#
#.......#.#
#.........#
l..........
#.........#
#.........#
#.........#
##.......##
#####.#####
locked : 1

3
0
#####.#####
#.........#
#......#..#
#......k#.#
#......#..#
#..........
#.........#
#........##
#.........#
#.........#
#####.#####
key : 2

0
0
###########
#.........#
#.#...#.#.#
#.........#
#.#.#.#.#.#
#..........
#.#.#.#.#.#
#.........#
#...#.#.#.#
#.........#
#####d#####

3
3
#####.#####
#.........#
#..#...#..#
#.#...#.###
#.........#
l.........#
#.........#
#.........#
#.........#
#.........#
###########
locked : 2

0
3
###########
#X........#
#.........#
#.........#
#.........#
#.........#
#.........#
#.........#
#.........#
#.........#
#####.#####

