4
0
#####l#####
#.........#
#......#..#
#.........#
#.........#
#....@#....
#.........#
#....#....#
#...#.....#
#.........#
#####.#####

0
0
###########
#ee?......#
#e........#
#s........#
#.........#
#..........
#.........#
#.........#
#.........#
#.........#
#####.#####
enemies 3
switch 0 : 0
sign The dungeon remembers all who enter.

1
3
#####.#####
#.........#
#.........#
#..#.#.#..#
#.........#
d..#..#...d
#....#.#..#
#..##.....#
#.........#
#.........#
#####.#####

1
2
###########
##e#e..#..#
#.........#
#....#.#.##
#.........#
...#.#.#..d
#.........#
##.......##
#.........#
#..#...#.##
#####.#####
enemies 2
door 0 : 0

2
3
#####.#####
#.........#
#......#..#
#.......#.#
#.........#
...........
#.........#
#.........#
#.........#
#.........#
###########

5
0
#####.#####
#.........#
##.....#.##
#.........#
#.#...#.#.#
#.........#
#..#...#..#
#.........#
#.#.#.#.#.#
#k........#
###########
key : 0

2
1
#####l#####
#e........#
##.#...#..#
#.........#
#..#.#.#..#
..........d
#..#.#.#..#
#.........#
##.#...#..#
#?........#
#####.#####
enemies 1
sign Only the prepared may pass.

1
0
#####.#####
##........#
#.........#
#.........#
#...#..#..#
#..........
#.........#
##.....#..#
#.........#
#.........#
#####.#####

0
1
###########
#.........#
#.........#
#.........#
#.........#
..........#
#.........#
#.......#.#
#......#..#
#.........#
#####.#####

2
2
#####.#####
#.........#
#.#.#.#...#
#.........#
#.#.#.#.#.#
d..........
#.#.#.#.#.#
#.........#
#.#.#.#.#.#
#.........#
#####.#####

3
2
#####.#####
#.........#
#.........#
#.........#
#.........#
..........#
#.........#
#.........#
#.........#
#........k#
###########
key : 12

3
1
#####.#####
#.........#
#..#...##.#
#.#.....#.#
#.........#
...........
#...#.....#
#.#.#.....#
#..#......#
#.........#
#####d#####

4
1
#####d#####
#.........#
#..#..#...#
#.........#
#.........#
...#......#
#.........#
#.........#
#..#..#..##
#.........#
###########

0
3
###########
#k........#
#..#......#
#..###.#..#
#..####...#
#....#....#
#.........#
#.........#
#.........#
#.........#
#####.#####
key : 8

1
1
#####.#####
#.........#
#..#...#..#
#.#.....#.#
#.........#
...........
#.........#
#.........#
#.........#
#.........#
#####l#####
locked : 1

2
4
#####.#####
#.........#
#.........#
#.........#
#.........#
..........#
#...#.....#
#...##....#
#.........#
#........X#
###########

3
0
#####.#####
#.........#
#.........#
#.##......#
#...#.....#
#..#.......
#.........#
#.........#
#.........#
#.........#
#####l#####
locked : 0

2
0
#####.#####
#.........#
#..#......#
#k#.......#
#.........#
#..#.......
#.......#.#
#.#.......#
#..#......#
#.........#
#####.#####
key : 1

1
4
###########
#.#.......#
#.........#
#.........#
#.........#
d....e....#
#.........#
#.#.......#
#.........#
#.........#
#####.#####
boss
enemies 1

