4
1
#####.#####
#.........#
#......#..#
#.......#.#
#.........#
...........
#.........#
#.#.......#
#..#......#
#.........#
#####d#####

3
1
###########
##e#e.....#
#.........#
#......#.##
#.........#
...#.#.#...
#.........#
##.#......#
#e........#
##.#...#.##
#####.#####
enemies 3

4
4
###########
##........#
#.........#
#.........#
#.........#
...........
#....#....#
#.......#.#
#......#..#
#.........#
#####d#####

1
3
#####.#####
#.........#
#.........#
#.........#
#.........#
#....e....#
#.........#
#.........#
#.........#
#.........#
#####d#####
boss
enemies 1

5
3
#####d#####
#.........#
#.........#
#.........#
#...#.....#
...........
#....#....#
#....##...#
#.....#...#
#.........#
###########

0
3
###########
#X.#...#..#
#..##..#..#
#..###....#
#.#....#..#
#..###.#..#
#.........#
#.........#
#.........#
#.........#
#####.#####

4
0
#####.#####
#.........#
#.........#
#.#..#....#
#.........#
#..........
#.#..#....#
#.........#
#.........#
#.......#.#
#####.#####

5
0
#####.#####
#.........#
#.....#...#
#.........#
#...#...#.#
#..........
#.#.#.#...#
#.........#
#.#.....#.#
#.........#
###########

5
2
#####.#####
#k........#
##.#...#.##
#.........#
#....#.#..#
...........
#..#...#..#
#.........#
##.#...#.##
#.........#
###########
key : 2

5
4
#####d#####
#.........#
#.#.....#.#
#.........#
#.........#
......#...#
#.........#
#.........#
#.#.......#
#.........#
###########

4
5
###########
##.#...#k##
#.........#
#.#...#.#.#
#.........#
...#.#.#..#
#.........#
#.#.#.#.#.#
#.........#
##.#...#.##
###########
key : 3

2
0
###########
#e......ee#
#...#.#.#.#
#...###...#
#....#.#..#
#....#....#
#.........#
#.........#
#.........#
#.........#
#####.#####
enemies 3

3
0
#####.#####
#.........#
#......#..#
#....#..#.#
#...@.#.#.#
#....###...
#.....#...#
#..#......#
#.#.......#
#.........#
#####.#####

4
2
#####.#####
#k........#
#.........#
#..#..#...#
#.........#
..........l
#..#..#...#
#.........#
#.........#
#........##
#####.#####
key : 1

5
1
#####d#####
#.........#
#.#...#.#.#
#.........#
#...#.#.#.#
...........
#.#.#.#.#.#
#.........#
#.#.#.#.#.#
#.........#
###########

3
3
#####.#####
#.........#
#.........#
#.........#
#.........#
...##.##..#
#.######..#
#..##.#...#
#..#..##..#
#......#..#
#####l#####
locked : 2

2
3
#####d#####
#.........#
#.........#
#...#####.#
#...###e#.#
#.....#...#
#...##.#..#
#....#....#
#.........#
#.........#
#####.#####
enemies 1

4
3
#####l#####
#.........#
#.........#
#.........#
#.........#
l..........
#.........#
#.........#
#.........#
#.........#
#####d#####
locked : 1

3
2
###########
#.........#
#.....#...#
#......#..#
#.........#
....####...
#...k###..#
#...##.#..#
#.........#
#..#......#
#####.#####
key : 0

