2
3
#####d#####
#.........#
#...#.....#
##........#
#.........#
...........
#.........#
#.........#
#.........#
#.......#.#
#####.#####

4
3
#####d#####
#.........#
#.........#
#.........#
#.........#
#....e....#
#.........#
#.........#
#.........#
#.........#
#####.#####
boss
enemies 1

2
1
#####l#####
#k........#
#..#......#
#.#.......#
#.........#
...........
#.........#
#.........#
#.........#
#.........#
#####d#####
key : 1

1
3
#####.#####
#e.......?#
#.........#
#.........#
#.#.......#
..........d
#.........#
#.........#
#.........#
#s........#
#####d#####
enemies 1
switch 0 : 0 1
sign Turn back; you are not yet ready.

3
0
#####.#####
#.........#
#......#..#
#.......#.#
#.........#
#..........
#.........#
#.#.....#.#
#..#...#..#
#.........#
###########

1
4
###########
##.....#..#
#.........#
#.#.#.#...#
#.........#
d..#.#.#..#
#.........#
#.#...#.#.#
#.........#
##.....#.##
#####.#####

3
4
#####.#####
#.#.......#
#.#.......#
#.#.###...#
#..#......#
....#.....#
#.....#...#
#....##...#
#.........#
#.......?e#
###########
enemies 1
door 0 : 0 1
sign Something glints behind that door…

5
3
#####.#####
#.........#
#.........#
#.........#
#..#.#....#
#..##.....#
#..##.....#
#.........#
#.........#
#X........#
###########

2
0
#####.#####
#.........#
#.......#.#
#.........#
#.....#...#
#....@#....
#......##.#
#.........#
#.........#
#.........#
#####.#####

0
1
###########
#.........#
#..#......#
#.#.....#.#
#.........#
#....#....#
#.........#
#.........#
#.#.......#
#.........#
#####.#####

2
4
#####.#####
#.........#
#.........#
#.........#
#.##......#
..........#
#.........#
#.#.....#.#
#..#...#..#
#.........#
#####.#####

3
1
#####d#####
#.........#
#.........#
#.#.......#
#....#....#
...#.......
#..#......#
#.........#
#.........#
#..#......#
###########

3
2
#####.#####
#........##
#..#......#
#.#.......#
#.........#
...........
#.........#
#..#....#.#
#......#..#
#......k..#
###########
key : 2

3
3
#####.#####
#.......#k#
#.........#
#.........#
#....#..#.#
...........
#.........#
#.#..#....#
#.........#
#.........#
#####d#####
key : 3

2
2
#####.#####
#e........#
#.........#
#.........#
#.........#
...........
#.........#
#.........#
#.........#
#?........#
#####.#####
enemies 1
sign This door will not yield without a key.

1
0
###########
#k........#
##.#...#.##
#.........#
#......#..#
#..........
#..#.#....#
#.........#
##.....#.##
#.........#
#####.#####
key : 0

1
2
###########
#.........#
##.......##
#.........#
#.#...#.#.#
l..........
#..#.#.#..#
#.........#
#.#.....#.#
#.........#
#####.#####
locked : 0

0
3
###########
#.........#
#..#......#
#.#.......#
#.........#
#.........#
#.........#
#.........#
#.........#
#.........#
#####.#####

1
1
#####.#####
#.........#
#..#......#
#.#.......#
#.........#
..........l
#.........#
#.........#
#.........#
#.........#
#####l#####
locked : 1

