0
1
###########
#......##.#
#...#.....#
#....#.#..#
#...###...#
D.........#
#.........#
#.........#
#.........#
#.........#
#####D#####

2
1
#####D#####
##.....#.##
#.........#
#.#...#...#
#.........#
D..#.#....D
#.........#
#.....#.#.#
#.........#
#..#...#.##
#####D#####

2
3
#####D#####
#.........#
#......#..#
#.......#.#
#.........#
D.........D
#.........#
#.........#
#.........#
#....k....#
###########
key : 3

1
4
#####l#####
#.........#
#.........#
#.........#
#.........#
l.........d
#.........#
#.........#
#.........#
#.........#
#####D#####
locked : 3

2
2
#####D#####
#?........#
#...#.#...#
#...#e#...#
#....##...#
D.........D
#.........#
#.........#
#.........#
#....e....#
###########
enemies 2
sign Something glints behind that door…

0
3
###########
#.........#
#.........#
#.........#
#...##.#..#
#..#####..D
#..###.#p.#
#.##.#....#
#......#..#
#.........#
#####d#####

2
0
#####D#####
#.........#
#..#..#...#
#.#.......#
#.........#
#.........D
#......#..#
#.........#
#.........#
#k........#
###########
key : 0

1
3
#####d#####
#.........#
#.........#
#.........#
#.........#
l.........l
#.........#
#.......#.#
#......#..#
#.........#
#####D#####
locked : 0

3
1
#####D#####
#.........#
#..#.....##
#.........#
#.........#
#...#.....#
#.........#
#.........#
#..#.....##
#?.......e#
###########
enemies 1
sign Many have walked this path.

1
0
#####d#####
#.........#
#.........#
#.........#
#?#..#....#
#..##@....D
#...##....#
#.........#
#.........#
#.........#
#####D#####
sign Something glints behind that door…

1
6
###########
#.........#
#...#..#..#
#.....##..#
#...#.#...#
l...#e.#..#
#...#.##..#
#.........#
#.........#
#.........#
#####D#####
locked : 1
boss
enemies 1

1
2
###########
##k#...#.##
#.........#
#...#...#.#
#.........#
D....#.#..l
#.........#
#.#.#.#...#
#.........#
##.#...#.##
#####D#####
key : 1

2
5
#####D#####
#......##.#
#.......#.#
#.....#.#.#
#.........#
D....#....D
#....###..#
#.....#...#
#.....##..#
#.....e##.#
###########
enemies 1

1
1
#####D#####
#.........#
#..##.##.##
#..###....#
#..##.###.#
D.....##..D
#..###....#
#.........#
#.........#
#.........#
#####D#####

0
0
###########
#.........#
#.........#
#..#..#..##
#.........#
#.........D
#..#..#...#
#.........#
#.........#
#..#.....##
#####d#####

2
4
#####D#####
#k#.......#
#......#..#
#.......#.#
#......#..#
D.........D
#.........#
#.#.......#
#.........#
#.........#
###########
key : 5

2
6
#####D#####
#.........#
#.........#
#.........#
#.........#
D.........#
#.........#
#.........#
#.........#
#........X#
###########

1
5
###########
####......#
#####.....#
####......#
#.##......#
d.........l
#.........#
#.........#
#.........#
#.........#
#####D#####

0
4
###########
#.........#
#.........#
#.#..#..#.#
#.........#
D.........#
#.#..#..#.#
#.........#
#.........#
#.#.......#
#####l#####
locked : 5

