4
2
#####D#####
#s........#
#.#.....#.#
#.........#
#.........#
D.........D
#.........#
#.........#
#.#.....#.#
#.e..e..e.#
###########
enemies 3
switch 0 : 0

2
4
###########
#........k#
##.#...#.##
#.........#
#...#...#.#
D.........#
#....#.#..#
#.........#
#.#.....#.#
#.........#
#####D#####
key : 8

1
1
###########
#........k#
#.........#
#......#..#
#.........#
D.........#
#.........#
#.#.....#.#
#..#...#..#
#.........#
#####D#####
key : 2

2
3
#####D#####
#.........#
#.........#
#.........#
#.........#
D....e....D
#.........#
#.........#
#.........#
#.........#
#####d#####
boss
enemies 1

3
0
#####D#####
#.......#.#
#...#...#.#
#......##.#
#...@####.#
#...##.#..d
#.........#
#.........#
#.........#
#.........#
#####D#####

5
1
#####l#####
#.........#
#.........#
#.........#
#.........#
#.........#
#.........#
#.#.......#
#..#......#
#.........#
###########
locked : 2

4
1
#####D#####
#.......#.#
#..#......#
#.#.......#
#.........#
D.........D
#.........#
#.#.......#
#..#......#
#.........#
#####l#####

3
4
#####D#####
#.........#
#.........#
#.........#
#.........#
D.........#
#.........#
#.........#
#.........#
#.........#
###########

2
0
#####D#####
#.#.....#.#
#.........#
#....#...##
#.........#
#...#.....D
#.........#
#..#.#.#.##
#.........#
#.#.....#.#
#####D#####

4
3
#####D#####
#.......#.#
#...#.#...#
#...##..#.#
#...#..#..#
D.....##..#
#.....###e#
#.........#
#.........#
#.......ee#
###########
enemies 3
door 0 : 0

3
2
#####D#####
#.........#
##.#...#.##
#.........#
#..#.#.#..#
l.........d
#..#.#.#..#
#.........#
##.......##
#.........#
#####D#####
locked : 0

1
3
###########
#X........#
#.........#
#.....##..#
#....##...#
#....###..#
#.........#
#.........#
#.........#
#.........#
#####D#####

2
1
#####D#####
#k........#
#...#.#.#.#
#.........#
#.#.#.#...#
D.........d
#.#...#...#
#.........#
#...#.#...#
#.........#
#####D#####
key : 1

2
2
###########
#.........#
#.###.#...#
#.#.......#
#.####....#
d....##...D
#.####....#
#.........#
#..#......#
#........##
#####D#####

4
0
#####D#####
#.........#
#......#..#
#.......#.#
#.........#
#.........D
#.........#
#.......#.#
#......#..#
#.........#
###########

1
0
#####l#####
#k#.....#.#
#.........#
#.........#
#..#..#...#
#.........D
#.........#
#.#.......#
#.........#
#.........#
#####D#####
key : 0

0
0
###########
#.........#
#.........#
#.....#...#
#.........#
#.........#
#...#.....#
#.........#
#.........#
#........##
#####l#####
locked : 1

3
3
#####d#####
#.........#
#......#..#
#.......#.#
#.........#
d.........D
#.........#
#.#.......#
#..#......#
#.........#
#####D#####

3
1
#####D#####
#.........#
#.........#
#.........#
#.........#
d.........l
#.........#
#.........#
#.........#
#.........#
#####D#####

