0
4
###########
#.......#X#
#.........#
#.........#
#.........#
D.........#
#.........#
#.........#
#..#......#
#.........#
#####D#####

3
0
#####D#####
#.........#
#......#..#
#.......#.#
#.........#
#.........D
#.........#
#k#.......#
#..#......#
#..#.....##
#####D#####
key : 0

1
1
###########
#....k....#
#.........#
#.........#
#...#pp...#
D...###...D
#.........#
#.........#
#.........#
#.........#
#####D#####
key : 2

3
1
#####D#####
#.........#
#......#.##
#.......#.#
#.........#
D.........D
#.........#
#.........#
#.........#
#.......#.#
###########

0
3
###########
#.........#
#.........#
#.........#
#.........#
#..##.....D
#....#....#
###.##....#
#..##.....#
#.........#
#####D#####

3
4
#####D#####
#.........#
#......#..#
#.......#.#
#.........#
D.........#
#.........#
#.......#.#
#......#..#
#........k#
###########
key : 4

4
2
#####D#####
#.........#
##..#..#..#
#.........#
#.........#
#....#....#
#.........#
#.........#
##.....#..#
#.........#
###########

2
3
#####d#####
#.........#
#.........#
#.........#
#.........#
l.........d
#.........#
#.........#
#.........#
#.........#
#####D#####
locked : 4

1
2
###########
#.........#
#.#...#.#.#
#.........#
#.#...#...#
D.........D
#.#.#.#...#
#.........#
#...#.#.#.#
#.........#
#####D#####

1
4
#####D#####
#.........#
#.........#
#...##....#
#..###....#
D..#e#....#
#.........#
#.........#
#.........#
#.........#
#####d#####
boss
enemies 1

2
4
#####d#####
#.........#
#.........#
#..#..#..##
#.........#
d.........#
#..#..#...#
#.........#
#.........#
#..#.....##
#####D#####

2
2
#####D#####
#.........#
#..#...#..#
#.#.....#.#
#.........#
D.........l
#.........#
#.#.....#.#
#..#...#..#
#.........#
#####d#####

2
1
#####D#####
#?........#
#.........#
#.....##e##
#......##.#
D......#..D
#......##.#
#....######
#.........#
#.........#
#####D#####
enemies 1
sign The brave are rewarded.

1
3
#####D#####
#.........#
#.........#
#.........#
#.........#
D.........D
#.........#
#.........#
#.........#
#.........#
#####d#####

1
0
###########
#.........#
#####.....#
#######...#
#..#......#
#.........D
#.........#
#.........#
#.........#
#.........#
#####l#####
locked : 0

3
2
#####d#####
#.........#
#.........#
#.........#
#.........#
D.........D
#.........#
#.#.....#.#
#..#...#..#
#.........#
#####D#####

3
3
#####D#####
#k........#
##..#..#..#
#.........#
#.........#
D...#..#..D
#.........#
#.........#
##.....#..#
#.........#
###########
key : 3

2
0
#####l#####
#e........#
#.........#
#.....#...#
#.........#
#e........D
#..#......#
#.........#
#.........#
#..#.....##
#####D#####
enemies 2

4
0
#####D#####
#.........#
#.....p...#
#..#.#....#
#...#.....#
#...@#....#
#...#.....#
###.......#
##..#.....#
####....p.#
###########

