3
2
#####.#####
#.........#
#.........#
#.........#
#.........#
d..........
#.........#
#.......#.#
#......#..#
#.........#
#####d#####

3
0
#####.#####
#.........#
#.........#
#.........#
#.........#
#..........
#.........#
#.........#
#.........#
#.........#
#####.#####

3
1
#####d#####
#.........#
#..#......#
#.#.......#
#.........#
..........d
#.........#
#.......#.#
#......#..#
#.........#
#####l#####

1
1
#####d#####
#k........#
#.........#
#..#......#
#......#..#
...........
#.........#
#.#...#...#
#..#......#
#.........#
#####.#####
key : 0

0
2
###########
#........k#
#.........#
#.........#
#.........#
..........#
#.........#
#.........#
#.........#
#.........#
#####.#####
key : 3

4
1
#####l#####
#.........#
#.........#
#.........#
#......##.#
...........
#....####.#
#........##
#.........#
#.........#
###########
locked : 0

1
2
#####.#####
#.........#
#.........#
#.....#####
#.........#
......##...
#.....#...#
#....##..##
#...#.....#
#.........#
#####.#####

3
3
###########
#.........#
#.........#
#.....#...#
#....##...#
.....##...l
#...##k#..#
#...##....#
#.........#
#.........#
###########
key : 2

0
1
###########
#.........#
#..#......#
#.#.......#
#.........#
#..........
#.........#
#.#.......#
#..#......#
#.........#
#####d#####

2
2
#####.#####
##.#...#.##
#........e#
##.#.#.#.##
#........e#
...#.#.#..#
#........?#
##.#.#...##
#........e#
#......#.##
#####.#####
enemies 3
sign Beware what lurks ahead.

4
4
#####.#####
#.........#
#.........#
#.........#
#.........#
#.........#
#.........#
##........#
#.........#
#X........#
###########

1
4
###########
#.........#
#..#..#..##
#.........#
#.........#
....#..#..#
#.........#
#.........#
#..#.....##
#.........#
###########

2
1
#####.#####
#.........#
#..#......#
#.#.......#
#.........#
...........
#.........#
#.........#
#.........#
#.........#
#####d#####

3
4
###########
#.........#
#......#..#
#..####...#
#..#.###..#
l..#.e##..#
#..#...#..#
#.........#
#.........#
#.........#
#####.#####
locked : 4
boss
enemies 1

1
3
###########
#.........#
#.........#
#.........#
#.........#
...........
#.........#
#.#.....#.#
#..#...#..#
#..k......#
###########
key : 4

1
0
###########
#.........#
#.........#
##..#..#..#
#.........#
#..........
#...#..#..#
#.........#
#.........#
##.....#..#
#####.#####

2
0
#####.#####
#.........#
#.........#
#.........#
#.........#
#?...@.....
#...#.....#
#.........#
#.........#
#.........#
#####.#####
sign The dungeon remembers all who enter.

4
2
#####d#####
#.........#
#.........#
##..#..#..#
#.........#
..........#
#.......#.#
#.........#
#.........#
##........#
###########

4
0
#####.#####
#......#..#
#...#.#...#
#...###.#.#
#...##.##.#
#...#..#...
#.........#
#.........#
#.........#
#e........#
###########
enemies 1

