3
5
#####.#####
#.........#
#..#...#..#
#.#.....#.#
#.........#
...........
#.........#
#.......#.#
#......#..#
#......k..#
###########
key : 3

1
2
###########
#.........#
#.........#
#.........#
#.#..#..#.#
...........
#.........#
##..#..#..#
#.........#
#.........#
#####.#####

0
1
###########
#.........#
#..#......#
#.#.......#
#.........#
..........#
#.........#
#.......#.#
#......#..#
#.........#
#####.#####

2
3
#####d#####
#k........#
#.........#
#.........#
#.........#
...........
#.........#
#.#.......#
#..#......#
#.........#
#####.#####
key : 0

3
3
#####.#####
#.........#
#.........#
##..#..#..#
#.........#
#.........d
#....#....#
#.........#
#k........#
##........#
###########
key : 1

1
3
###########
#.........#
#.........#
#.........#
#....#..#.#
...........
#.....#...#
#..#.#.##.#
#.........#
#.........#
#####d#####

3
4
#####.#####
#.........#
#.#.......#
##........#
#.........#
d..........
#.........#
#.........#
#.........#
#.........#
###########

1
5
#####.#####
#.........#
#..#..##..#
#....#.#..#
#...#.....#
.....e....#
#.........#
#.........#
#.........#
#.........#
#####l#####
locked : 2
boss
enemies 1

0
5
###########
#X........#
#.........#
#.........#
#.##......#
#..##.....#
#.........#
#.........#
#.........#
#.........#
#####.#####

2
4
#####l#####
#k#.....#.#
#.........#
#....#.#.##
#.........#
....#......
#.........#
#..#.#.#.##
#.........#
#.......#.#
#####.#####
key : 2

1
4
###########
#.........#
#.........#
#.........#
#.........#
...........
#.........#
#.........#
#.........#
#.........#
#####l#####
locked : 0

2
6
###########
#.........#
#.........#
#.#.....#.#
#.........#
d.........#
#.#..#..#.#
#.........#
#.........#
#.#.....#.#
#####.#####

0
0
###########
#.........#
#.........#
#.........#
#.........#
#..........
#.........#
#.........#
#.........#
#.........#
#####d#####

1
0
#####d#####
#.........#
#.........#
#.........#
#.........#
#....@.....
#.##......#
#...#.....#
#.##......#
#?........#
###########
sign Many have walked this path.

3
6
#####.#####
#.#.....#.#
#.........#
#.#.#.#...#
#.........#
....#.#...#
#.........#
#.#.#.#.#?#
#.......e.#
#......e#e#
###########
enemies 3
door 0 : 0 1
sign Something glints behind that door…

2
1
#####.#####
#......#..#
#.........#
#.........#
#...#..#..#
#..........
#s........#
##..#..#..#
#e........#
#e........#
###########
enemies 2
switch 0 : 0 1

2
2
#####.#####
#.......#.#
#.........#
#.........#
#.....#...#
...........
#.........#
#....#..#.#
#.........#
#.........#
###########

2
5
#####l#####
#e.......?#
##.#.....##
#.........#
#.#.#.#.#.#
..........d
#......#..#
#.........#
#.#.#.#.#.#
#.........#
#####.#####
enemies 1
sign Only the prepared may pass.

1
1
#####.#####
#.........#
#.........#
#.........#
#.........#
...........
#.........#
#.#.....#.#
#..#...#..#
#.........#
#####.#####

