2
0
###########
#.........#
##..#..#..#
#.........#
#.........#
#...#..#..D
#.........#
#.........#
##.....#..#
#.........#
#####d#####

2
3
#####D#####
##........#
###.#.....#
#.#s#.....#
#..#......#
D..#.#....d
#.#.......#
###.##....#
####......#
#e........#
#####d#####
enemies 1
switch 0 : 0 1

1
1
###########
#.........#
#..#......#
#.#.......#
#.........#
#.........D
#.........#
#.........#
#.........#
#.........#
#####D#####

2
1
#####D#####
#k........#
#.........#
#.........#
#.........#
D.........d
#.........#
#.........#
#.........#
#.........#
#####D#####
key : 0

0
2
###########
####e...?e#
#####.....#
######....#
#e##......#
#....#....#
#.........#
#.........#
#.........#
#.........#
#####D#####
enemies 3
door 0 : 0 1
sign Something glints behind that door…

4
0
#####D#####
#.........#
#..#...#..#
#.#.....#.#
#.........#
#.........D
#.........#
#.#.....#.#
#..#...#..#
#.........#
###########

4
3
#####D#####
#.........#
#.........#
#.........#
#.....#...#
D..#.###..D
#.#..#....#
##.##..#..#
#.....#...#
##....k...#
###########
key : 5

1
3
###########
#........k#
#.........#
#.........#
#.........#
D..###....#
#.##.#....#
#.........#
#####.....#
####......#
#####D#####
key : 2

1
2
#####D#####
#.........#
#.........#
#.#.#p....#
#...#kp...#
D...#.....D
#.........#
#.........#
#.........#
#.........#
#####D#####
key : 1

3
2
#####D#####
#e........#
##..#.....#
##........#
#e#.......#
D...#.....D
#.#.......#
#.........#
#.........#
#e........#
#####D#####
enemies 3

3
4
#####D#####
#.........#
#.........#
#.........#
#.........#
l....e....#
#.........#
#.........#
#.p.......#
#.........#
#####D#####
locked : 1
boss
enemies 1

3
0
#####d#####
#.........#
#.........#
#.........#
#.........#
#....@....D
#...#.#...#
#....##...#
#...#.#...#
#.........#
#####D#####

3
3
#####d#####
#.........#
#.........#
#.........#
#.........#
D.........l
#.........#
#.#.......#
#..#......#
#.........#
#####D#####

4
4
#####D#####
#p........#
#.........#
#...##....#
#..####...#
D..###....#
#.#.#.#...#
#.#.#.....#
#......p..#
#........X#
###########

2
4
###########
#.........#
#p........#
#p........#
#.........#
d.........#
#.........#
#.........#
#.........#
#.........#
#####D#####

4
1
#####D#####
#.#.......#
#..#......#
#.#.......#
#.........#
D.........D
#.......#.#
#.......#.#
#......#..#
##........#
###########

2
2
#####D#####
#.........#
#.#...#.#.#
#.........#
#..#.#....#
d.........D
#.#.#.#...#
#.........#
#........##
#.........#
#####D#####

4
2
#####D#####
#.........#
#.........#
#....#..#.#
#.........#
D.........D
#.#.......#
#.........#
#.........#
#.......#.#
###########

3
1
#####D#####
#.........#
#.........#
#.........#
#.####....#
D....#....D
#.#####...#
#######...#
##..#.#...#
#.........#
#####D#####

