1
1
###########
#?...e....#
#.........#
#.........#
#.........#
...........
#.........#
#.........#
#.........#
#.........#
#####.#####
enemies 1
sign Turn back; you are not yet ready.

3
2
#####.#####
#e#.....#.#
#.........#
#..#.#.#.##
#.........#
...........
#.........#
#....#...##
#.........#
#e#.....#.#
#####d#####
enemies 2

2
1
#####.#####
#.........#
#......#.##
#.......#.#
#.........#
l......#...
#.........#
#.........#
#.........#
#.........#
#####.#####
locked : 1

1
2
###########
##.#.....##
#.........#
#.#.#...#.#
#.........#
.....#.#...
#.........#
#...#.#...#
#.........#
##.#...#.##
#####d#####

2
0
#####.#####
#.........#
#.........#
#.........#
#.........#
#.........l
#.........#
#.........#
#.........#
#.........#
#####d#####

4
1
#####.#####
#.........#
#.........#
#.........#
#.........#
...........
#.........#
#.........#
#.........#
#....k....#
###########
key : 0

2
2
#####d#####
#.........#
#.........#
#.........#
#.........#
....##.#...
#.#.##..#.#
#....####.#
#...#.#.#.#
#.......#k#
#####.#####
key : 3

1
0
#####.#####
#..#......#
#..##.....#
#..##.....#
#.........#
#k.........
#...##....#
#...###...#
#.....#...#
#.........#
#####.#####
key : 1

2
3
#####d#####
#.........#
#..#...#..#
#.#.#...#.#
#.........#
...........
#.........#
###.......#
##.#......#
#.........#
#####.#####

2
4
###########
#.........#
##.#.....##
#.........#
#.#.#.#.#.#
..........#
#..#.#.#..#
#.........#
#.#.#.#...#
#.........#
###########

3
1
#####.#####
#?........#
#.........#
#.#..#..#.#
#.........#
...........
#.....#...#
#.........#
#.........#
#e#.....#e#
#####.#####
enemies 2
sign This door will not yield without a key.

0
3
###########
#X........#
#..##.#...#
#..###....#
#.#####...#
#.........#
#.........#
#.........#
#.........#
#.........#
#####.#####

0
0
###########
#.........#
#......#..#
#.......#.#
#.........#
#.........#
#.........#
#.........#
#.........#
#.........#
#####.#####

3
3
#####.#####
#..#......#
#...#.#.#.#
#.....#...#
#...####..#
...##.##..#
#...#.#.#.#
###.#.....#
#.#.......#
#........k#
###########
key : 4

4
2
#####d#####
#.........#
#..#......#
#.#.......#
#.........#
..........#
#.........#
#.#.....#.#
#..#...#..#
#.........#
###########

5
0
#####l#####
#.........#
#.........#
#.........#
#.........#
#.........#
#.........#
#.......#.#
#......#..#
#.........#
###########
locked : 0

1
3
#####.#####
#.........#
#......##.#
#......#..#
#.....##..#
.....e....#
#.........#
#.........#
#.........#
#.........#
#####d#####
boss
enemies 1

4
0
#####.#####
#.........#
#.........#
#.........#
#.........#
#?...@.....
#.........#
#.........#
#.........#
#.........#
#####l#####
sign A locked path — look elsewhere first.

3
0
#####d#####
#.#.....#.#
#.........#
#.#.#.#.#.#
#.........#
#...#.#....
#.........#
#.#...#...#
#.........#
#.......#.#
#####.#####

