2
4
#####D#####
#......#..#
#.........#
#.........#
#.#..#..#.#
d.........#
#.........#
#......#..#
#.........#
#.........#
#####D#####

1
2
###########
#e...e....#
#.........#
#.........#
#.........#
D.........d
#.........#
#.........#
#.........#
#s........#
#####D#####
enemies 2
switch 0 : 0

7
1
#####D#####
#.........#
#..##...#.#
#...##.#..#
#..#.#....#
#..#.###..#
#..#..#...#
#.........#
##........#
#X........#
###########

1
0
#####D#####
#.........#
#.....##..#
#....#.#..#
#...@...#.#
#...###...D
#...####..#
#.........#
#.........#
#.........#
#####D#####

2
3
#####D#####
#.........#
#......#..#
#......##.#
#.........#
l.........d
#.#.......#
#.......#.#
#..#...#..#
#.........#
#####D#####
locked : 1

5
1
#####D#####
#.........#
#.........#
#.........#
#.........#
#e........#
#....#e#..#
#.....#e..#
#......#..#
#.........#
#####d#####
enemies 3

3
4
#####D#####
#.........#
#.........#
#.........#
#.........#
D.........#
#.........#
#.........#
#.........#
#........k#
###########
key : 4

1
1
###########
#.........#
#......#..#
#.......#.#
#.........#
D.........D
#.........#
#.#.....#.#
#..#...#..#
#........##
###########

3
1
###########
#.........#
#.......#.#
#.........#
#.........#
d.........D
#.........#
#.#.....#.#
#..#...#..#
#.........#
#####D#####

2
0
#####D#####
#.........#
#.........#
#.........#
#.........#
#.........#
#.........#
#k#.......#
#..#......#
#.........#
#####D#####
key : 0

3
2
#####D#####
#.........#
#.........#
##..#..#..#
#.........#
D.........D
#...#..#..#
#.........#
#.........#
##.....#..#
###########

6
1
#####d#####
#..#......#
#.........#
#.....###.#
#.....##..#
#....e....#
#.....###.#
#.....##..#
#.........#
#.........#
#####D#####
boss
enemies 1

1
3
###########
#.........#
#......#..#
#.......#.#
#.....#...#
d......#..D
#.........#
#.#.......#
#..#......#
#.........#
#####D#####

0
0
###########
#.........#
#.........#
#.........#
#.........#
#....p....#
#.........#
#.........#
#.........#
#.........#
#####D#####

1
4
###########
#.......ee#
#.........#
#.........#
#.........#
D.........#
#.........#
#.........#
#.........#
#.........#
#####D#####
enemies 2

3
3
#####D#####
#.........#
#p........#
#.........#
#.##......#
D..###....D
#..####...#
#...##e...#
#.#...#...#
#.........#
###########
enemies 1
door 0 : 0

3
0
#####D#####
#.......#.#
#.........#
#.........#
#.........#
#.........d
#.........#
#.#..#..#.#
#.........#
#k........#
###########
key : 1

4
1
#####D#####
#k........#
##.#.....##
#.........#
#.#.#.#...#
#.........#
#..#.#.#..#
#.........#
#.#.....#.#
#.........#
#####D#####
key : 2

2
2
#####D#####
#.........#
#.p.......#
#.........#
#.....#.#.#
#....###..l
#....###..#
#.....#.#.#
#.....#.###
#.........#
#####D#####

