6
0
#####.#####
#.........#
#.........#
#.........#
#.........#
#..........
#.........#
#.#.....#.#
#..#...#..#
#k........#
###########
key : 1

7
1
#####.#####
#.........#
#.....###.#
#....#....#
#.........#
#.........#
#.........#
#.........#
#.........#
#e......#e#
###########
enemies 2

6
2
###########
#.........#
###.#.....#
###.###...#
#...###...#
d..##.....#
#...####..#
#.....#...#
#......#..#
#.........#
###########

1
3
#####.#####
#.........#
#..#...#..#
#.#.....#.#
#.........#
d.........#
#.........#
#.........#
#.........#
#.........#
#####d#####

4
0
#####d#####
#.........#
#.........#
#.........#
#.....#...#
#?..#@.....
#.....#...#
#.........#
#.........#
#.........#
#####.#####
sign You feel a chill that has nothing to do with the cold.

4
1
#####.#####
#.........#
#.........#
#.........#
#.........#
..........#
#.........#
#.........#
#.........#
#.........#
#####.#####

5
1
#####.#####
#.........#
#.........#
#.........#
#.........#
..........#
#.##......#
#.###.....#
#..##.....#
####......#
#####.#####

6
1
#####.#####
#e.#...#e##
#.........#
#.#s#.#.#.#
#.........#
...#.#....d
#.........#
#.#?#.#.#.#
#.........#
#e.#.....##
#####.#####
enemies 3
switch 0 : 0 1
sign Those who search shall find.

1
2
#####.#####
#k........#
#.........#
#.........#
#.........#
..........d
#.........#
#.........#
#.........#
#.........#
#####.#####
key : 3

2
1
#####l#####
#.........#
#.........#
#..#..#..##
#.........#
#..........
#......#..#
#.........#
#.........#
#........##
#####l#####
locked : 1

3
0
###########
##.....#.##
#.........#
#.#...#.#.#
#.........#
#..#...#...
#.........#
#.#.#.#.#.#
#.........#
##.#.....##
#####d#####

0
2
###########
#e#e....#.#
#e........#
#?..#.#.#.#
#.........#
#...#......
#.........#
#.....#...#
#.........#
#.......#.#
#####.#####
enemies 3
door 0 : 0 1
sign Something glints behind that door…

5
0
#####.#####
#.........#
#.........#
#..#..#..##
#.........#
#k.........
#..#..#...#
#.........#
#.........#
#..#.....##
#####.#####
key : 0

2
3
#####d#####
#.........#
#.........#
#.........#
#.....##..#
.....e.#..#
#....#....#
#.........#
#.........#
#.........#
#####.#####
boss
enemies 1

3
1
#####l#####
#..#.....##
#.........#
#.#.#.#...#
#.........#
.....#.#..#
#.........#
#...#.#...#
#.........#
##.#...#..#
#####.#####

1
1
###########
#.........#
#.........#
#.........#
#..##.....#
#..#.......
#.###.....#
#..##.....#
#.........#
#.........#
#####l#####
locked : 0

2
2
#####.#####
#.#.....#.#
#.........#
#...#.#.#.#
#.........#
....#.#....
#.........#
#.....#...#
#.........#
#.......#.#
###########

0
3
###########
#........k#
#..#......#
#.#.......#
#..#......#
.......#..#
#.........#
#.......#.#
#......#..#
#.#.......#
#####.#####
key : 6

3
3
#####.#####
#.........#
#.........#
#.....#.#.#
#.........#
#......#..#
#.........#
#.........#
#.........#
#X........#
###########

