2
3
###########
#........X#
#......##.#
##..###.#.#
#...#.#...#
D.....##..#
#...###...#
#.........#
#.........#
#.........#
#####D#####

4
0
#####D#####
#.......p.#
#.........#
#.........#
#?#.#.....#
#...@###..d
#.##.##...#
#...####..#
#.#.#.#...#
#.........#
#####D#####
sign Beware what lurks ahead.

1
2
###########
#........k#
#.........#
#.........#
#.........#
D.........#
#.........#
#.........#
#.........#
#.........#
#####D#####
key : 4

3
2
#####D#####
#.........#
#......#..#
#.......#.#
#.........#
D.........D
#.........#
#.#.......#
#..#......#
#..k......#
###########
key : 5

6
1
#####D#####
#e........#
#.........#
#.........#
#.........#
D........e#
#.........#
#.........#
#.........#
#e........#
#####D#####
enemies 3

1
1
###########
#.........#
#.........#
#......####
#.....##..#
D....###..D
#....#k#..#
#......#.##
#.........#
#.........#
#####D#####
key : 2

5
1
#####D#####
#.........#
#......#..#
#.......#.#
#.........#
D.........#
#.........#
#.........#
#...#.....#
#.........#
#####D#####

3
0
#####D#####
#.........#
#..#...#..#
#.#.....#.#
#.........#
#.........d
#.........#
#.........#
#.........#
#.........#
#####D#####

5
0
#####D#####
#.........#
#.........#
##........#
#.........#
#.........D
#....#....#
#.........#
#.........#
#.........#
#####d#####

2
1
#####D#####
#e##......#
#.#.#.#...#
#...#.#...#
#..##.#...#
D.........d
#.........#
#.........#
#.........#
#.........#
#####D#####
enemies 1

2
2
#####D#####
#.........#
#.........#
#.........#
#.........#
d....e....D
#.........#
#.........#
#.........#
#.........#
#####D#####
boss
enemies 1

3
1
#####D#####
#.........#
#.........#
#.........#
#.........#
d.........D
#.........#
#.........#
#.........#
#.........#
#####D#####

3
3
#####D#####
#.........#
#.#...#.#.#
#.........#
#...#.#.#.#
D.........#
#.#.#.#.#.#
#.........#
#.#.#.#.#.#
#.......ee#
###########
enemies 2

0
0
###########
#k........#
#......#..#
#...#...#.#
#.........#
#.........#
#.........#
#.........#
#.........#
#.......#.#
#####D#####
key : 3

7
1
#####D#####
#.........#
#.........#
#.........#
#.........#
#.........#
#.........#
#.........#
#.........#
#.........#
###########

2
0
#####D#####
#.........#
#.........#
#e#..#..#.#
#.........#
#e........D
#..#..#...#
#.........#
#.........#
#e#.......#
#####D#####
enemies 3

1
0
#####D#####
#.........#
#.#.#.....#
#.........#
#.........#
#.........D
#.........#
#.........#
#.........#
#.........#
#####D#####

4
1
#####D#####
#.#.......#
#.........#
#.........#
#.........#
d.....#...#
#....#....#
#.#.......#
#..#......#
#.........#
#####D#####

6
0
#####d#####
#.........#
#.........#
##..#..#..#
#.........#
#.........D
#...#.....#
#.........#
#.........#
##.....#..#
###########

