4
2
#####D#####
##.....#..#
#.........#
#.........#
#...#.....#
#.........D
#.........#
##..#.....#
#.........#
#k........#
###########
key : 3

3
4
#####D#####
#.........#
##.#...#.##
#.........#
#.#.#.#.#.#
D.........#
#..#.#.#..#
#.........#
#.#.#.#.#?#
#.......ee#
###########
enemies 2
sign The dungeon remembers all who enter.

0
4
###########
#X........#
#.........#
#.....#...#
#.....#...#
#....##...#
#.........#
#.........#
#.........#
#.........#
#####D#####

2
4
#####d#####
#.........#
#.........#
#......#..#
#.....#...#
D.........#
#.........#
#.#.......#
#..#....#.#
#.........#
#####D#####

2
0
#####d#####
#.........#
#..#...#..#
#k#.....#.#
#.........#
#.........D
#.........#
#.........#
#.........#
#.........#
#####D#####
key : 0

3
3
#####D#####
#.........#
#......#..#
#...##.##.#
#....##...#
D...#.##..D
#.....###.#
#.........#
#.........#
#.........#
#####d#####

3
1
#####l#####
#.........#
#.........#
##..#.....#
#.........#
D.........l
#...#..#..#
#.........#
#.........#
#......#..#
###########

2
1
###########
#.........#
#.....#...#
#....###..#
#...##.#..#
D....#....D
#..#.#.#..#
#.........#
#.........#
#.........#
#####l#####
locked : 1

1
4
#####D#####
#.........#
#.........#
#.........#
#.........#
D....e....#
#.........#
#.........#
#.........#
#.........#
#####d#####
boss
enemies 1

3
2
#####D#####
#.........#
#..#...#..#
#.#.....#.#
#.........#
l.........D
#.........#
#.........#
#.........#
#.........#
#####D#####
locked : 0

1
2
#####D#####
#.........#
#.........#
#.........#
#.........#
#..#......D
#..##.....#
#..#......#
#.........#
#.........#
#####D#####

1
3
###########
#....k....#
#.........#
#.........#
#.....##..#
D....##...D
#.....#.#.#
#.....#...#
#.....###.#
#.........#
#####D#####
key : 5

3
0
#####D#####
##........#
#####.....#
###.#...#.#
#?#.......#
#...#@....D
#...#.....#
#.........#
#.........#
#.........#
#####D#####
sign Something glints behind that door…

4
3
#####d#####
#.........#
#.........#
#.........#
#.....#...#
D....#....#
#......#..#
#.....#..##
#.......###
#.........#
###########

0
2
###########
#ee#?....e#
#.........#
#.........#
#..#..#...#
#.........#
#.........#
#..#..#..##
#.........#
#.........#
#####D#####
enemies 3
sign Many have walked this path.

2
3
#####D#####
#.........#
#.......#.#
#.........#
#.........#
d..#..#...D
#.........#
#.........#
#.#.....#.#
#.........#
#####D#####

4
0
#####D#####
#.........#
#.........#
#..#..#..##
#.........#
#.........#
#...#..#..#
#.........#
#.........#
#k.......##
###########
key : 1

1
0
###########
#.........#
#.........#
#.........#
#...##....#
#...##....#
#....#....#
#.........#
#.........#
#.........#
#####d#####

2
2
#####D#####
#.........#
#.........#
#.........#
#.........#
D.........d
#.........#
#.......#.#
#......#..#
#.........#
#####D#####

