2
2
#####D#####
#.........#
#.......#.#
#.........#
#.........#
D.........D
#.........#
#.........#
#.........#
#.........#
#####D#####

1
1
#####d#####
#k........#
#.........#
#.........#
#.........#
D.........D
#.........#
#.........#
#.........#
#.........#
#####D#####
key : 2

3
1
#####D#####
#........##
#.....###.#
#....#.##.#
#....#..#.#
D...#e....D
#....#....#
#....#..#.#
#....?###.#
#.....e#e.#
###########
enemies 3
sign What you seek is close.

5
4
#####D#####
#.........#
#.........#
#.........#
#.........#
#.........#
#.........#
#.........#
#.........#
#e.......e#
###########
enemies 2

0
1
###########
#.........#
#.........#
#.#..#....#
#.........#
#.........#
#.#..#....#
#.........#
#.........#
#.......#.#
#####d#####

3
0
#####D#####
#.........#
#.........#
#.........#
#...#..#..#
#..####...D
#...####..#
#...#..#..#
#..##.#...#
#k........#
###########
key : 1

5
2
#####l#####
#.........#
#.........#
#.........#
#...e#....#
#....##...#
#.....###.#
#....#..#.#
#.....#.###
#.........#
#####D#####
locked : 1
boss
enemies 1

2
1
#####D#####
#k........#
#.........#
#.........#
#.........#
D.........D
#.........#
#.#.......#
#..#......#
#.........#
#####D#####
key : 0

6
2
#####D#####
#.........#
#.........#
#.........#
#.........#
#..#......#
#...##....#
#.........#
#.........#
#X........#
###########

2
0
#####l#####
#.........#
#..#......#
#.........#
#?#.......#
#....@....D
#.........#
#.........#
#.........#
#.........#
#####D#####
sign This door will not yield without a key.

3
3
#####D#####
#k........#
#.........#
#.........#
#.........#
D.........d
#.........#
#.#......##
#..#......#
#.........#
#####d#####
key : 3

4
4
#####D#####
#.......e##
#.....###e#
#....#..?.#
#......##e#
D.........#
#.........#
#.........#
#.........#
#.........#
#####D#####
enemies 3
door 0 : 0
sign Beware what lurks ahead.

1
2
###########
#.........#
#..#...#.##
#.........#
#.#...#...#
D.........#
#..#.#.#..#
#.........#
#.#.#.#.#.#
#.........#
#####D#####

3
2
#####D#####
#.#.......#
#.........#
#.........#
#....#..#.#
D.........D
#.........#
#.#..#..#.#
#.........#
#.........#
#####l#####

4
3
#####d#####
#.........#
#.........#
#.........#
#.........#
D.........D
#.........#
#.........#
#.........#
#.........#
###########

1
0
###########
#.........#
#......#..#
#.......#.#
#.........#
#.........D
#.........#
#.......#.#
#......#..#
#.........#
#####l#####
locked : 0

2
3
###########
#s......ee#
####.....e#
##........#
#.###.....#
D..#......#
#.#.#.....#
#.........#
#.........#
#........##
#####D#####
enemies 3
switch 0 : 0

4
2
#####l#####
##.#...#.##
#.........#
##...#.#.##
#.........#
#..#......D
#.........#
##.#.#...##
#.........#
##.#...#..#
#####l#####
locked : 3

3
4
###########
#.........#
##.#...#.##
#.........#
#.#.....#.#
d.........#
#..#.#....#
#.........#
#.#.#.#.#.#
#.........#
#####D#####

