1
5
###########
#.........#
#.........#
#.........#
#.........#
D..#......#
#.........#
#....#....#
#.........#
#.........#
#####l#####
locked : 2

3
5
#####D#####
#e#.......#
#.........#
#.........#
#..#..#...#
#e........D
#.........#
#e#.......#
#.........#
#.........#
#####d#####
enemies 3

4
6
#####D#####
#.........#
#.........#
#....#....#
#...#.....#
d..##e....#
#.........#
#.#.......#
###.......#
#.........#
#####D#####
boss
enemies 1

1
2
#####l#####
#k........#
##.#...#..#
#.........#
#..#...#..#
D.........D
#..#.#.#..#
#.........#
##.#...#.##
#.........#
#####D#####
key : 0

1
3
#####d#####
#.........#
#..#......#
#.#.......#
#.........#
D.........D
#.........#
#.........#
#.........#
#.........#
#####D#####

2
4
#####D#####
#.........#
#.........#
#.........#
#.........#
D.........D
#.........#
#.......#.#
#......#..#
#.........#
###########

0
2
###########
#.........#
##..#..#..#
#.........#
#.........#
D...#..#..D
#.........#
#.........#
#...#..#..#
#.........#
#####l#####
locked : 0

1
4
###########
#....k....#
#.........#
#.........#
#.........#
D.........D
#.........#
#.#.......#
#..#......#
#.........#
#####D#####
key : 2

2
2
#####D#####
#.........#
#..#.....##
#.........#
#.........#
#..#..#...d
#.........#
#.........#
#..#.....##
#.........#
###########

3
6
###########
#.......ee#
#.........#
#...#..#..#
#.........#
D.........#
#.......#.#
#.........#
#.........#
##.....#..#
#####D#####
enemies 2

1
1
#####D#####
#.........#
#.....##..#
#.......#.#
#.........#
D.........D
#.........#
#.#...#...#
#.##......#
#.........#
###########

0
3
###########
#.........#
#.#.#.#.#.#
#.........#
#..#.#.#..#
D.........#
#.#...#.#.#
#.........#
#......#.##
#.........#
#####d#####

5
6
#####D#####
#.........#
#.........#
#.........#
#.........#
#.........#
#.........#
#.........#
#.........#
#X........#
###########

3
3
#####D#####
#.........#
#.........#
#.........#
#.........#
#.........#
#.........#
#.........#
#.........#
#e.......e#
###########
enemies 2

1
0
###########
#.........#
#.........#
#.........#
#...##....#
#..#@##...D
#.##......#
#.........#
#.........#
#.........#
###########

4
5
#####d#####
#.........#
#.........#
#.........#
#.........#
#.........d
#...#.....#
#..##.....#
#..#......#
#.........#
###########

2
3
#####D#####
#.........#
#..#...#..#
#.#.....#.#
#.........#
d.........D
#.........#
#.#.......#
#..#......#
#.........#
#####D#####

2
5
#####l#####
#k##......#
#...#.....#
##..###...#
#.#..#....#
D....#....#
#.........#
#.........#
#.........#
#.........#
#####D#####
key : 5

0
1
###########
#k........#
#.........#
#.........#
#...##....#
#.....#...D
#....#....#
#.........#
#.........#
#.........#
#####D#####
key : 1

