1
4
###########
#k........#
##.....#..#
#.........#
#.........#
D...#..#..D
#.........#
#.........#
##..#..#..#
#.........#
#####D#####
key : 4

0
5
###########
#......##X#
#.....#...#
##...####.#
#...#..##.#
#.........#
#.........#
#.........#
#.........#
#.........#
#####D#####

2
0
#####D#####
#.........#
#.........#
#...#.....#
#...#.#...#
#....@#...D
#.........#
#.........#
#.........#
#?........#
###########
sign The brave are rewarded.

0
1
###########
#.........#
#......#..#
#.......#.#
#.........#
#.........#
#.........#
#.#.......#
#..#......#
#.........#
#####D#####

1
0
###########
#k........#
#.........#
#.........#
#.........#
#.........D
#.........#
#.........#
#.........#
#.........#
#####D#####
key : 0

3
4
#####d#####
#.........#
#.........#
#.........#
#.........#
D.........D
#.........#
#.#.......#
#..#......#
#.........#
###########

3
5
#####d#####
#.........#
#..#......#
#.#.......#
#.........#
D.........#
#.........#
#.......#.#
#......#..#
#.........#
###########

1
5
#####D#####
#.........#
#.##..#...#
#...###...#
#..####...#
D...e#....#
#..#.##...#
#.........#
#.........#
#.........#
#####l#####
locked : 3
boss
enemies 1

2
3
#####D#####
#.........#
#.#.#.#.#.#
#.........#
#.#.#.#...#
l.........D
#.#...#...#
#.........#
#.#.#.#.#.#
#.........#
#####D#####
locked : 0

1
3
###########
#..#k.....#
#.........#
#....#....#
#.........#
D.........D
#.#.......#
#.#.....#.#
#..#...#..#
#.........#
#####D#####
key : 6

2
6
###########
#.........#
#..#...#.##
#.........#
#....#....#
l.........#
#....#.#..#
#.........#
##.....#.##
#.........#
###########
locked : 4

2
1
#####d#####
#.#.....#.#
#.........#
#..#.#.#..#
#.........#
D...#.#...D
#.........#
#..#.#...##
#.........#
#.#.....#.#
###########

3
2
#####D#####
#.........#
#.........#
#.........#
#.........#
#.........D
#.........#
#.#.....#.#
#..#...#..#
#.........#
###########

1
2
###########
#.ee......#
#.##....p.#
#.##?.....#
#..##.....#
D.........D
#.........#
#.........#
#.........#
#p........#
#####D#####
enemies 2
sign Those who search shall find.

2
5
#####l#####
#.........#
#.........#
#.........#
#.........#
d.........l
#.........#
#.........#
#.........#
#.........#
#####d#####

3
3
#####D#####
#.........#
#..#......#
#.#.......#
#.........#
D.........D
#.........#
#.#.....#.#
#..#...#..#
#..k......#
###########
key : 3

1
1
#####D#####
#e........#
#####.....#
#####.....#
#e#e......#
D..#......D
#...#.....#
#.........#
#.........#
#?.......p#
#####d#####
enemies 3
sign Those who search shall find.

2
2
#####D#####
#.........#
#.........#
##.....#..#
#.........#
D.........l
#...#..#..#
#.........#
#.........#
#......#..#
#####D#####

2
4
#####D#####
#.........#
#.........#
#.........#
#.........#
D.........d
#.........#
#.........#
#.........#
#.........#
#####d#####

