0
2
###########
#........k#
#.##......#
#.##......#
#.###.#...#
D...##....#
#.###.....#
#.........#
#.........#
#.........#
#####D#####
key : 3

1
0
#####d#####
#.........#
#.........#
#.........#
#.........#
#.........D
#.........#
#.......#.#
#......#..#
#.........#
#####D#####

5
0
#####l#####
#.........#
#.........#
#...#..#..#
#.........#
#.........#
#.#..#..#.#
#.........#
#.........#
##........#
###########
locked : 1

3
2
#####D#####
####......#
####......#
####......#
#.........#
D.........D
#.........#
#.........#
#.........#
#....k....#
###########
key : 2

4
3
#####d#####
#.........#
#.........#
#.........#
#.........#
#....e....#
#.........#
#.........#
#.........#
#.........#
#####D#####
boss
enemies 1

5
3
#####D#####
###.......#
##.#......#
##.#......#
#..#......#
#.........#
#.........#
#......#..#
##........#
#X........#
###########

0
1
###########
#..e......#
#..#?.....#
#..##.....#
#.#e#.#...#
D......#..D
#....#.#..#
#.........#
#.........#
#.........#
#####D#####
enemies 2
sign A useful tool lies just ahead.

2
2
#####d#####
#.........#
##.#......#
#..##.#...#
#.#.#.....#
d.........D
#.........#
#.........#
#.........#
#.........#
#####D#####

2
1
#####D#####
#k........#
#...#.#...#
#.........#
#.....#.#.#
D.........d
#.#.......#
#.........#
#...#.....#
#.........#
#####D#####
key : 0

4
1
#####D#####
#.........#
#..#......#
#.#.......#
#.........#
D.........#
#.........#
#.........#
#.........#
#.........#
###########

1
2
#####D#####
#.........#
#.........#
#.........#
#.........#
D.........#
#.........#
###.....#.#
#..#...#..#
#.........#
#####d#####

4
0
#####l#####
#.........#
#.........#
#.........#
#.........#
#.........D
#.........#
#.........#
#.........#
#.........#
#####l#####
locked : 0

0
0
###########
#.........#
#.........#
#.........#
#.........#
#.........D
#.........#
#.#.......#
#..#......#
#.........#
#####d#####

3
0
#####D#####
####......#
##e.#.....#
###.#.....#
#e#.......#
#e........D
#.........#
#.........#
#.........#
#.........#
#####l#####
enemies 3

2
0
#####D#####
#.........#
#.........#
#.........#
#.........#
#?...@....D
#.........#
#.........#
#.........#
#.........#
#####D#####
sign Something glints behind that door…

3
3
#####D#####
#.........#
#.........#
#.........#
#.........#
D....#.#..#
#.........#
#.........#
#.........#
#.........#
#####d#####

2
3
###########
#........e#
#.........#
#.....#..##
#.........#
D.........#
#..#..#...#
#.........#
#.........#
#..#.....##
#####D#####
enemies 1

1
1
#####D#####
#.........#
#.........#
#.#..#..#.#
#.........#
D.........D
#.#..#..#.#
#.........#
#.........#
#.#.....#.#
#####D#####

3
1
#####D#####
#k........#
#..#......#
#.#.......#
#.........#
D.........D
#.........#
#.......#.#
#......#..#
#.........#
#####D#####
key : 1

