5
1
#####D#####
#.........#
#.........#
#.........#
#.........#
#....##...D
#...#...#.#
#.....#...#
#...#..#..#
#......#..#
###########

2
1
#####D#####
#.........#
#..#......#
#.#......##
#.........#
D.........d
#.........#
#....#..#.#
#......#..#
#.........#
#####D#####

0
2
###########
#k........#
#.........#
#.....#...#
#......##.#
#.........d
#.........#
#.........#
#.........#
#.........#
#####D#####
key : 3

1
1
###########
##.....#..#
#.........#
##.#.#.#.##
#.........#
D....#.#..D
#.........#
##.#.#....#
#.........#
#..#...#.##
#####D#####

1
3
#####D#####
#.........#
#.........#
#.........#
#.........#
D.........#
#.........#
#.........#
#.........#
#........X#
###########

0
0
###########
#.........#
#.........#
#.........#
#.........#
#.........#
#.........#
#.#.......#
#..#......#
#.........#
#####D#####

2
0
#####D#####
#s........#
#.........#
#.........#
#....##...#
#e..#e#...D
#...#.....#
#.........#
#.........#
#.........#
#####D#####
enemies 2
switch 0 : 0 1

4
1
#####D#####
#.........#
#..#...#..#
#.#.#...#.#
#.........#
#.........D
#.........#
#.......#.#
#......#..#
#.........#
#####D#####

2
2
#####d#####
#.........#
#.........#
#.........#
#.........#
d.........#
#.........#
#.#.....#.#
#..#...#..#
#.........#
#####D#####

1
0
#####D#####
#.........#
#...p.....#
#.........#
#..##.....#
#..?.@....D
#..##.....#
#..#......#
#..#......#
#.........#
#####D#####
sign Many have walked this path.

0
3
###########
#.........#
#.##..#...#
#..#.#....#
#.#.e.....#
d....###..#
#....####.#
#.....#.#.#
#.........#
#........##
#####D#####
boss
enemies 1

1
2
#####D#####
##.....#.##
#.........#
##.#......#
#.........#
D....#.#..D
#.........#
#..#.#.#.##
#.........#
#..#...#..#
#####d#####

4
3
#####D#####
#.........#
#.........#
#.........#
#.........#
D.........#
#.........#
###....#..#
#..#......#
#......#.k#
###########
key : 5

3
0
#####D#####
#.........#
#.#.#.#.#.#
#.........#
#.#.#.#.#.#
#.........D
#.#...#.#.#
#.........#
#.#.#...#.#
#.........#
###########

3
1
#####D#####
#k........#
#.........#
#...#.....#
#.........#
D.........D
#...#..#..#
#.........#
#.........#
##.....#..#
#####D#####
key : 1

4
2
#####D#####
#k........#
#.........#
#.........#
#.........#
D.........D
#.........#
#.......#.#
#......#..#
#.........#
#####D#####
key : 4

3
3
###########
#.........#
#.........#
#.........#
#.........#
d.........#
#.........#
#.........#
#.........#
#.........#
#####D#####

5
2
#####D#####
####....#.#
##......#.#
#..##.#.#.#
#.##?#..#.#
D..#......#
#.........#
#.........#
#........e#
#.......ee#
###########
enemies 3
sign The brave are rewarded.

3
2
#####D#####
#?........#
#.........#
#.........#
#.........#
D..##.....d
#.#.......#
##e.#.....#
###.......#
##e.......#
#####D#####
enemies 2
door 0 : 0 1
sign What you seek is close.

