5
2
#####d#####
#.........#
#.........#
#.........#
#..#.#....#
D..##.....D
#.#.......#
###.#.....#
##..#.....#
#.........#
###########

3
3
#####D#####
#.........#
#......#..#
#.......#.#
#.........#
#k........D
#.........#
#.........#
#.........#
#......#..#
#####D#####
key : 4

7
1
#####D#####
#.........#
#..#......#
#.#.......#
#.........#
#.........#
#.........#
#.........#
#.........#
#.........#
###########

2
4
#####D#####
#.........#
#.........#
#.........#
#.........#
d.........D
#.p.......#
#.........#
#........p#
#.........#
#####D#####

4
1
###########
#.........#
#.........#
#.........#
#.........#
#.........D
#.........#
#.........#
#.........#
#.........#
#####l#####
locked : 1

4
2
###########
#.........#
#.........#
#.......#.#
#.#.......#
D.........D
#.........#
#.#.......#
#..#..#...#
#.........#
#####d#####

5
3
#####D#####
#?........#
#.........#
#.........#
#.........#
D.........D
#.........#
#.........#
#.........#
#....e....#
###########
enemies 1
sign Many have walked this path.

4
3
#####D#####
#e#.....#e#
#.........#
#..#.#.#.##
#.........#
D.........#
#.........#
#..#.#.#.##
#.........#
#e#.......#
#####D#####
enemies 3

2
3
#####D#####
#.#.....#.#
#.........#
#.........#
#.#.....#.#
#.........d
#.........#
#.#..#..#.#
#.........#
#.........#
#####D#####

1
4
###########
#.........#
#.........#
#.........#
#.........#
d.........l
#.........#
#.#.....#.#
#..#...#..#
#.........#
#####D#####

2
5
#####D#####
#.........#
#.........#
#.........#
#.........#
D.........#
#..#......#
###......p#
#...#.....#
####.....X#
###########

1
5
###########
#..#...#..#
#..##..#..#
#....#....#
#..#.#....#
l....e....#
#.........#
#.........#
#.........#
#.........#
#####D#####
locked : 4
boss
enemies 1

5
1
#####l#####
#k........#
#..#......#
#.#.......#
#.........#
D.........D
#.........#
#.#.......#
#..#......#
#.........#
#####D#####
key : 0

5
4
###########
##.#...#.##
#.........#
#.#.#.#.#.#
#.........#
D......#..#
#.........#
#...#.#.#.#
#.........#
#........##
###########

1
3
#####d#####
#e#.....#.#
#.........#
#.#.#...#.#
#.........#
#...#.#...d
#.........#
#.#...#.#.#
#.........#
#.#.....#.#
#####D#####
enemies 1

6
1
#####D#####
#k........#
##.#......#
#.........#
#......#..#
#.........#
#..#...#..#
#.........#
##.....#.##
#.........#
#####D#####
key : 1

3
4
#####D#####
#.##......#
#..##.#...#
#...#.#...#
#.#..##...#
D....##...#
#..#......#
#..#......#
#..#......#
#........k#
###########
key : 5

0
3
###########
##.#......#
##........#
#....#....#
#....#....#
#.........#
#.....###.#
#......##.#
#.........#
#.........#
#####d#####

5
0
###########
#?........#
#.###.....#
#.###.....#
#...@##...#
#...###...D
#..#####..#
#.........#
#.........#
#.........#
###########
sign Something glints behind that door…

