5
2
#####.#####
#.........#
#.........#
##..#.....#
#.........#
d.........#
#......#..#
#.........#
#.........#
##.....#..#
#####.#####

2
1
#####l#####
#.........#
#.........#
#.....#..##
#.........#
...........
#..#..#...#
#.........#
#.........#
#..#.....##
#####.#####
locked : 1

4
2
#####.#####
#..#...#.##
#.........#
#.#.#.#.#.#
#.........#
d..#...#..#
#.........#
#.#.#.#.#.#
#.........#
##.#...#.##
#####.#####

8
2
#####.#####
#.........#
#......##.#
#...##.##.#
#....##...#
#....###..#
#.........#
#.........#
#.........#
#X........#
###########

5
1
#####.#####
#k........#
##.#...#.##
#.........#
#..#.#.#..#
#.........d
#..#.#....#
#.........#
##.#...#.##
#.........#
#####.#####
key : 2

0
0
###########
#.........#
#.#.#.....#
#.........#
#.#.#...#.#
#.........#
#.#.#.#.#.#
#.........#
#...#.#.#.#
#.........#
#####.#####

2
2
###########
#...e..e..#
#...#..#..#
#.........#
#.........#
....#..#...
#.........#
#.........#
##..#..#..#
#e........#
#####.#####
enemies 3

6
1
#####.#####
##.....#..#
#.........#
#.........#
#...#..#..#
#.........l
#.........#
##..#.....#
#.........#
#.........#
#####.#####

7
2
#####d#####
#.........#
#.........#
#.........#
#.........#
.....e....#
#.........#
#.........#
#.........#
#.........#
#####.#####
boss
enemies 1

3
2
#####.#####
#.........#
#.........#
#.........#
#.........#
..........d
#.........#
#.#.....#.#
#.........#
#.........#
#####.#####

7
1
#####.#####
#.........#
#..#......#
#.#.......#
#.........#
#..........
#.........#
#.......#.#
#......#..#
#k........#
###########
key : 3

2
0
#####.#####
#.........#
#.........#
##........#
#.........#
#..........
#.#.....#.#
#.........#
#k........#
##........#
###########
key : 1

4
1
#####.#####
#e.....#..#
#.....##..#
#....####.#
#e...####.#
#e........d
#.........#
#.........#
#.........#
#.........#
#####.#####
enemies 3

1
1
###########
#........k#
#......#..#
#.......#.#
#.........#
..........#
#.........#
#.#.......#
#..#......#
#.........#
#####l#####
key : 0

3
3
#####.#####
#.#.......#
#.#.......#
#..#......#
#..#......#
d.........#
#.........#
#.........#
#.........#
#.........#
###########

2
3
###########
#.......ee#
#........e#
#.........#
#.........#
..........#
#.........#
#.........#
#.........#
#.........#
#####.#####
enemies 3

6
2
#####.#####
#.........#
#.........#
#.........#
#.........#
l.........#
#.........#
#.......#.#
#......#..#
#.........#
#####d#####
locked : 3

1
0
#####.#####
#.........#
#.........#
#.........#
#.........#
#?...@.....
#.........#
#.........#
#.........#
#.........#
#####.#####
sign Those who search shall find.

3
1
#####.#####
#.........#
##.....#..#
#.........#
#.........#
#....#.....
#.........#
#.........#
##..#..#..#
#.........#
#####.#####

