1
2
#####D#####
#.........#
#..#...#..#
#....#.#..#
#..#e#.#..#
#...##.#..#
#..##.....#
#.........#
#.........#
#.........#
#####d#####
boss
enemies 1

6
2
#####D#####
#........##
#.........#
#.........#
#..#..#...#
D.........#
#.........#
#.....#..##
#.........#
#.........#
#####D#####

6
1
#####D#####
#.........#
#.........#
#.........#
#.........#
D.........D
#.........#
#.........#
#.........#
#....k....#
###########
key : 3

4
1
#####d#####
#.........#
#.#.#.#.#.#
#.........#
#......#..#
D.........l
#.#.#...#.#
#.........#
#......#.##
#........k#
#####D#####
key : 0

7
2
#####D#####
#.......###
#.....#####
#........##
#.......#?#
#.....#...#
#.........#
#.........#
#.........#
#e.......e#
###########
enemies 2
sign The dungeon remembers all who enter.

2
2
#####d#####
#..#......#
#.........#
##.#...#.##
#.........#
#..#.#.#..#
#.........#
#..#.#.#.##
#.........#
#..#...#.##
#####l#####
locked : 4

6
0
#####l#####
###.......#
#.#.......#
#.###..#..#
#...##....#
#.........D
#.##......#
##.###....#
#.........#
#.........#
###########
locked : 0

5
2
#####D#####
#.#.......#
#.........#
#.........#
#.#..#..#.#
D.........#
#.........#
#.#..#....#
#.........#
#.........#
#####D#####

5
1
#####D#####
#.........#
#.........#
#.......#.#
#.........#
D.........D
#.........#
#.....#.#.#
#......#..#
#.........#
#####D#####

3
1
###########
#.........#
#..#...#..#
#.#.....#.#
#.........#
D.........D
#.........#
#.........#
#.........#
#.........#
#####d#####

4
2
#####D#####
#.........#
#.........#
#.........#
#.........#
l.........D
#.........#
#.........#
#.........#
#.........#
#####D#####
locked : 1

3
2
#####l#####
#e.p.....?#
#.........#
#.........#
#.........#
D.........d
#.........#
#.........#
#.........#
#e........#
#####D#####
enemies 2
sign This door will not yield without a key.

5
0
#####D#####
#.#.....#.#
#.........#
#.........#
#..#..#...#
#.........D
#.........#
#....#....#
#.........#
#.........#
#####l#####

4
3
#####D#####
#.........#
#.........#
#.........#
#.........#
D.........d
#.........#
#.........#
#.........#
#....k....#
###########
key : 4

4
0
#####D#####
#.........#
#.........#
#.........#
#.........#
#....@....D
#.........#
#.........#
#.........#
#.........#
#####D#####

3
3
###########
#.........#
#...#..#..#
#.......#.#
#.........#
d.........#
#.........#
#.......#.#
#......#..#
#.........#
#####D#####

0
2
###########
#........X#
#.#......##
#..#......#
#.#.......#
#..##.....#
#.##......#
##.#......#
#.........#
#.........#
#####D#####

3
0
###########
#k........#
#...p.....#
#.........#
#.#.......#
#.........D
#.......p.#
#.........#
#.........#
#.........#
#####D#####
key : 1

4
4
###########
#.........#
#.........#
#...##....#
#..###..#.#
d..###....#
#.........#
#.........#
#...#.....#
#.........#
###########

