3
0
#####.#####
#.##......#
#.#.......#
#.#.......#
#.........#
#..........
#.........#
#.........#
#.........#
#.........#
#####l#####

6
0
#####d#####
#.........#
#......#..#
#.......###
#...#.....#
#..........
#.........#
#.......#.#
#......#..#
#.........#
#####d#####

4
2
###########
#.........#
#......#..#
#.......#.#
#.........#
d..........
#.........#
#.#.....#.#
#..#...#..#
#.........#
###########

5
1
#####.#####
#.........#
#...#..#..#
#.......#.#
#....#....#
..........#
#.........#
#.#.......#
#..#......#
#.........#
#####.#####

2
1
#####.#####
#.........#
#..#....#.#
#.#.......#
#.........#
...........
#.........#
#.......#.#
#......#..#
#.........#
#####l#####

4
0
#####l#####
#.........#
#.........#
#.........#
#.........#
#..........
#.........#
#.........#
#.........#
#.........#
#####l#####
locked : 0

2
2
###########
#........k#
#.#.......#
#..##.....#
#.##......#
..........#
#.........#
#.........#
#.........#
#.........#
###########
key : 1

8
0
#####.#####
#.........#
#.........#
##.##.....#
#.###.....#
#..#......#
#...#.....#
###.......#
#.........#
#X........#
###########

6
1
#####.#####
#.........#
#.........#
#.........#
#.........#
..........#
#.........#
#.........#
#.........#
#.........#
###########

4
4
###########
#........k#
#..#......#
#.#.......#
#.........#
..........#
#.........#
#.......#.#
#......#..#
#.........#
###########
key : 4

2
0
###########
#..#......#
#...#.#####
##..#.##.##
#...@..#..#
#....###...
#.....###.#
#.........#
#.........#
#.........#
#####.#####

3
1
#####l#####
#.#.....#.#
#.........#
#..#.#.#.##
#.........#
....#.#...#
#.........#
#..#.#.#..#
#.........#
#.......#.#
#####.#####
locked : 1

5
0
#####l#####
#.........#
#..#......#
#.#.......#
#.........#
#..........
#.........#
#.#.......#
#..#......#
#.........#
#####d#####
locked : 2

1
1
#####d#####
##.....#k##
#.........#
#...#...#.#
#.........#
#..#...#..#
#.........#
#...#.#...#
#.........#
##.....#.##
#####.#####
key : 0

7
0
#####d#####
#.........#
#.........#
#.........#
#.........#
#....e....#
#.........#
#.........#
#.........#
#.........#
#####.#####
boss
enemies 1

5
3
#####.#####
#.........#
#..#...#.##
#.........#
#..#...#..#
#.........#
#..#.#.#..#
#.........#
##.#...#.##
#e........#
###########
enemies 1
door 0 : 0

4
3
###########
#....e....#
#.........#
#...##s...#
#...e##...#
....#e#....
#.........#
#.........#
#.........#
#.........#
#####.#####
enemies 3
switch 0 : 0

0
1
###########
#.........#
#.........#
#.........#
#.........#
#.........#
#.........#
#.........#
#.........#
#.........#
#####d#####

4
1
#####.#####
#k........#
#......#..#
#.......#.#
#.........#
..........d
#.........#
#.#.......#
#..#......#
#.........#
#####.#####
key : 2

