3
3
#####d#####
#e........#
##.......##
#.........#
#.#.#...#.#
...........
#..#...#..#
#.........#
#.#.#e#.#.#
#...e.?...#
###########
enemies 3
sign The dungeon remembers all who enter.

6
1
###########
#.........#
#.........#
#.........#
#.........#
..........#
#.........#
#.......#.#
#......#..#
#.........#
###########

2
1
#####d#####
#.........#
#.........#
#.........#
#.........#
...##k##...
#...###...#
#...####..#
#..#......#
#......#..#
#####.#####
key : 2

3
0
#####.#####
#k........#
##.#.....##
#.........#
#.#.#...#.#
#.........d
#....#.#..#
#.........#
#...#.....#
#.........#
#####.#####
key : 1

0
0
###########
#.........#
#.#.....#.#
#.........#
#.........#
#..#..#...#
#.........#
#.........#
#.#.....#.#
#.........#
#####d#####

5
0
#####.#####
##........#
#####.....#
###.......#
#?###.....#
#..##@....#
#.........#
#.........#
#.....#...#
#.........#
#####.#####
sign Someone has been here recently.

2
3
#####.#####
#......#.##
#......#.##
#.........#
#...e##.#.#
.....###..#
#.....#...#
#....#....#
#.........#
#.........#
#####d#####
boss
enemies 1

2
2
###########
#....k....#
#.........#
#.........#
#.........#
...........
#.........#
#.......#.#
#...#..#..#
#.........#
#####.#####
key : 4

4
0
#####.#####
##.#...#.##
#.........#
##.#.#.#.##
#.........#
#..#.#.#...
#.........#
##.#.#.#.##
#.........#
##.#.....##
#####.#####

6
0
#####.#####
#.........#
##........#
####......#
#k#.......#
#..........
#.........#
#.........#
#.........#
#.........#
#####l#####
key : 0

7
0
#####l#####
#.........#
#.........#
##.#......#
#.#.......#
#..##.....#
#.#.......#
#..#......#
#.........#
#.........#
###########
locked : 0

1
3
###########
#X........#
#.........#
#....##...#
#....#.#..#
#......#..#
#.........#
#.........#
#.........#
#.........#
#####.#####

3
2
#####.#####
#.##......#
#.........#
#..#......#
#..###....#
......##...
#...#.##..#
#..###....#
#..#...#..#
#.........#
###########

2
0
#####l#####
##.#...#..#
#.........#
#.#.#...#.#
#.........#
#..#.#.#...
#.........#
#...#.#.#.#
#.........#
##.#...#.##
#####.#####

4
1
#####.#####
#.........#
#.#.#.#.#.#
#.........#
#.#.#.#.#.#
..........#
#.#.#...#.#
#.........#
#.#.#.#.#.#
#.........#
###########

3
1
#####.#####
#.#.....#.#
#.........#
#.........#
#..#..#...#
d..........
#.........#
#.#..#....#
#.........#
#.........#
#####.#####

1
1
###########
#.........#
#..#...#..#
#.#.....#.#
#.........#
..........#
#.........#
#.......#.#
#......#..#
#.........#
#####d#####

3
4
###########
##........#
#..#......#
##........#
#.........#
..........#
#.........#
#.........#
#.........#
#.........#
###########

1
0
#####d#####
#.........#
#.........#
#.........#
#..###.#..#
#.....#....
#..##..#..#
#..#..#...#
#...#..#..#
#.........#
#####l#####
locked : 1

