3
3
#####d#####
##k#...#.##
#.........#
#...#.#.#.#
#.........#
D..#.#.#..d
#.........#
#.#.#.#.#.#
#.........#
##.#......#
#####d#####
key : 0

2
4
#####D#####
#.........#
#.........#
#.#.#.....#
#.##e.....#
l..####...#
#...#.#...#
#.........#
#.........#
#.........#
#####D#####
locked : 2
boss
enemies 1

4
5
#####D#####
#.........#
#.........#
#.........#
#.........#
D.........#
#.........#
#.........#
#........e#
#......?ee#
###########
enemies 3
door 0 : 0
sign A useful tool lies just ahead.

1
4
###########
#X........#
#.#...#...#
#..#......#
#.#####...#
#...##....#
#.#.##....#
#.....#...#
#.##..#...#
#.##......#
#####D#####

5
4
#####D#####
#.........#
#.........#
#.........#
#.........#
#.........#
#.........#
#.........#
#.........#
#k........#
###########
key : 3

1
1
#####D#####
#.........#
#......#..#
#.......#.#
#.........#
#.........D
#.........#
#.#.....#.#
#..#...#..#
#.........#
#####d#####

4
3
#####d#####
#.......#.#
#.........#
#.#...#.#.#
#.........#
D...#.#...D
#.........#
#.#.#.#.#.#
#.........#
#.#.....#.#
###########

2
3
###########
#.........#
#.........#
#.......#.#
#.#.......#
D.........l
#.........#
#.........#
#.........#
#.........#
#####d#####

3
4
#####D#####
#.........#
#..#......#
#.#.......#
#.........#
d.........D
#.........#
#.........#
#.........#
#.........#
#####D#####

2
1
#####d#####
#.........#
#.........#
#...#..#..#
#.........#
#.........D
#...#..#..#
#.........#
#.........#
##.....#..#
#####D#####

0
1
###########
#k........#
#......#..#
#.......#.#
#.........#
#.........#
#.........#
#.......#.#
#......#..#
#.........#
#####D#####
key : 1

3
1
#####D#####
#.........#
##.....#..#
#.........#
#....#....#
D.........D
#..#.#.#..#
#.........#
#..#.....##
#.........#
###########

4
4
#####D#####
#k........#
#.........#
#.........#
#.........#
D.........D
#...#.....#
#.........#
#...#.....#
#.........#
#####D#####
key : 2

3
0
###########
#.........#
#.........#
#.........#
#.#....##.#
#...#@#...D
#.#.....#.#
##.#...#..#
#..#......#
##........#
###########

2
2
#####D#####
#e........#
#.........#
####......#
#?##......#
D..#......D
#...#.....#
#e#.#.....#
##........#
#e........#
#####D#####
enemies 3
sign Beware what lurks ahead.

4
2
#####D#####
#.........#
#.........#
#.........#
#.........#
#.........D
#.........#
#.#.....#.#
#..#...#..#
#.........#
###########

3
2
#####D#####
#..#......#
#......#..#
#..#....#.#
#.......#.#
D.........D
#.........#
#.#.....#.#
#..#...#..#
#.........#
#####D#####

3
5
###########
#.....s..e#
#..#..#...#
#..#..#...#
#.#.#.....#
D.........#
#.........#
#.........#
#.........#
#.........#
#####D#####
enemies 1
switch 0 : 0

1
2
###########
#.........#
#..#...#.##
#.#.......#
#.........#
D.........#
#.........#
#.#.....#.#
#..#...#..#
#.........#
#####D#####

