7
1
###########
#.........#
#......#..#
#.......#.#
#.........#
..........#
#.........#
#.#.......#
#..#......#
#.........#
###########

2
4
###########
#........k#
#..#......#
#.#.......#
#.........#
..........#
#.........#
#.........#
#.........#
#.........#
###########
key : 3

3
1
#####.#####
#.........#
#..#......#
#.#.......#
#.........#
d..........
#.........#
#.........#
#.........#
#......#..#
###########

5
0
#####.#####
#.........#
#.........#
#....#..#.#
#.........#
#..........
#.....#...#
#.........#
#.........#
#.#.....#.#
#####l#####
locked : 0

7
0
#####.#####
#........k#
#..#..#..##
#.........#
#.........#
#..#..#....
#.........#
#.........#
#..#.....##
#.........#
#####.#####
key : 0

2
1
###########
#?...e....#
#.........#
#.........#
#.........#
..........d
#.........#
#.........#
#.........#
#.........#
#####.#####
enemies 1
sign Many have walked this path.

1
2
###########
#k........#
##.#......#
##.###....#
#....##...#
#..#.#.....
#.#.##.#..#
#.#...#...#
#.........#
#.........#
#####.#####
key : 2

1
3
#####.#####
#.........#
#.........#
#.........#
#.###.....#
....e##...#
#.##.##...#
#..####...#
#.###.##..#
#.........#
#####l#####
locked : 1
boss
enemies 1

3
0
#####d#####
#.........#
#.........#
#.........#
#......#..#
#k........d
#.........#
#.........#
#.........#
#.........#
#####.#####
key : 1

0
3
###########
#X........#
#.........#
#..#.#....#
#...##....#
#..#.#....#
#....#....#
##.#.#....#
##........#
##........#
#####.#####

4
0
#####.#####
#.........#
#...#..#..#
#.........#
#.........#
#....#....#
#.........#
#?........#
##..#..#..#
#e........#
#####.#####
enemies 1
sign Turn back; you are not yet ready.

3
3
#####.#####
#.........#
##.#...#..#
#.........#
#....#.#..#
..........#
#..#.#.#..#
#.........#
##.#......#
#.........#
###########

5
1
###########
#.........#
#..#......#
#.#.......#
#.........#
..........#
#.........#
#.........#
#.........#
#.........#
###########

2
3
#####l#####
#.........#
#.#.......#
#.........#
#.........#
d.....#....
#.........#
#.........#
#.#.....#.#
#.........#
#####.#####

2
0
###########
#.........#
#..#......#
#.#...#...#
#.........#
#..........
#...#.....#
#........##
#.........#
#.........#
#####d#####

3
2
#####.#####
#......#..#
#......##.#
#....###..#
#....###..#
....#.##...
#.##......#
#.###.....#
#.##......#
#.##......#
###########

6
0
#####l#####
#.........#
#.........#
#.........#
#.........#
#?...@....#
#.........#
#.........#
#.........#
#.........#
#####.#####
sign A locked path — look elsewhere first.

2
2
#####.#####
#.........#
#.#.#.#...#
#.........#
#..#.#.#..#
d.........d
#.#.#.#.#.#
#.........#
#......#.##
#.........#
#####.#####

8
0
#####.#####
#.........#
#......#..#
#.......#.#
#.........#
#.........#
#.........#
#.#.......#
#..#......#
#.........#
###########

