0
0
###########
#.........#
#.........#
#.#..#..#.#
#.........#
#.........#
#..#..#...#
#.........#
#.........#
#.#.....#.#
#####d#####

3
2
#####.#####
#e........#
#.........#
#.........#
#.........#
..........d
#.........#
#.........#
#.........#
#?........#
#####.#####
enemies 1
sign A useful tool lies just ahead.

5
1
#####.#####
#........##
#..#..###.#
#....##.#.#
#.......#.#
#..........
#.........#
#.........#
#.........#
#.........#
#####.#####

1
1
###########
#.........#
#.#.....#.#
#.........#
#.#.#.#.#.#
...........
#...#.#.#.#
#.........#
#...#.#.#.#
#.........#
#####.#####

6
1
#####.#####
#.#.....#.#
#.........#
#.#.#...#.#
#.........#
#...#......
#.........#
#?#...#.#.#
#.........#
#e......#.#
###########
enemies 1
door 0 : 0
sign Many have walked this path.

1
0
#####d#####
#.........#
#..#...#..#
#.#.....#.#
#.........#
#..........
#.........#
#.........#
#.........#
#.........#
#####d#####

5
2
#####.#####
#.........#
#.........#
#.........#
#.........#
.........k#
#.........#
#.#.......#
#.........#
#.........#
#####.#####
key : 9

2
2
#####l#####
#......#..#
#.....#k#.#
#.......#.#
#.....##..#
..........#
#.........#
#.........#
#.........#
#.........#
#####.#####
key : 4

6
2
#####.#####
#.........#
##.....#.##
#.........#
#..#.#.#..#
..........#
#..#.#....#
#.........#
##.....#.##
#.........#
###########

4
1
#####.#####
#.........#
#..#......#
#.#.......#
#.........#
...........
#.........#
#.........#
#.........#
#.........#
#####.#####

3
0
#####d#####
#.........#
#e#.#.....#
##......#.#
#s.#.#....#
#....#.....
#..###....#
#.........#
#........##
#.........#
#####.#####
enemies 1
switch 0 : 0

2
0
#####d#####
#..#......#
#..#......#
#.........#
#.........#
#.........l
#.........#
#.#.#...#.#
#..#...#..#
#.........#
#####d#####

1
2
###########
#.......#.#
#.........#
#.#.#.#...#
#.........#
....#.#...#
#.........#
#.#...#.#.#
#.........#
#.......#.#
#####l#####
locked : 1

3
3
###########
#.........#
#.#.......#
#.##.##...#
#...###...#
d..###e#..#
#.####.#..#
#.........#
#.........#
#.........#
#####.#####
boss
enemies 1

4
3
#####.#####
#.........#
#.........#
#.........#
#.........#
..........#
#.........#
#.........#
#.........#
#........X#
###########

2
1
#####.#####
#.........#
#.........#
#.........#
#.........#
l..........
#.........#
#.........#
#.........#
#.........#
#####.#####
locked : 0

4
2
#####.#####
#k........#
#.#.#.#.#.#
#.........#
#..#.#....#
...........
#.#.....#.#
#.........#
#..#...#..#
#.........#
#####.#####
key : 0

3
1
#####.#####
#k........#
#......#..#
#.......#.#
#.........#
...........
#.........#
#.........#
#.........#
#.........#
#####.#####
key : 1

4
0
#####.#####
#.........#
#.........#
#.........#
#.........#
#..#.@.....
#.##......#
#.#.......#
#.........#
#?........#
###########
sign The dungeon remembers all who enter.

