5
1
#####d#####
#.........#
#..#...#..#
#.#.....#.#
#.........#
#.........D
#.........#
#.........#
#.........#
#.........#
#####d#####

6
1
#####d#####
#.........#
#.........#
#.........#
#.........#
#.........#
#.........#
#.#.....#.#
#..#...#..#
#.........#
#####D#####

1
2
#####l#####
#.........#
#.........#
#.........#
#.........#
D..##.....#
#...##....#
#.#####...#
#.###.....#
#..#......#
#####D#####

4
1
#####D#####
#k........#
#......#..#
#.......#.#
#.........#
D.........D
#.........#
#.#.......#
#..#......#
#.........#
#####d#####
key : 2

1
1
#####D#####
#.........#
#.......#.#
#...##....#
#....##...#
#...##....D
#s#e##....#
#?##.#....#
#.........#
#.........#
#####D#####
enemies 1
switch 0 : 0 1
sign Beware what lurks ahead.

0
1
###########
#e........#
####......#
#.e##..#..#
#.#.#.###.#
#....#.#..D
#..###.#..#
#......#..#
#.........#
#.........#
#####D#####
enemies 2

5
3
###########
#.........#
#.........#
#.........#
#...e.....#
d..#.#....#
#...##....#
#..###....#
#...#.#...#
#.........#
#####D#####
boss
enemies 1

7
1
#####D#####
#.........#
#.........#
#.........#
#......#..#
#.........#
#.........#
#..#.....##
#.........#
#e.......e#
###########
enemies 2
door 0 : 0 1

6
3
#####D#####
#.........#
#.........#
#.........#
#.........#
#.........#
#.........#
#.........#
#.........#
#X........#
###########

3
0
#####D#####
#k#.....#.#
#.........#
#.......#.#
#.........#
#...#.#...D
#.........#
#.......#.#
#.........#
#.......#.#
#####D#####
key : 0

2
1
#####D#####
#.........#
#......#..#
#.......#.#
#.......#.#
D.........D
#..#......#
#.....#...#
#.........#
#.........#
#####D#####

0
2
###########
#.........#
#.#.#.#.#.#
#.........#
#..#.#....#
D.........#
#.#...#.#.#
#.........#
#..#.....##
#.........#
#####l#####
locked : 2

2
2
#####D#####
#......#k##
#......#.##
#.....##..#
#.p#####..#
D..###....#
#...##....#
#.........#
#.........#
#.........#
#####D#####
key : 1

2
0
###########
#?........#
#.........#
#....#....#
#.........#
#....@....D
#.........#
####......#
#.#.......#
#.........#
#####D#####
sign A useful tool lies just ahead.

3
2
#####D#####
#.........#
#.........#
#.........#
#.........#
d.........#
#.........#
#.........#
#.........#
#.........#
#####D#####

3
1
#####D#####
#......#..#
#.........#
#.........#
#.........#
D.........d
#.........#
#.#.......#
#..#......#
#.........#
#####D#####

4
2
#####D#####
#.........#
#.#.#...#.#
#.........#
#..#...#..#
D.........#
#.#.#.#...#
#.........#
#..#...#.##
#........k#
#####l#####
key : 3

4
0
#####D#####
#.........#
#.#...#.#.#
#.........#
#...#.#.#.#
#.........D
#...#.#.#.#
#.........#
#.#.#.#.#.#
#.........#
###########

5
2
#####l#####
#.........#
#.........#
#.........#
#.........#
D..##.....d
#...#.....#
#.........#
#.........#
#.........#
###########
locked : 3

