2
2
#####.#####
#.........#
#...#.....#
#.........#
#.........#
l..#.......
#.........#
#.#.......#
#..#......#
#.........#
###########
locked : 5

4
1
#####.#####
#k........#
##..#..#..#
#.........#
#.........#
....#..#..l
#.........#
#.........#
##..#.....#
#.........#
###########
key : 0

5
3
#####d#####
#.........#
#..#.....##
#.#.......#
#.........#
#.........#
#.....#...#
#.......#.#
#......#..#
#.........#
#####d#####

1
2
###########
#......#..#
#.........#
#.........#
#..###....#
....##....d
#..##.....#
######....#
#..##.....#
#.........#
#####.#####

0
0
###########
##.....#.k#
#.........#
#.#.#.#.#.#
#.........#
#....#.#..#
#.........#
#...#.#...#
#.........#
##.....#.##
#####.#####
key : 5

3
0
#####.#####
#.........#
#.........#
#.........#
#.##@#....#
#....#.....
#..#..#.#.#
#?####..###
##..#.#..##
#......#..#
#####.#####
sign The brave are rewarded.

4
3
#####.#####
#.........#
#..#......#
#.#.......#
#.........#
..........#
#.........#
#.#.....#.#
#..#...#..#
#.........#
#####d#####

3
1
#####.#####
#.........#
#..#..#...#
#.........#
#.........#
...#..#...#
#.........#
#.........#
#..#..#..##
#........k#
#####.#####
key : 3

1
1
###########
#e..se?...#
#.........#
#.........#
#.........#
...........
#.........#
#.........#
#.........#
#e........#
#####.#####
enemies 3
switch 0 : 0 1
sign Only the prepared may pass.

2
0
#####.#####
#?........#
#.........#
#.........#
#.........#
#e........l
#e#.......#
#.........#
#.........#
#..#......#
#####.#####
enemies 2
door 0 : 0 1
sign Turn back; you are not yet ready.

2
3
#####.#####
#e......#e#
#####.....#
###e#.....#
#...###...#
...####...#
#.#####...#
#.###s#...#
#.###.#...#
#.........#
#####.#####
enemies 3
switch 1 : 2 3

3
3
#####.#####
#.........#
#.........#
#.........#
#.....#...#
#e....e#..#
#....##...#
#.........#
#.........#
#.........#
#####.#####
enemies 2
door 1 : 2 3

2
1
#####.#####
#.........#
#.........#
#.........#
#.........#
l.........l
#.........#
#.........#
#.........#
#.........#
#####.#####
locked : 2

1
3
###########
#.........#
#..#......#
#.#.......#
#.........#
d.........#
#.........#
#.........#
#.........#
#.........#
#####.#####

4
0
#####.#####
#......#..#
#...#..#..#
#...#..#..#
#.....#.#.#
#..........
#.........#
#.........#
#.........#
#.........#
###########

7
3
#####.#####
#.........#
#.........#
#....#....#
#.....##..#
#....###..#
#......#..#
#.........#
#.........#
#X........#
###########

4
2
###########
#.........#
#..#.....##
#.........#
#.........#
l..#..#....
#.........#
#.........#
#.....#..##
#.........#
###########
locked : 0

1
0
#####.#####
###.......#
###...###.#
#k###.###.#
#.##..#.#.#
#..........
#.........#
#.........#
#.........#
#.........#
#####.#####
key : 2

6
3
#####d#####
#......####
#..#...#.##
#..###...##
#...e##...#
#....###..#
#.........#
#.........#
#.........#
#.........#
#####.#####
boss
enemies 1

