5
2
#####d#####
#.........#
#.........#
##..#.....#
#.........#
D..#......#
#.##......#
#.#.......#
#.###.....#
#.........#
###########

2
2
###########
#........k#
#...#.....#
#.........#
#.........#
D....#....#
#.........#
#.........#
#...#.....#
#.........#
###########
key : 4

4
2
###########
#.........#
#.....##..#
#.......#.#
#.........#
d.........D
#.........#
#.......#.#
#......#..#
#.........#
#####d#####

5
0
#####D#####
#.........#
##.#...#.##
#.........#
#....#.#..#
#.........D
#..#.#.#..#
#.........#
#..#...#..#
#.........#
#####D#####

2
1
#####d#####
#.........#
#.........#
#....###..#
#....###..#
D....##...D
#....##...#
#.........#
#.........#
#.........#
#####D#####

8
1
#####D#####
#.........#
#...#.#...#
#...#.....#
#.........#
#.........#
#.........#
#.........#
#.........#
#X........#
###########

6
0
#####D#####
#.........#
#.........#
#.........#
#....##...#
#....#....d
#...#k#...#
#.........#
#.........#
#.........#
#####D#####
key : 1

5
1
#####D#####
#.........#
#.........#
#..#..#..##
#.........#
D.........D
#..#..#...#
#.........#
#.........#
#..#......#
#####D#####

4
0
#####l#####
#?##......#
#...#..#..#
#.#.##.#..#
#..#...##.#
#....@....D
#.........#
#.........#
#.........#
#.........#
#####D#####
sign Only the prepared may pass.

4
1
#####D#####
#k........#
##.#...#.##
#.........#
#....#.#..#
D.........d
#....#.#..#
#.........#
##.#...#..#
#.........#
#####D#####
key : 0

3
0
#####D#####
#.........#
#..#......#
#.#.......#
#.........#
#.........D
#.........#
#.........#
#.........#
#.........#
#####l#####
locked : 0

6
1
#####D#####
#.........#
#..##.#...#
#......#..#
#....#.#..#
d...#.##..#
#.........#
#.........#
#.........#
#.........#
#####l#####

7
1
#####l#####
#.........#
#.........#
#.........#
#....##...#
D....e##..#
#.....###.#
#....######
#.......###
#.........#
#####D#####
locked : 4
boss
enemies 1

4
3
###########
##.#...#e##
#........?#
#.#.#.#.#.#
#.........#
D....#....#
#.........#
#.#.#.#.#.#
#.........#
##.#...#ee#
###########
enemies 3
sign Beware what lurks ahead.

7
0
#####D#####
#.........#
#..#......#
#.#.......#
#.........#
#.........D
#.........#
#.........#
#.........#
#.........#
###########

3
1
#####D#####
#e........#
##..#.....#
#..#......#
#.##......#
D..e##s#..#
#..#e#....#
#......#..#
#..#......#
#......#..#
#####D#####
enemies 3
switch 0 : 0 1

1
1
#####D#####
#.........#
#.........#
#.#.......#
#.#.......#
#..##.....#
#.#.......#
##.##.....#
#..#......#
#.........#
#####d#####

2
0
###########
#k........#
#.........#
#..#.....##
#.........#
#.........D
#...#.....#
#.........#
#.........#
#........##
#####D#####
key : 3

0
1
###########
#e.......e#
#e........#
####......#
#.........#
#..#......#
#.#.......#
####......#
#..#......#
#.........#
#####D#####
enemies 3
door 0 : 0 1

