6
3
###########
#.......ee#
#........e#
#.........#
#.........#
D.....#...#
#.#...##..#
###...##..#
#.#.......#
#.........#
#####D#####
enemies 3

4
0
#####D#####
##.#...#..#
#.........#
#k#.#.#.#.#
#.........#
#..#.#.#..D
#.........#
#.....#.#.#
#.........#
#..#...#..#
#####D#####
key : 0

0
0
###########
#k........#
#..#......#
#.#.......#
#.........#
#.........#
#.........#
#.........#
#.........#
#.........#
#####D#####
key : 1

7
3
#####D#####
##.....#..#
#.........#
#.........#
#.#..#....#
D.........#
#.........#
#...#..#..#
#.........#
#........k#
###########
key : 4

4
1
#####D#####
#.........#
#.........#
#..#..#..##
#.........#
D.........D
#...#..#..#
#.........#
#.........#
#..#......#
#####d#####

1
0
#####D#####
#.........#
#.........#
#.........#
#.........#
#..#......#
#.#..#....#
#.##.#....#
##........#
#..#......#
#####d#####

6
1
#####d#####
#.........#
#.........#
#..#..#..##
#.........#
l.........l
#..#..#...#
#.........#
#.........#
#..#.....##
#####D#####
locked : 1

6
2
#####d#####
##.#...#.##
#.........#
#.......#.#
#.........#
l..#.#.#..D
#.........#
#.#...#.#.#
#.........#
##.....#.##
#####D#####
locked : 0

3
1
###########
#.........#
#.#.....#.#
#.........#
#.........#
D.........#
#.........#
#.........#
#.#.....#.#
#.........#
#####D#####

4
2
###########
#........X#
#.........#
#.......#.#
#.#.#.#.#.#
D..#......#
#..#......#
#.........#
#.........#
#.........#
#####D#####

7
1
#####D#####
#.#.......#
#.........#
#.........#
#.#..#..#.#
D.........D
#.........#
#.#..#..#.#
#.........#
#.........#
###########

7
2
#####D#####
#.........#
#......##.#
#.....#...#
#.....###.#
D.........D
#.........#
#.........#
#.........#
#.........#
###########

2
0
#####d#####
#.........#
#.........#
#.........#
#.........#
#..#......#
#.#.##....#
#...#.....#
#.........#
#.........#
#####D#####

5
1
#####d#####
##.#...#..#
#.........#
#.#...#.#.#
#.........#
D..#.#.#..D
#.........#
#.#.....#.#
#.........#
##.#......#
#####d#####

5
0
#####D#####
#.........#
#......#..#
#.......#.#
#.........#
#.........D
#.........#
#.......#.#
#......#..#
#.........#
#####D#####

5
2
#####D#####
#.........#
#.........#
#.........#
#.........#
D....e....#
#.##......#
#.........#
#.........#
#.........#
#####d#####
boss
enemies 1

3
0
#####D#####
#......##?#
#.......#.#
#.....#.#.#
#.........#
#....@....D
#.........#
#.........#
#.........#
#.........#
#####D#####
sign Something glints behind that door…

6
0
#####D#####
#.........#
#......#..#
#.......#.#
#.........#
#.........l
#.........#
#.#.......#
#..##.....#
#.........#
#####D#####

7
0
#####D#####
#.........#
#.........#
#.........#
#.........#
#.........D
#.........#
#.........#
#.........#
#k........#
###########
key : 2

