1
0
#####.#####
#.......#.#
#.........#
#.........#
#..##.....#
#....@....#
#..#......#
##.##.....#
#.#.#.....#
#.........#
#####.#####

3
2
#####l#####
#.........#
#.........#
#.........#
#.........#
..........l
#.........#
#.........#
#.........#
#.........#
#####.#####
locked : 0

4
1
#####.#####
#.........#
#..#...#..#
#.#.....#.#
#.........#
#..........
#.........#
#.#.....#.#
#..#...#..#
#.........#
#####d#####

3
3
###########
#.........#
#...#.#...#
#.#####...#
#.##.##...#
l..#......#
#.#..##...#
#.........#
#........##
#.........#
#####.#####
locked : 2

5
1
#####d#####
#.........#
#.......#.#
#.........#
#.........#
#.....#....
#.........#
#.........#
#.......#.#
#.........#
###########

5
4
#####.#####
#.........#
#.........#
#.........#
#...#.#...#
...##.....#
#.###.#...#
#...#.....#
#.........#
#........X#
###########

5
2
#####.#####
#.........#
#.........#
#.........#
#.........#
...........
#.........#
#.........#
#.........#
#....k....#
###########
key : 4

1
2
###########
#.........#
#...#...#.#
#.........#
#...#.#.#.#
#..........
#.#.....#.#
#.........#
#.....#.#.#
#.........#
#####l#####
locked : 1

1
3
###########
#.........#
#.........#
#.........#
#.........#
..........#
#.........#
#.........#
#.........#
#.........#
###########

4
2
#####.#####
##.#...#.##
#.........#
##...#.#.##
#.........#
...#......d
#.........#
##...#.#.##
#.........#
##.#......#
#####.#####

2
1
###########
##....k#..#
#.........#
#.........#
#.#..#..#.#
...........
#.........#
##..#.....#
#.........#
#.........#
#####.#####
key : 0

4
4
###########
#.........#
#.........#
#.........#
#.........#
d....e....#
#.........#
#.........#
#.........#
#.........#
#####.#####
boss
enemies 1

2
0
#####.#####
#.........#
#.........#
##..#..#..#
#.........#
#..........
#......#..#
#.........#
#.........#
##.....#..#
#####d#####

4
3
#####.#####
#.........#
#.........#
#...#.#...#
#...###...#
d...#.##..d
#...#.....#
#...#.###.#
##....#.#.#
#.........#
#####.#####

2
2
#####l#####
#.........#
#.........#
#.....#..##
#........k#
..........#
#..#..#...#
#.........#
#.........#
#..#.....##
#####l#####
key : 1

3
0
#####d#####
#.........#
#.........#
#.........#
#.........#
#..........
#.........#
#.#.......#
#..#......#
#.........#
###########

0
0
###########
#.........#
#..#......#
#.#.......#
#.........#
#.........#
#.........#
#.#.......#
#..#......#
#.........#
#####.#####

5
3
#####.#####
#.........#
#.........#
#.........#
#.........#
...........
#.........#
#.........#
#.........#
#....e....#
###########
enemies 1

3
1
#####.#####
#k........#
#...#.....#
#.........#
#.........#
...........
#.........#
#.#.......#
#..#...#..#
#.........#
#####.#####
key : 2

