2
1
#####.#####
#.........#
#.........#
#.........#
#.........#
...........
#.........#
#.........#
#.........#
#.........#
#####l#####
locked : 1

3
2
#####.#####
#........##
#.........#
#....##...#
#.....#...#
....#.#....
#..#......#
#.........#
#.#.......#
#.e..e....#
###########
enemies 2

2
3
#####d#####
#e........#
#.........#
#.........#
#....#....#
...........
#.........#
#.........#
#.........#
#?........#
#####d#####
enemies 1
sign A useful tool lies just ahead.

2
4
###########
#...k.....#
#.#.#.#.#.#
#.........#
#..#...#..#
..........l
#.#.#.#.#.#
#.........#
#..#.....##
#.........#
#####.#####
key : 3

4
1
#####.#####
#......##.#
#...#.###.#
#.....###.#
#....####.#
....####..#
#.........#
#.........#
#.........#
#.......ee#
###########
enemies 2

3
1
#####l#####
#k........#
#.........#
#.........#
#.........#
...........
#.........#
#.........#
#.........#
#.........#
#####.#####
key : 0

0
3
###########
#k........#
#.........#
#.........#
#.........#
#....#....#
#..###....#
#...#.....#
#..##.....#
#.........#
#####.#####
key : 4

1
5
###########
#.........#
#.........#
#.........#
#.........#
#.........d
#.........#
#.......#.#
#......#..#
#.........#
#####l#####
locked : 4

3
4
#####.#####
#.........#
#.........#
#.........#
#.........#
..........#
#.........#
#.........#
#.........#
#.......ee#
###########
enemies 2

2
0
###########
#.........#
#..#......#
#.#.......#
#.........#
#..........
#.........#
#.........#
#.........#
#.........#
#####.#####

4
0
#####.#####
#.........#
#.#.....#.#
#.........#
#.........#
#..#.......
#.........#
#.........#
#.#.......#
#k........#
###########
key : 1

2
2
###########
#.......#.#
#.........#
#.#.....#.#
#.........#
......#....
#.........#
#...#...#.#
#.........#
#.#.....#.#
#####.#####

3
3
#####d#####
#.........#
#.........#
#.........#
#.........#
...........
#.........#
#......#..#
#.........#
#.........#
###########

1
3
#####.#####
#.........#
#......#..#
#.........#
#.........#
#.........#
#.........#
#.........#
#.........#
#.........#
#####d#####

3
0
#####.#####
#.........#
#.........#
#.........#
#.........#
#?...@.....
#.........#
#.........#
#.........#
#.........#
#####.#####
sign What you seek is close.

1
1
###########
#.........#
#..#......#
#.#.......#
#.........#
#.........#
#.........#
#.........#
#.........#
#.........#
#####.#####

2
6
#####.#####
#.........#
#.........#
#.........#
#.........#
...#......#
#.........#
##........#
#.........#
#........X#
###########

2
5
#####l#####
#.........#
#.........#
#..#..#..##
#.........#
l..........
#...#..#..#
#.........#
#.........#
#..#......#
###########
locked : 0

1
6
###########
#.........#
#..#......#
#.........#
#.........#
d....e....#
#.........#
#.........#
#..#......#
#.........#
#####.#####
boss
enemies 1

