4
1
#####.#####
#.........#
#.........#
#.........#
#.........#
#.....#...#
#..#......#
#.........#
#.........#
#k........#
###########
key : 1

2
4
#####.#####
#.........#
##.....#.##
#.........#
#.#.#.#.#.#
l.........l
#..#.#.#..#
#.........#
#...#.#.#.#
#.........#
#####d#####
locked : 0

3
1
#####.#####
##........#
#.........#
#.........#
#......#..#
...........
#.........#
##.....#..#
#.........#
#.........#
#####.#####

3
4
#####d#####
#.........#
#.##......#
#..#......#
#..##.....#
#..###....#
#...e#....#
#..#......#
###.#...#.#
#.........#
#####.#####
boss
enemies 1

2
0
###########
#.........#
#.........#
#.........#
#.........#
#....@.....
#.........#
#.........#
#.........#
#.........#
#####.#####

2
1
###########
#.........#
#..#......#
#.....#...#
#....#....#
....###....
#.#..#....#
#.........#
#.........#
#.........#
#####.#####

1
2
#####d#####
#.........#
##.......##
#.........#
#...#.....#
#..........
#..#.#....#
#.........#
#...#...#.#
#.........#
#####.#####

4
4
#####.#####
#.........#
#.........#
#.........#
#...#.....#
#.........#
#.........#
#.........#
#.........#
#X........#
###########

3
2
#####d#####
#.........#
#.........#
#.........#
#.........#
..........#
#.........#
#.......#.#
#......#..#
#.........#
###########

2
3
#####d#####
#.........#
#.........#
#.........#
#...##..#.#
....####..l
#....###..#
#....###..#
#...#...#.#
#.........#
###########

2
2
#####.#####
#.........#
#.#.#.#...#
#.........#
#...#.#.#.#
...........
#.#.#.#...#
#.........#
#.#.#.#.#.#
#.........#
#####d#####

1
5
###########
#........k#
#.........#
#.........#
#.........#
..........#
#.........#
#.........#
#.........#
#.........#
#####.#####
key : 2

1
3
#####.#####
#.........#
#.........#
#.........#
#....####.#
...##..#...
#...##.#..#
#....#....#
#.......#.#
#.........#
#####d#####

0
2
###########
#.........#
#......#..#
#.........#
#.........#
#....#.....
#.........#
#.........#
#......#..#
#.........#
#####d#####

0
3
###########
##e..ee#s.#
#.........#
#.........#
#...#..#..#
...........
#.........#
#...#..#..#
#.........#
#?........#
#####.#####
enemies 3
switch 0 : 0 1
sign A useful tool lies just ahead.

1
4
#####.#####
#e#.....#e#
#.........#
#..#.#.#.##
#.........#
....#.#....
#.........#
#..#.....##
#.........#
#e........#
#####.#####
enemies 3
door 0 : 0 1

2
5
#####.#####
#.........#
#......#..#
#.........#
#.........#
l.........#
#......##.#
#.#.....#.#
#..#...#..#
#.........#
###########
locked : 1

0
4
###########
#.#.....#k#
#.........#
#...#.#.#.#
#.........#
....#.#...#
#.........#
#.#...#.#.#
#.........#
#.#.....#.#
#####.#####
key : 3

3
0
#####.#####
#.........#
#.........#
#.........#
#.........#
#..........
#.........#
#.........#
#.........#
#k........#
###########
key : 0

