4
4
###########
#.......ee#
#.........#
#....#.#..#
#......#..#
D......#..#
#.........#
#.........#
#.........#
#........e#
###########
enemies 3

1
0
###########
#X........#
#.........#
#.........#
#.........#
#.........D
#.........#
#.........#
#.........#
#.........#
#####D#####

5
2
#####D#####
#.........#
#.........#
#.........#
#.........#
D.........#
#.........#
#.........#
#.........#
#........k#
###########
key : 3

3
3
###########
##.#...#..#
#.........#
##.#.#.#.##
#.........#
D..#.#.#..#
#.........#
##.#.#.#.##
#.........#
##.....#.##
#####D#####

5
1
#####D#####
#.........#
#......#..#
#.......#.#
#.........#
D.........D
#.........#
#.......#.#
#......#..#
#.........#
###########

0
1
###########
#e.......e#
#.........#
#.....#...#
#......#..#
#...##.#..#
#...##....#
##..##....#
#.#.......#
#.........#
#####D#####
enemies 2
door 0 : 0 1

4
1
#####D#####
#.........#
#.#s#.....#
#.e#?.....#
#.###.....#
D..#......d
#.........#
#.........#
#.........#
#..p......#
#####D#####
enemies 1
switch 0 : 0 1
sign The brave are rewarded.

3
0
#####l#####
#.........#
#..##.##..#
#...#..#..#
#...#.#...#
#..#..#...D
#...#.##..#
#.........#
#.........#
#.........#
#####D#####

3
2
#####d#####
#k........#
#.........#
#.........#
#.........#
D.........D
#.........#
#.........#
#.........#
#.........#
#####D#####
key : 2

2
0
#####D#####
#.........#
#.........#
#.........#
#.........#
#.........D
#....#..#.#
#.........#
#.........#
#.........#
#####l#####
locked : 0

4
2
#####D#####
#.........#
#.....#..##
#.........#
#.........#
d..#..#...D
#.........#
#.........#
#.....#..##
#.........#
#####D#####

2
2
#####D#####
#.........#
#..##.....#
#.##......#
#..#......#
D.........#
#.........#
#.........#
#.......p.#
#.........#
#####d#####

2
1
#####d#####
#.#.......#
#.........#
#...#.#.#.#
#.........#
D...#.....D
#.........#
#.#.#.#.#.#
#.........#
#.#.....#.#
#####d#####

4
0
#####D#####
#.........#
#.........#
#.........#
#.........#
#?...@....D
#.........#
#.........#
#.........#
#.........#
#####D#####
sign Those who search shall find.

5
0
#####D#####
#.........#
#.........#
#.........#
#....#.##.#
#....##...D
#.....##..#
#.....#...#
#......#.##
#k........#
###########
key : 0

4
3
#####D#####
#.........#
#.........#
##.....#..#
#.........#
D.........D
#.#..#..#.#
#.........#
#.........#
##.....#..#
###########

3
1
#####d#####
#k........#
#.........#
#.........#
#.........#
D.........D
#.........#
#.........#
#.........#
#.........#
#####D#####
key : 1

1
1
#####D#####
#.........#
#.........#
#.........#
#....#....#
D..#.e....D
#..###....#
#..#......#
#.........#
#.........#
#####d#####
boss
enemies 1

1
2
###########
#.........#
#.#.#.#...#
#.........#
#.#.#.#.#.#
D.........#
#.#.#.#.#.#
#.........#
#.#...#.#.#
#.........#
#####D#####

