7
2
#####d#####
#.........#
#......#..#
#.......#.#
#.........#
D.........#
#.........#
#.......#.#
#......#..#
#.........#
###########

7
1
#####D#####
#.........#
##.....#..#
#.......#.#
#.........#
#.........D
#.........#
#.........#
#.........#
#k........#
###########
key : 7

2
0
#####D#####
#.........#
#..#......#
#.#.......#
#.........#
#.........l
#.........#
#.......#.#
#......#..#
#.........#
###########

6
1
#####D#####
#.......###
#...#....##
#..#e###e##
#?...####.#
#s.#.#e#..D
#.........#
#.........#
#.........#
#.........#
#####D#####
enemies 3
switch 0 : 0
sign Those who search shall find.

6
3
#####D#####
#.........#
#.#.#.#.#.#
#.........#
#..#.#.#..#
D.........#
#...#...#.#
#.........#
#..#...#.##
#......e.e#
###########
enemies 2
door 0 : 0

6
2
#####d#####
#.........#
#..#......#
###.......#
#.........#
D.........D
#.........#
#......#..#
#.........#
#.........#
#####d#####

3
2
#####D#####
#.........#
#.........#
#.........#
#.........#
d.........#
#..#......#
#.#.#.....#
#.....###.#
#.........#
#####D#####

4
3
###########
#........k#
#.....#...#
#...###...#
#...#.#...#
D.........#
#.........#
#.........#
#.........#
#.........#
#####D#####
key : 2

2
1
#####D#####
#.........#
#......#..#
#.......#.#
#.....#...#
l.........D
#.........#
#.....#...#
#.........#
#..#......#
#####D#####
locked : 0

5
1
#####d#####
#.........#
#..#..#..##
#.........#
#.........#
#.....#...D
#.........#
#.........#
#........##
#.........#
#####D#####

1
1
###########
#........k#
#.......#.#
#.........#
#.........#
D.....#...#
#.........#
#.........#
#.#.....#.#
#.........#
#####D#####
key : 0

4
1
#####D#####
#..#.....##
#.........#
#.........#
#...#.....#
#.........D
#.........#
#..#..#..##
#.........#
#.........#
#####d#####

2
2
###########
#........k#
#.....#...#
#.........#
#.........#
D..#......#
#.........#
#.........#
#..#..#..##
#.........#
#####D#####
key : 1

1
0
#####D#####
#.........#
#.........#
#.........#
#.........#
#....@....D
#?#..#..p.#
#.........#
##........#
##.#......#
#####D#####
sign Strange symbols cover the floor.

3
1
#####D#####
#.........#
#..#......#
#.#.......#
#.........#
#.........d
#.........#
#.........#
#.........#
#.........#
#####D#####

4
2
#####D#####
##e#...#e##
#.........#
#.#.#.#.#.#
#.........#
D..#.#....D
#.........#
#.#.....#.#
#.........#
##.....#.##
#####D#####
enemies 2

5
3
#####D#####
#.........#
#.........#
#.........#
#.........#
D........X#
#.........#
#.........#
#.........#
#.........#
#####D#####

0
0
###########
#.........#
#..#...#..#
#..#####..#
#..##..#..#
#...##....#
#....###p.#
#...###...#
#...#..#..#
#.........#
#####D#####

5
2
#####D#####
#..#......#
#.........#
#...#.###.#
#...#..##.#
D...####..D
#...e#....#
#....##.#.#
#.........#
#.........#
#####d#####
boss
enemies 1

