5
2
#####l#####
##.....#.##
#.........#
##.#.#.#.##
#.........#
#....#....#
#.........#
##.#.#.#.##
#.........#
#..#...#..#
###########
locked : 3

4
0
#####.#####
#.........#
#.#.#.#...#
#..##.#...#
#.#.####..#
#....##....
#...###...#
#....#.#..#
#...#...#.#
#.........#
###########

2
0
###########
#......#.##
#.........#
#.#.#.#.#.#
#.........#
#..#.#.#...
#.........#
#.#.#.#...#
#.........#
##.#.....##
#####d#####

2
4
###########
##.....#ee#
#.........#
#.........#
#.#..#..#.#
..........#
#.........#
##..#.....#
#.........#
#........e#
###########
enemies 3

0
1
###########
#.......#k#
#.........#
#.........#
#..#..#...#
#.........#
#.........#
#.#..#..#.#
#.........#
#.........#
#####.#####
key : 4

2
3
#####.#####
#.........#
#.........#
#.........#
#.#.......#
.....#.....
#.........#
#.#.......#
#..#......#
#.........#
#####d#####

3
2
#####.#####
#e........#
#.........#
#.........#
#.........#
...........
#.........#
#.........#
#.........#
#.........#
#####.#####
enemies 1

3
1
#####.#####
#.........#
#.........#
##..#..#..#
#.........#
...........
#.#..#....#
#.........#
#.........#
##.....#..#
#####d#####

1
3
#####.#####
#.........#
#.##......#
##........#
#.###.....#
l....e....#
#.#.......#
#.........#
#.........#
#.........#
#####.#####
locked : 4
boss
enemies 1

1
1
#####.#####
#.........#
#.........#
#.......#.#
#.........#
#k.........
#.........#
#.......#.#
#.........#
#.........#
#####.#####
key : 0

3
0
#####d#####
#..#......#
#.###.....#
#.#.##.#..#
#?#.#@....#
#...###....
#...#.#...#
#.........#
#.........#
#.........#
#####.#####
sign Beware what lurks ahead.

3
3
#####d#####
#.........#
#...#.....#
#.........#
#.........#
.....#....#
#.........#
#.........#
##........#
#.........#
#####.#####

0
3
###########
#X.#...#..#
#...#..#..#
#..###....#
#...##.#..#
#.....#...#
#.........#
#.........#
#.........#
#.........#
#####.#####

1
2
###########
#....k....#
#.........#
#.........#
#.........#
..........l
#.........#
#.#.....#.#
#..#...#..#
#.........#
#####.#####
key : 3

4
1
#####d#####
#..#.....##
#.........#
#.........#
#..#..#...#
...........
#.........#
#.....#..##
#.........#
#.........#
###########

4
2
#####.#####
#.........#
#.........#
#.........#
#.........#
..........d
#.........#
#.#.......#
#..#......#
#.........#
#####l#####

4
3
#####.#####
##.....#.##
#.........#
##.#.#.#.##
#.........#
d..#.#....#
#.........#
##.#.#.#..#
#.........#
##.#...#.##
###########

2
2
#####.#####
#k........#
#.#...#.#.#
#.........#
#.....#.#.#
...........
#.#...#.#.#
#.........#
#...#.#.#.#
#.........#
#####.#####
key : 1

2
1
#####.#####
#.........#
##..#.....#
#.........#
#.........#
....#..#...
#.........#
#.........#
##.....#..#
#.........#
#####.#####

