5
2
#####d#####
#.##......#
#.....#...#
#.#..##...#
#.#.#.#...#
....#.....#
#.........#
#.........#
#......#..#
#.........#
#####d#####

4
1
#####.#####
#e.......e#
#..#..#..##
#.........#
#.........#
...#..#....
#.........#
#.........#
#..#.....##
#........e#
#####.#####
enemies 3

2
0
#####.#####
#.........#
#.#...#...#
#.....#...#
#..###e...#
#.....#...#
#..##.....#
#s#e##....#
#.#.......#
#.........#
#####.#####
enemies 2
switch 0 : 0

7
0
#####.#####
##........#
#.........#
#.........#
#...#..#..#
#..........
#.........#
#...#..#..#
#.........#
#k........#
###########
key : 4

0
0
###########
#.........#
#......#..#
#.......#.#
#.........#
#.........d
#.........#
#.#.....#.#
#..#...#..#
#.........#
#####.#####

3
0
#####.#####
#.........#
#......#..#
#.......#.#
#.........#
#.........l
#.........#
#k#.......#
#..#......#
#.........#
#####.#####
key : 0

6
2
#####d#####
#e.......e#
#...#....##
#...#.....#
#.........#
......#....
#.........#
#.........#
#.........#
#?...e....#
###########
enemies 3
sign A useful tool lies just ahead.

1
0
#####.#####
#.#.....#.#
#.........#
#.#.#.#.#.#
#.........#
#...#.....#
#.........#
#.....#...#
#.........#
#.#.......#
#####.#####

5
0
#####.#####
#.........#
##.#...#..#
#.........#
#.#.#.#.#.#
#..........
#..#.#.#..#
#.........#
#.#...#...#
#.........#
#####.#####

3
1
###########
#.........#
####......#
####......#
#.#.......#
l..........
#.........#
#.........#
#.........#
#.........#
#####.#####
locked : 0

5
1
#####.#####
#k........#
#.........#
#...#.....#
#.........#
...........
#.........#
#.........#
#.....#...#
#.........#
#####.#####
key : 2

0
1
###########
#.........#
#...#.#.#.#
#.........#
#.#.#.#.#.#
d.........#
#.#.#.#.#.#
#.........#
#.#.#.#.#.#
#.........#
###########

4
0
#####.#####
#.........#
#........##
#....##...#
#...@##...#
#....##....
#....#.#..#
#.........#
#.........#
#.........#
#####.#####

7
1
#####d#####
#.........#
#.........#
#.........#
#.........#
..........#
#.........#
#.........#
#.........#
#.........#
###########

3
2
###########
#........X#
#.........#
#....###..#
#....#....#
.......#..#
#.........#
#.........#
#.........#
#.........#
#####.#####

6
3
###########
##.....#k##
#.........#
##.....#..#
#.........#
...#.#.#..#
#.........#
##.#.#...##
#.........#
##.......##
###########
key : 6

6
0
#####.#####
#e........#
#..#..#...#
#..##.....#
#.........#
#e.........
#e#..##...#
#....##...#
#......#..#
#.........#
#####.#####
enemies 3
door 0 : 0

6
1
#####.#####
#.........#
#..#...#..#
#.#.....#.#
#.........#
...........
#.........#
#.........#
#.........#
#.........#
#####d#####

4
2
#####.#####
#.........#
#.........#
#.........#
#.........#
.....e....#
#.........#
#.........#
#.........#
#.........#
#####d#####
boss
enemies 1

