8
1
#####.#####
#.........#
#.........#
#####.....#
#...#.....#
#...#.....#
#.###.....#
#.###.....#
#.........#
#X........#
###########

5
1
#####d#####
#.........#
#.........#
#..#.....##
#.........#
..........#
#...#.....#
#.........#
#.........#
#..#.....##
#####l#####

4
3
###########
#.........#
#...#.#.#.#
#.........#
#..#.#....#
l.........#
#.....#.#.#
#.........#
#........##
#.........#
###########
locked : 2

3
1
#####.#####
#k........#
#......#..#
#.......#.#
#.........#
...........
#.........#
#.......#.#
#......#..#
#.........#
#####.#####
key : 1

3
2
###########
##.#...#.##
#.........#
##.#.#.#.##
#.........#
.......#..#
#.........#
#..#.#.#.##
#.........#
##.#...#.##
#####.#####

7
1
#####d#####
##........#
#...#.#...#
##..##....#
#..###....#
#....e....#
#.........#
#.........#
#.........#
#.........#
#####.#####
boss
enemies 1

6
2
###########
#.........#
#......#..#
#.......#.#
#.........#
l.........#
#.........#
#.#.....#.#
#..#...#..#
#.........#
###########
locked : 0

5
0
#####d#####
#.#.....#.#
#.........#
#.#.#.#.#.#
#.........#
#...#.#....
#.........#
#.#.#.#.#.#
#.........#
#.#.....#.#
#####.#####

2
1
#####.#####
#.........#
#.#.......#
#.........#
#.........#
.........k#
#......#..#
#.........#
#.........#
#.........#
#####.#####
key : 0

6
1
#####l#####
#.........#
#......#..#
#.......#.#
#.........#
..........l
#.........#
#.#.....#.#
#..#...#..#
#.........#
#####d#####
locked : 4

1
1
###########
##........#
#.........#
##........#
#.........#
..........#
#.........#
#.........#
#.........#
#.........#
#####.#####

4
1
#####.#####
#k........#
#...#.....#
#....#....#
#....#....#
...........
#.........#
#.........#
#.........#
#.........#
#####d#####
key : 2

6
0
#####.#####
#.........#
#.#.#.#.#.#
#.........#
#....#.#..#
#..........
#...#.#.#.#
#.........#
#..#......#
#k........#
###########
key : 4

4
2
#####.#####
#.........#
#.........#
##.....#..#
#.........#
..........l
#.#..#..#.#
#.........#
#.........#
##.....#..#
###########

1
0
#####.#####
#e........#
##........#
#?........#
#.........#
#..........
#..#......#
#.........#
#.........#
#.........#
#####.#####
enemies 1
sign Beware what lurks ahead.

2
0
#####.#####
#.........#
#..#......#
#.........#
#.....#.#.#
#?...@#....
#.........#
#.........#
#.#.......#
#.........#
#####.#####
sign Those who search shall find.

3
0
#####.#####
#.........#
#.#.#.#.#.#
#.........#
#....#.#..#
#..........
#.#.#.#.#.#
#.........#
#..#...#.##
#.........#
#####d#####

4
0
#####d#####
#.........#
#..#...#..#
#.#.....#.#
#.........#
#..........
#.........#
#.......#.#
#...#..#..#
#.........#
#####d#####

0
0
###########
#.........#
#.........#
#.........#
#.........#
#.........#
#.........#
#.........#
#.........#
#.........#
#####.#####

