3
0
#####.#####
##.#...#.##
#.....##..#
#.#.#..##.#
#?#.@##.#.#
#....#.....
#.........#
#........##
#.........#
#.........#
#####.#####
sign Beware what lurks ahead.

1
0
#####d#####
##.....#..#
#.........#
#.........#
#......#..#
#.........d
#.........#
##..#..#..#
#.........#
#.........#
#####d#####

6
1
#####.#####
#.........#
#.........#
#..###....#
#.........#
...#.#....#
#...#..#..#
#...#..##.#
#.........#
#........e#
###########
enemies 1

6
0
#####.#####
#.......#.#
#...#..#..#
#....##...#
#...#.#...#
#...#.##...
#.........#
#.........#
#s........#
#e........#
###########
enemies 1
switch 0 : 0 1

5
0
#####d#####
#.......#.#
#.........#
#.........#
#.#.....#.#
#..........
#.........#
#.#..#..#.#
#.........#
#.........#
#####.#####

2
0
#####d#####
##.#...#.##
#.........#
##.#.#...##
#.........#
#....#.#...
#.........#
#....#.#.##
#.........#
##.#...#.##
#####.#####

1
2
###########
#........X#
#.........#
#.........#
#.........#
..........#
#.........#
#.........#
#...#.....#
#.........#
#####.#####

4
0
#####.#####
#.........#
#.........#
#.........#
#.....###.#
#......#...
#.....##..#
#.........#
#.........#
#.........#
#####d#####

0
0
###########
#.........#
#.#.#.#...#
#.........#
#..#......#
#.........#
#.....#.#.#
#.........#
#........##
#.........#
#####d#####

1
1
###########
#.........#
#......#..#
#.......#.#
#.#.......#
d..........
#.........#
#.#.......#
#..#......#
#.........#
#####.#####

4
3
###########
#........k#
#.#.....#.#
#.........#
#.#.#...#.#
..........#
#.#.#...#.#
#.........#
#.#.#.#...#
#.........#
###########
key : 3

2
1
#####.#####
####......#
#.##......#
#..#......#
#.####....#
...#......l
#.........#
#.........#
#.........#
#.........#
#####.#####

3
2
#####.#####
#e........#
#......#..#
#.........#
#.........#
.........e#
#.........#
#.........#
#.#.......#
#?........#
#####.#####
enemies 2
sign Only the prepared may pass.

5
2
#####.#####
#.........#
####......#
#.##......#
#.###.....#
....#.....#
#.#.......#
#.........#
#........e#
#.......ee#
###########
enemies 3
door 0 : 0 1

4
1
#####.#####
#k........#
##.#......#
#.........#
#...#.....#
...........
#..#.#.#..#
#.........#
#.#...#.#.#
#.........#
#####.#####
key : 0

5
1
#####.#####
#k........#
#..#......#
#.#.......#
#.........#
...........
#.........#
#.......#.#
#......#..#
#.........#
#####.#####
key : 2

3
1
#####.#####
#.........#
#.........#
#.........#
#.........#
...........
#.........#
#.........#
#.........#
#.........#
#####.#####

4
2
#####.#####
#k........#
##.....#.##
#.........#
#..#...#..#
...........
#..#.#.#..#
#.........#
##.#...#.##
#.........#
#####.#####
key : 1

2
2
#####.#####
#.........#
#.........#
#.#.#.....#
#..##.....#
l....e....#
#.........#
#.........#
#.........#
#.........#
#####.#####
locked : 0
boss
enemies 1

