1
1
###########
#.........#
#.........#
#..#.#....#
#..####...#
D..####...d
#.........#
#.........#
#.........#
#.........#
#####D#####

4
0
#####D#####
#.........#
#.........#
#...#..#..#
#.........#
#.........D
#...#..#..#
#.........#
#.........#
#.........#
###########

2
3
#####D#####
#k#.......#
#.........#
#.........#
#..#..#...#
D.........l
#.........#
#....#..#.#
#.........#
#.........#
#####d#####
key : 5

2
2
#####D#####
#......#..#
#.........#
#.#.#...#.#
#.........#
D..#.#....D
#.........#
#.#...#.#.#
#.........#
##.#......#
#####d#####

3
3
#####d#####
#.........#
#.........#
#.........#
#.........#
D..##e....#
#.####....#
###..#....#
##........#
#.........#
#####D#####
boss
enemies 1

3
0
#####D#####
##?#...#.##
#.........#
#e#.#.#.#.#
#.........#
#..#......D
#.........#
#e#.#...#.#
#.........#
##.....#.##
#####D#####
enemies 2
sign The brave are rewarded.

3
1
#####D#####
#k........#
##..#..#..#
#.........#
#.........#
D...#..#..D
#.........#
#.........#
##..#..#..#
#.........#
#####d#####
key : 0

4
3
#####D#####
#.........#
#..##..#..#
#..####...#
#...###...#
D..##.##..#
#..#...#..#
#.........#
#.........#
#........X#
###########

0
2
###########
#k#.....#.#
#.........#
#..#.#.#..#
#.........#
#...#.#...#
#.........#
#..#.#....#
#.........#
#.#.....#.#
#####D#####
key : 6

2
0
#####D#####
#.........#
#.........#
#.........#
#.........#
#....@....D
#.........#
#.........#
#.........#
#.........#
#####D#####

2
1
#####D#####
#.#.......#
#.........#
#.........#
#..#..#...#
D.........D
#.........#
#.#..#..#.#
#.........#
#.........#
#####D#####

1
0
#####l#####
#.........#
#..#......#
#.#.......#
#.........#
#.........D
#.........#
#.......#.#
#......#..#
#.........#
#####D#####

3
2
#####d#####
#.........#
#......#..#
#.......#.#
#.........#
D.........D
#.........#
#.........#
#.........#
#.........#
#####D#####

0
0
###########
#.........#
#.........#
#.........#
#.........#
#.....#...#
#.....#.#.#
#.........#
#.........#
#.........#
#####l#####
locked : 0

4
2
#####D#####
#.........#
#..#......#
#.#.......#
#.........#
D.........D
#.........#
#.........#
#.........#
#....k....#
###########
key : 7

2
4
###########
#.........#
#..#......#
#.#.......#
#.........#
l.........#
#.........#
#.........#
#.........#
#.........#
###########
locked : 7

1
3
###########
#......?ee#
#.....###e#
#.....#...#
#.........#
D...p.....#
#.p.......#
#.........#
#.........#
#.........#
#####D#####
enemies 3
sign Something glints behind that door…

4
1
#####d#####
#.........#
#..##.#...#
#..##.#...#
#...#.#...#
D..####...D
#...#.....#
#.........#
#...#.....#
#.........#
###########

1
2
#####D#####
#.........#
#.........#
#.........#
#.........#
d.........D
#.........#
#.........#
#.........#
#.........#
#####D#####

