1
4
#####.#####
#.........#
#.........#
#.........#
#....#....#
d....e.....
#..#......#
##........#
#.........#
#.........#
#####.#####
boss
enemies 1

3
2
#####.#####
#.........#
#.........#
#.........#
#...#.....#
l....#....l
#..#......#
#...#.#...#
#..##.#...#
#.........#
#####.#####
locked : 0

5
1
#####d#####
#.........#
#.........#
#.........#
#.........#
#.........#
#.........#
#.........#
#.........#
#.........#
###########

2
6
###########
#.#.....#.#
#.........#
#.#.#.#.#.#
#.........#
....#.#...#
#.........#
#.....#...#
#.........#
#.#.....#.#
###########

2
4
#####.#####
#.........#
#.........#
#....##...#
#...#.#...#
d..........
#.........#
#.........#
#.........#
#.........#
#####.#####

1
5
###########
##.....#..#
#.........#
##.#.#.#..#
#.........#
.....#....#
#.........#
#..#.#.#..#
#.........#
##.......##
#####.#####

2
2
###########
#e........#
##.#...#..#
#e........#
#..#.#.#..#
#..........
#..#.#.#..#
#.........#
##.#...#.##
#.........#
#####.#####
enemies 2

3
1
###########
#.#.....#.#
#.........#
#..#.#.#.##
#.........#
....#.#...l
#.........#
#....#.#.##
#.........#
#.......#.#
#####.#####

3
4
#####.#####
#.........#
#..#......#
#.#....#..#
#.........#
...........
#.......#.#
#.#.....#.#
#..#...#..#
#.........#
###########

3
3
#####d#####
#.........#
#......#..#
#....#..#.#
#.........#
l..........
#.........#
#.#.......#
#..#......#
#.........#
#####.#####
locked : 1

4
2
#####.#####
#.........#
#.........#
#.........#
#.........#
...#..#....
#.........#
#.........#
#.#.....#.#
#.k.......#
###########
key : 1

3
0
###########
#.#.......#
#..#......#
#.####....#
#...#.#...#
#....@.....
#.........#
#.........#
#.........#
#.........#
###########

0
4
###########
#X........#
#.........#
#.........#
#.........#
#.........#
#.........#
#.........#
#.........#
#.........#
#####.#####

2
5
#####.#####
#k#.......#
#.........#
#.#.#.#.#.#
#.........#
....#.#....
#.........#
#.#.#.#...#
#.........#
#.#.......#
#####.#####
key : 3

3
5
#####.#####
#.........#
#.........#
#.....##..#
#....#.#..#
..........#
#.....#...#
#.......#.#
#.....###.#
#........k#
###########
key : 4

2
3
#####.#####
#.........#
#..#......#
#.#.......#
#......#..#
.....#....d
#.........#
#.#.......#
#..#......#
#.........#
#####d#####

4
1
#####.#####
#.........#
#.........#
##..#.....#
#k........#
#..........
#.#..#..#.#
#.........#
#.........#
#.........#
#####d#####
key : 0

1
3
###########
#.........#
#.........#
##.....#..#
#.........#
#.........d
#.#..#..#.#
#.........#
#.........#
##........#
#####.#####

4
3
#####.#####
#.#.....#.#
#.........#
#.#.#.#...#
#.........#
......#...#
#.........#
#.#.....#.#
#.........#
#.#.......#
###########

