2
1
#####.#####
#.........#
#.........#
#.........#
#.........#
...#.##....
#.###.....#
#...##....#
#...#.....#
#k#.......#
#####.#####
key : 0

1
0
#####.#####
#.........#
#.........#
#.........#
#.........#
#.........d
#.........#
#.......#.#
#......#..#
#.........#
#####.#####

0
2
###########
#.........#
#..#......#
#.#.......#
#.........#
..........#
#.........#
#.........#
#.........#
#.........#
#####.#####

2
2
#####d#####
#.........#
#..#......#
#.#.......#
#.........#
...........
#.........#
#.......#.#
#......#..#
#.........#
###########

2
3
#####.#####
#.........#
##.....#.##
#.........#
#..#......#
..........#
#......#..#
#......e..#
##.#...#..#
#......e.e#
###########
enemies 3

1
1
#####d#####
#.........#
#.......#.#
#.........#
#...#.#.#.#
d..........
#...#.#...#
#.........#
#.#...#.#.#
#.........#
#####.#####

2
0
#####.#####
#.........#
#..#......#
#.#.......#
#.........#
#..........
#..#......#
###.......#
#.........#
#.........#
#####.#####

3
0
#####.#####
#.........#
#.........#
#.....#.#.#
#.....###.#
#.........l
#.........#
#.........#
#......#..#
#.........#
#####.#####

0
1
###########
#.........#
#......#..#
#.......#.#
#.........#
...........
#.........#
#.#.......#
#..#......#
#.........#
#####d#####

4
1
#####.#####
#.........#
#..#......#
#.#.......#
#.........#
d..........
#.........#
##........#
#..#......#
#.........#
#####l#####

3
1
#####.#####
#.........#
#.........#
#.........#
#.........#
l.........#
#.........#
#.........#
#.........#
#.........#
#####.#####
locked : 1

4
2
###########
#........k#
#..#......#
#.#.......#
#.........#
..........#
#.........#
#.#.......#
#..#......#
#.........#
###########
key : 3

5
1
#####l#####
#.........#
#.........#
#.........#
#.........#
.....e#...#
#.....#.#.#
#.....##..#
#.........#
#.........#
#####.#####
locked : 3
boss
enemies 1

6
1
#####.#####
#.........#
#.....#...#
#.....#.#.#
#.....#.#.#
#..#.#....#
#..#......#
#...##....#
#.........#
#X........#
###########

1
2
#####.#####
#k........#
#.........#
#.........#
#.........#
...........
#.........#
#.........#
#.........#
#.........#
#####d#####
key : 1

5
0
#####.#####
#.........#
#.#...#.#.#
#.........#
#.#.#.#.#.#
#..........
#?#...#.#.#
#.........#
#...#...#.#
#e........#
###########
enemies 1
sign Only the prepared may pass.

4
0
#####.#####
#e........#
#.........#
#.........#
#.........#
#e........d
#.........#
#.........#
#.........#
#.........#
#####.#####
enemies 2

1
3
###########
##.#.....k#
#.........#
#.#.......#
#.........#
...#.#.#..#
#.........#
#.#.#.#.#.#
#.........#
##.#.....##
#####.#####
key : 2

0
0
###########
#?........#
#.........#
#...#.....#
#.........#
#....@#....
#.........#
#.........#
#.........#
#.........#
#####.#####
sign Beware what lurks ahead.

