3
5
#####.#####
#.........#
#..#.....##
#.........#
#.#.#.#.#.#
..........#
#..#.#.#..#
#.........#
#.#.#.#.#e#
#.......ee#
###########
enemies 3
door 0 : 0

2
5
###########
#.........#
#..#...#..#
#.#.....#.#
#.........#
#.........#
#.........#
#.......#.#
#......#..#
#.........#
#####.#####

4
4
#####d#####
#.........#
#.........#
#.......#.#
#.........#
..........#
#.........#
#.......#.#
#......#..#
#.........#
#####l#####

2
1
#####.#####
#e.......?#
#.........#
##..#..#..#
#.........#
........se#
#.#..#..#e#
#.........#
#.........#
##.....#..#
#####.#####
enemies 3
switch 0 : 0
sign Those who search shall find.

6
4
#####.#####
#.........#
#.........#
#....#....#
#.....#...#
#..#.##...#
#...#.....#
#..##..#..#
###.......#
#X........#
###########

5
1
#####d#####
#.........#
#..#.....##
#.........#
#..#...#..#
#.........#
#..#.#.#..#
#.........#
#......#.##
#.........#
###########

4
3
#####.#####
#.........#
###.......#
#.#.......#
#..#......#
...........
#.##......#
####......#
##........#
#.........#
###########

5
4
#####l#####
#.........#
#.........#
#.........#
#.........#
#....e....#
#.........#
#.........#
#.........#
#.........#
#####.#####
locked : 4
boss
enemies 1

4
1
#####.#####
#.........#
#.........#
#.........#
#.........#
#k........l
#.........#
#.......#.#
#......#..#
#.........#
#####d#####
key : 1

3
4
###########
#....k....#
#.........#
#.........#
#.........#
...........
#.........#
#.#.......#
#..#......#
#.........#
#####d#####
key : 4

3
1
#####.#####
#.........#
#.........#
#.........#
#.........#
...##.....l
#...#.....#
#...##....#
#.........#
#.........#
#####.#####

3
3
###########
#.........#
#.........#
#.........#
#.........#
l..........
#.........#
#.#.......#
#..#......#
#.........#
#####.#####
locked : 2

1
0
#####.#####
#.........#
#..#...#..#
#.#.....#.#
#.........#
#..........
#.........#
#.........#
#.........#
#.........#
#####.#####

2
0
#####.#####
#.........#
#.#.#.#.#.#
#.........#
#.....#.#.#
#..........
#k#.#.#...#
#.........#
#.#.#.#.#.#
#.........#
#####.#####
key : 0

3
0
#####.#####
#.........#
#.........#
#.........#
#.........#
#....@.....
#..##.....#
#.#.......#
#..#......#
#?........#
###########
sign Something glints behind that door…

4
2
#####.#####
#.........#
#.....#.#.#
#....#.####
#......##.#
l....#.....
#.....##..#
#.........#
#...#.....#
#..#......#
###########
locked : 1

3
2
###########
#.........#
#.........#
#.........#
#.........#
l.........l
#.........#
#.........#
#.........#
#.........#
#####.#####
locked : 0

1
1
###########
##.#.....##
#........k#
##.#.#.#.##
#.........#
...#.#.#..#
#.........#
#..#.#...##
#.........#
##.#...#..#
#####.#####
key : 2

0
0
###########
#.........#
#.........#
#.........#
#.........#
#.........#
#.........#
#.#.....#.#
#..#...#..#
#.........#
#####.#####

