2
3
#####.#####
#e.......e#
#.#.....#.#
#.........#
#.........#
...#..#...d
#.........#
#.........#
#.........#
#e........#
#####.#####
enemies 3

1
2
###########
#.........#
#...#..#..#
#..##.....#
#....##...#
#..#.###...
#..####...#
#.........#
#.........#
#.........#
#####l#####
locked : 0

3
1
#####d#####
#.........#
#.........#
#....#....#
#.........#
#..........
#.#..#..#.#
#.........#
#.........#
#.......#.#
###########

3
4
#####.#####
#.........#
#.........#
#...##....#
#..##.....#
...#k#.....
#.........#
#...#.....#
#.........#
#.........#
###########
key : 1

0
3
###########
#e.......e#
#?........#
##..#.....#
#.........#
#.........#
#...#..#..#
#.........#
#.........#
##.....#..#
#####.#####
enemies 2
sign The dungeon remembers all who enter.

1
5
###########
#.........#
#..#...#..#
#.#.....#.#
#.........#
..........#
#.........#
#.#.......#
#..#......#
#.........#
#####.#####

3
6
#####.#####
#.........#
#.........#
#.........#
#.........#
......#...#
#....#..#.#
#.....##..#
#.....#.#.#
#.......#X#
###########

1
3
#####.#####
#.........#
#.........#
#.........#
#.........#
...........
#.........#
#...#.....#
#.........#
#.........#
#####.#####

2
0
###########
#?........#
#.........#
#....##...#
#...@..#..#
#....###...
#....###..#
#....##..##
#......####
#.........#
###########
sign Beware what lurks ahead.

4
3
#####.#####
#.........#
#.........#
#.........#
#......#..#
#...##.#..#
#...#.###.#
#.......#.#
#......#..#
#.........#
###########

3
5
#####.#####
#e#.....#e#
#.........#
#.#.#.#.#.#
#.........#
....#.#....
#.........#
#.#.#...#.#
#.........#
#e#.....#?#
###########
enemies 3
sign Those who search shall find.

1
4
###########
##.#......#
##.#......#
#....#....#
#.###.....#
......#....
#.....#...#
#......#..#
#.........#
#.........#
#####d#####

3
3
#####.#####
##.....#..#
#.........#
#.....#...#
#.........#
...........
#.........#
#.........#
#.#.......#
#.........#
#####.#####

2
5
#####.#####
#k.#.....##
#.........#
#.........#
#......#..#
..........d
#.........#
#..#..#..##
#.........#
#.........#
#####.#####
key : 2

2
1
###########
#.........#
#.........#
#...##..#.#
#....#.##.#
....###....
#.....##..#
#...####..#
#.........#
#.........#
#####d#####

3
2
#####.#####
#.........#
#.........#
#.........#
#.........#
...........
#.........#
#.......#.#
#......#..#
#......k..#
###########
key : 5

2
6
###########
#..#......#
#..##.#...#
#..#...#..#
#....###..#
d....e....#
#.........#
#.........#
#.........#
#..#......#
#####.#####
boss
enemies 1

2
2
#####l#####
#k........#
#.........#
#.........#
#.........#
...........
#.........#
#.......#.#
#......#..#
#.........#
#####.#####
key : 0

2
4
#####d#####
#.........#
#.........#
#.........#
#.........#
d..........
#.........#
#.........#
#.........#
#.........#
#####.#####

