2
5
#####D#####
#..#...##.#
#.#...###.#
#.###..##.#
#.#####...#
#...e##...#
#.........#
#.....#...#
#.........#
#.........#
#####d#####
boss
enemies 1

3
0
#####D#####
#.#.....#.#
#.........#
#.#.....#.#
#.........#
#...#.#...#
#.........#
#.#.#.#.#.#
#.........#
#.......#.#
###########

0
3
###########
#........k#
#......p..#
#.........#
#.........#
D.........#
#.........#
#..p......#
#.........#
#.........#
#####D#####
key : 4

3
3
#####D#####
#k.#.....##
#.........#
#.........#
#..#......#
D.........D
#.........#
#..#..#..##
#.........#
#.........#
#####D#####
key : 1

3
5
#####d#####
#.........#
#......#.##
#.........#
#....#....#
D.........#
#..#......#
#.........#
##.#.....##
#.........#
###########

1
5
###########
#X#.......#
#.###.....#
#..###....#
#.#####...#
#.....#...#
#.........#
#.........#
#.........#
#.........#
#####D#####

2
2
#####D#####
#k........#
#.........#
#.........#
#.........#
D.........l
#.........#
#.........#
#.........#
#.........#
#####d#####
key : 0

2
1
#####D#####
##.....#..#
#.........#
#.........#
#.#..#..#.#
D.........D
#.........#
##..#.....#
#.........#
#.........#
###########

2
3
#####D#####
#.........#
#.........#
#.........#
#.........#
l.........#
#.........#
#.........#
#.........#
#.........#
#####D#####
locked : 0

1
3
#####D#####
#........k#
#..#..#..##
#.........#
#.........#
D...#.....#
#.........#
#.........#
#..#..#..##
#.........#
#####D#####
key : 2

3
2
#####d#####
#.........#
#...#.#...#
#...#.....#
#.....#...#
#.........D
#.........#
#.........#
#.........#
#.........#
###########

0
2
###########
#.........#
#.........#
#.........#
#.........#
#....#.#..D
#.....#...#
#....#..###
#......####
#.........#
#####d#####

1
2
#####d#####
#.........#
#.........#
#####.....#
#...##....#
D...##....D
#.#.##....#
#.###.....#
#.........#
#.........#
#####D#####

0
0
###########
#es......e#
#e........#
#...#.....#
#.........#
#.........#
#.#..#....#
#.........#
#.........#
##........#
#####D#####
enemies 3
switch 0 : 0

4
3
#####D#####
#.........#
#.........#
#.........#
#.........#
#..#......#
#e#.......#
##e#......#
#.........#
#e........#
###########
enemies 3
door 0 : 0

1
0
#####D#####
#.........#
#.........#
#.........#
#.........#
#.........D
#.........#
#.........#
#.........#
#.........#
#####d#####

2
0
#####d#####
#.........#
#.........#
#.........#
#.........#
#?...@....D
#.........#
#.........#
#.........#
#.........#
#####D#####
sign Beware what lurks ahead.

3
4
###########
#.........#
#.........#
#....##...#
#....####.#
D...###...D
#....###..#
#....###..#
#.....e#..#
#......?..#
###########
enemies 1
sign A useful tool lies just ahead.

1
1
###########
#..#...#..#
#.....#...#
#..##.##..#
#.####.#..#
D..#......D
#.##......#
#.........#
#.........#
#.........#
#####D#####

