1
3
#####d#####
##.#......#
#.........#
#.#.#.#...#
#.........#
D..#...#..l
#.........#
#.#.#.#.#.#
#.........#
##.#.....##
#####D#####

1
4
###########
#.........#
#.........#
#.........#
#.....#...#
l...#e....#
#.....#...#
#.........#
#.........#
#.........#
#####D#####
locked : 3
boss
enemies 1

6
0
#####l#####
#.........#
#.........#
#.........#
#.........#
#.........#
#.........#
#.......#.#
#......#..#
#.........#
###########
locked : 0

5
0
#####D#####
#.........#
#..#...#..#
#.#.....#.#
#.........#
#.........D
#.........#
#.......#.#
#......#..#
#.........#
#####l#####

2
4
#####D#####
#.........#
#.........#
#.........#
#.........#
D.........#
#.........#
#.........#
#.........#
#........X#
###########

0
2
###########
#.........#
#...#..#..#
#.......#.#
#.........#
#.........D
#.........#
#.......#.#
#......#..#
#.........#
#####d#####

3
1
###########
#....k....#
#.........#
#.........#
#.....#.#.#
D.........D
#......##.#
#.........#
#.........#
#.........#
#####D#####
key : 2

2
0
###########
#k........#
#.#.......#
#.........#
#.........#
#..#..#...#
#.........#
#.........#
#.#.......#
#.........#
#####D#####
key : 0

4
0
#####D#####
#.........#
#..#......#
#.#.......#
#..#......#
#.........D
#.........#
#.........#
#.........#
#.........#
#####D#####

4
2
#####l#####
#.........#
#.........#
#.........#
#.........#
l.........d
#.........#
#.........#
#.........#
#.........#
###########
locked : 1

1
2
#####d#####
#e........#
##..#..#..#
#e........#
#.........#
#...#..#..D
#.........#
#.........#
##..#..#..#
#e........#
#####D#####
enemies 3

4
1
#####D#####
#.........#
#.........#
#.....#...#
#...####..#
D..#k.#...l
#..##.....#
#....#.#..#
#.........#
#.........#
#####D#####
key : 1

4
3
###########
#.........#
#..#......#
#.#.......#
#.........#
d.........#
#.##......#
#.........#
#........##
#.........#
###########

2
2
#####D#####
#.........#
#..#......#
#k#.......#
#.........#
#.........d
#.........#
#.......#.#
#......#..#
#.........#
#####D#####
key : 3

3
2
#####D#####
#.........#
#.........#
#.........#
#.........#
D.........#
#.........#
#.#.......#
#..#......#
#.........#
#####l#####
locked : 2

3
0
#####D#####
#.........#
#.........#
#.........#
#.........#
#?...@....D
#.........#
#.........#
#.........#
#.........#
#####D#####
sign Something glints behind that door…

2
3
#####D#####
#.........#
#..#......#
#.#.......#
#.........#
d.........D
#.........#
#.......#.#
#......#..#
#.........#
###########

5
1
#####D#####
#.........#
#.........#
#.....#...#
#....#....#
D.....#...#
#.........#
#.........#
#.........#
#.........#
###########

0
3
###########
#.........#
#.#.#.#.#.#
#.........#
#.#...#.#.#
D.........#
#.#.....#.#
#.........#
#.#.....#.#
#.........#
#####d#####

