2
0
#####.#####
#.........#
#...#.....#
#.....#...#
#.........#
#....@....l
#...##....#
#...#.#...#
#...#.#...#
#.........#
#####.#####

5
1
#####d#####
####......#
#..#......#
#...#.....#
#.###.....#
.......#..#
#..##.#...#
#..#.##...#
#.....##..#
#..#...#..#
###########

1
5
#####.#####
#.........#
#.........#
#.........#
#.........#
d..#.e#...#
#.##..#...#
#..##.#...#
#..#..#...#
#.#.......#
#####.#####
boss
enemies 1

1
1
###########
#........k#
#.........#
#.........#
#.........#
..........#
#.........#
#.......#.#
#......#..#
#.........#
#####.#####
key : 2

4
1
#####.#####
#.........#
#.#.....#.#
#.........#
#.........#
l..#......#
#.........#
#.........#
#.......#.#
#.........#
#####d#####
locked : 2

1
0
###########
#.........#
#.........#
#.........#
#.........#
#..........
#.........#
#.#.......#
#..#......#
#.........#
#####.#####

2
3
#####.#####
#e........#
#.........#
#.........#
#.........#
...........
#.........#
#.........#
#.........#
#?...e....#
###########
enemies 2
sign A locked path — look elsewhere first.

2
2
###########
#.........#
#.........#
#.........#
#.........#
l....###...
#.....###.#
#......##.#
#.........#
#.........#
#####.#####
locked : 1

3
2
#####.#####
#.........#
#.#.#.....#
#..##.....#
#.##......#
...##.....#
#.###.....#
#.........#
#.........#
#.........#
###########

2
4
#####l#####
#.........#
#.##....#.#
###k#.....#
#...#.#.#.#
...#.#.#..d
#....#.#..#
#.........#
#.........#
#.........#
###########
key : 4

2
5
#####.#####
#.#.......#
#.##......#
#.##......#
#.........#
d.........#
#.........#
#.........#
#.........#
#.........#
###########

0
5
###########
#X........#
#.........#
#..##.#...#
#..#......#
#..##.....#
#...####..#
#..##.##.##
##........#
#.........#
#####.#####

2
1
#####.#####
#......#.##
#.....#...#
#....#.#.##
#......#..#
l.........l
#.........#
#.........#
#.........#
#.........#
#####.#####
locked : 0

3
0
#####.#####
#.........#
#...#.#.#.#
#.........#
#...#.#.#.#
#..........
#k#.#.#.#.#
#.........#
#.#.#...#.#
#.........#
#####.#####
key : 0

3
1
#####.#####
#..#......#
#..k#.....#
#..#......#
#.##..#...#
.....#.....
#.........#
#.........#
#.........#
#.........#
#####.#####
key : 1

4
0
#####.#####
#.........#
#.........#
#.....#...#
#...##.#..#
#...##....l
#..#.#.#..#
#....##...#
#.........#
#.........#
#####d#####

5
0
#####d#####
#.........#
#.#.....#.#
#.........#
#..#......#
#..........
#.#.#.#.#.#
#.........#
#..#...#.##
#.........#
###########

1
4
###########
#.#.....#.#
#.........#
#..#.#...##
#.........#
....#.#...d
#.........#
#..#.#.#.##
#.........#
#.........#
#####l#####
locked : 4

1
3
###########
#..#......#
#.###.#...#
#.###.#...#
#...##....#
#..####....
#.#.#.#...#
#...#.....#
#.........#
#.........#
#####.#####

