5
4
#####.#####
#.........#
#.........#
#.........#
#..#......#
...##.....#
#..#......#
#####.....#
#.........#
#........X#
###########

3
1
#####.#####
#.........#
#.........#
#.........#
#.........#
....##.....
#..#k.....#
#.####....#
#.#.#.....#
##........#
#####.#####
key : 2

2
0
#####.#####
#.........#
#..#......#
#.........#
#...#.....#
#...@###...
#?#.##....#
##.#......#
##........#
#.........#
#####l#####
sign A locked path — look elsewhere first.

1
0
#####l#####
#.........#
#.........#
#.........#
#.........#
#k.........
#.........#
#.........#
#.........#
#.........#
#####.#####
key : 1

3
4
###########
#.........#
#......#..#
#.......#.#
#.........#
d.........#
#.........#
#.#.....#.#
#..#...#..#
#.........#
#####.#####

0
0
###########
#.........#
#.........#
#.........#
#.........#
#.........#
#.........#
#.........#
#.........#
#.........#
#####l#####
locked : 1

1
2
###########
#.........#
#.........#
#.##......#
#..##.....#
...##.....#
#.#.......#
#..#......#
#..#......#
#.........#
#####d#####

4
1
#####.#####
#.........#
##.....#..#
#.........#
#.........#
#...#..#...
#.........#
#.........#
#......#..#
#k........#
###########
key : 3

3
3
#####.#####
#.........#
#..#......#
#.#.......#
#.........#
d.........d
#.........#
#.........#
#.........#
#.........#
#####d#####

4
3
#####d#####
##........#
#..#......#
##.##.....#
#.#.......#
..........l
#.........#
#.........#
#.........#
#.........#
#####.#####

2
1
#####.#####
#k........#
#......#..#
#.......#.#
#..#......#
...........
#.........#
#.#.......#
#..#......#
#.........#
#####.#####
key : 0

4
2
#####l#####
#.........#
#..#...#..#
#.........#
#....#.#..#
...........
#..#...#..#
#.........#
##.#......#
#.........#
###########
locked : 2

3
0
#####l#####
#.........#
#.........#
##.##.....#
#..###....#
#..........
#.#.##....#
#..#.#....#
#.........#
#.........#
###########
locked : 0

2
2
#####d#####
#.........#
#.........#
#.........#
#.........#
...........
#.........#
#.........#
#.........#
#.........#
#####.#####

2
3
###########
##........#
#.........#
#.........#
#.#.....#.#
..........#
#.........#
##..#.....#
#.........#
#.........#
#####.#####

5
3
#####.#####
#..#......#
#..##.....#
#...#..#..#
#.###.##..#
#..........
#.#.#.....#
#e#.......#
#####.....#
#ee.......#
###########
enemies 3

3
2
#####.#####
#.........#
#.........#
#........##
#.........#
..........d
#.........#
#.........#
#.........#
#.........#
#####l#####

4
4
#####.#####
#.........#
#.#.......#
#.........#
#.........#
l....e....#
#.........#
#.........#
#.........#
#.........#
#####.#####
locked : 3
boss
enemies 1

1
1
###########
##.#...#..#
#.........#
#....#.#.##
#.........#
...#...#...
#.........#
##.#.....##
#.........#
##.....#.##
#####.#####

