2
3
###########
#........k#
#.........#
#.....##..#
#...###.#.#
......#...#
#...#.....#
#...#.....#
#.........#
#.........#
###########
key : 5

4
0
#####.#####
#k........#
####......#
#..##.....#
#..#......#
#..#...#...
#..#..##..#
#....#....#
#.........#
#.........#
#####.#####
key : 1

6
3
###########
#.........#
#......#..#
#.......#.#
#.........#
d.........#
#.........#
#.......#.#
#......#..#
#.........#
###########

7
0
#####.#####
#.........#
#...#...#.#
#.........#
#..#.#.#..#
#.........#
#.#...#.#.#
#.........#
#........##
#.........#
###########

0
2
###########
#X#.......#
#.........#
#.#.#.....#
#..#......#
#..#.#....#
#..##.....#
#....#....#
#.........#
#.........#
#####.#####

6
1
#####.#####
#e........#
#.........#
#.........#
#...#..#..#
...........
#.........#
#..#..#...#
#.........#
#?...e....#
###########
enemies 2
sign Only the prepared may pass.

3
1
###########
#.........#
#......#..#
#.......#.#
#.........#
...........
#.........#
#.........#
#.........#
#.........#
#####d#####

1
2
#####.#####
#.........#
#.........#
#.........#
#.........#
#....e....#
#.........#
#...#.....#
#.........#
#.........#
#####d#####
boss
enemies 1

3
2
#####.#####
#.........#
#..#..##..#
#..###....#
#...#..#..#
...#####..#
#...#.##..#
#...#.#.###
#...#.#.#.#
#.........#
#####d#####

6
0
#####.#####
#.........#
#.........#
##..#..#..#
#k........#
#..........
#.#.....#.#
#.........#
#.........#
#......#..#
#####.#####
key : 0

5
2
#####.#####
#.........#
#......#..#
#.......#.#
#.........#
..........#
#.........#
#.#.....#.#
#..#...#..#
#.........#
#####l#####
locked : 2

5
1
#####.#####
##........#
#.........#
#.........#
#...#.....#
l..........
#.........#
##........#
#.........#
#.........#
#####.#####
locked : 0

4
1
#####d#####
#.........#
#.........#
#.........#
#....####.#
......#...l
#.........#
#.........#
#.........#
#.........#
#####.#####

4
2
#####d#####
#.........#
#......#..#
#.......#.#
#.........#
l.........#
#.........#
#.......#.#
#......#..#
#.........#
#####.#####
locked : 1

3
0
###########
#.........#
#.........#
#.........#
#.........#
#..........
#.........#
#.........#
#.........#
#.........#
#####.#####

5
0
#####.#####
#.........#
#.........#
#.........#
#.........#
#....@....l
#..#......#
#.#.#.....#
#.#.#.....#
#.........#
#####.#####

6
2
#####l#####
#.........#
#.........#
#.........#
#..#......#
..........d
#.........#
#.........#
#.........#
#.........#
#####.#####

2
2
#####d#####
#.........#
#......#..#
#.......#.#
#.........#
#..........
#.........#
#.........#
#.........#
#.........#
#####.#####

7
2
#####.#####
#.........#
#..#...#..#
#.#.....#.#
#.........#
#.........#
#.........#
#.#.......#
#..#......#
#k........#
###########
key : 2

