5
4
#####d#####
#.........#
#.........#
#.........#
#..#.#....#
#...#e#...#
#...#.#...#
#..#......#
#.#.......#
#.........#
#####.#####
boss
enemies 1

0
0
###########
#.......#.#
#.........#
#....#.#.##
#.........#
#...#.#...#
#.........#
#..#...#.##
#.........#
#.......#.#
#####d#####

0
3
###########
#.........#
#..#......#
#####.....#
#.#.......#
#..###....#
#.##......#
#.#..#....#
#.........#
#.........#
#####.#####

3
4
#####.#####
#.........#
#.........#
#.........#
#.........#
d.........#
#.........#
#.........#
#.........#
#.........#
#####.#####

6
4
#####.#####
#......##.#
#...#.##..#
#...###...#
#...#####.#
#...#.#...#
#.......#.#
#...###.#.#
#.....###.#
#......##X#
###########

4
3
#####d#####
#.........#
#..##.#...#
#.#.......#
#.........#
#.....#....
#.........#
#.#.......#
#..#......#
#.........#
###########

3
2
#####.#####
#.........#
##.#...#.##
#.........#
#.#.#.#...#
#..........
#..#......#
#.........#
#e#.#...#.#
#ee.......#
###########
enemies 3

3
3
#####.#####
#k........#
#..#......#
#.#.......#
#.........#
..........d
#.........#
#.......#.#
#......#..#
#.........#
#####d#####
key : 3

3
0
#####.#####
#.........#
#.........#
#.##......#
#.#.##....#
#....#....#
#.##......#
#.#...#...#
#..##.....#
#k........#
###########
key : 0

2
4
#####.#####
#.........#
#.#.......#
#.........#
#..#......#
l.........#
#.##......#
##.#......#
##........#
#.........#
#####.#####
locked : 3

1
1
###########
#.#....e#e#
#........e#
#.#.#.#...#
#.........#
....#.#...#
#.........#
#.#...#.#.#
#.........#
#.#.....#.#
#####.#####
enemies 3

2
2
###########
#.........#
#......#..#
#.......#.#
#.........#
...........
#..#......#
#.#.....#.#
#..#......#
#.........#
#####.#####

1
0
#####d#####
#..#.....##
#.........#
#.........#
#...#.....#
#k.........
#.........#
#..#..#..##
#.........#
#.........#
#####.#####
key : 2

2
0
#####.#####
#.........#
#.###.#...#
#.#.#.#...#
#.#.@.....#
#...##.....
#.##.#....#
#.........#
##.##.....#
#........##
#####.#####

4
4
#####.#####
#.........#
#.....#...#
#.....#.#e#
#.....#...#
.........e#
#.........#
#.........#
#.........#
#.........#
#####d#####
enemies 2

1
3
#####.#####
#.........#
#.........#
#.........#
#.........#
#.........l
#.........#
#.........#
#.........#
#.........#
#####.#####

2
3
#####.#####
#.........#
#..#...#..#
#.#.....#.#
#.........#
..........l
#.........#
#.#.......#
#..#......#
#.........#
#####.#####

1
4
###########
##.......##
#.........#
#.#.#.#.#.#
#.........#
l..#...#..#
#.........#
#.#.#.#.#.#
#.........#
##.#.....##
#####.#####
locked : 2

2
1
#####.#####
#.k#......#
#.##......#
#..#.#....#
#.........#
....#......
#.........#
#.........#
#.........#
#.........#
###########
key : 1

