2
1
#####D#####
#.........#
#..#......#
#.........#
#.........#
D.........D
#.........#
#.........#
#..#..#..##
#.........#
#####D#####

2
3
#####D#####
#.........#
#.........#
##..#..#..#
#.........#
d.........D
#.#..#..#.#
#.........#
#.........#
##.....#..#
#####D#####

3
4
#####l#####
#.........#
#..#......#
#.#.......#
#.........#
D.........d
#.........#
#.#.....#.#
#..#...#..#
#.........#
#####d#####
locked : 1

4
4
#####d#####
#........##
#.......###
#....##..##
#....#..#.#
#....###..D
#.......#.#
#.........#
#.........#
#.........#
###########

3
5
###########
#.........#
#..#......#
#.#.......#
#.........#
d.........l
#.........#
#.........#
#.........#
#.........#
#####D#####

1
3
#####l#####
#.........#
#.........#
#.#..#..#.#
#.........#
#.........D
#k#..#..#.#
#.........#
#.........#
#.#.....#.#
#####D#####
key : 1

4
5
#####D#####
#.........#
#.........#
#..###....#
#...k#....#
D..###....D
#.........#
#.........#
#.........#
#.........#
###########
key : 3

4
6
#####D#####
#.........#
#.........#
#.........#
#.........#
D..###....#
#.#..#....#
#.........#
#.#.#.....#
####.....X#
###########

1
1
###########
#..#......#
#.#.#.....#
#.#...#...#
#..#..#...#
D..#.##...#
#.........#
#.........#
#.........#
#.........#
#####D#####

1
0
###########
#.........#
#..#...#..#
#.#.....#.#
#.........#
#.........D
#.........#
#.........#
#.........#
#.........#
#####d#####

2
0
#####d#####
#.........#
#.#......##
##.#......#
#..#......#
#..#.@....D
#....#....#
#.....#...#
#.........#
#.........#
###########

1
4
###########
#......e.e#
##.#...#?##
#.........#
#..#.#.#..#
D.........#
#..#.#.#..#
#.........#
##.#.....##
#.........#
#####D#####
enemies 2
sign What you seek is close.

0
3
###########
#.........#
#.......#.#
#.........#
#.........#
#.........#
#.........#
#.........#
#.......#.#
#.........#
#####l#####
locked : 0

3
3
#####D#####
#.........#
#..#...#..#
#.#.....#.#
#.........#
D...#.....D
#.........#
#.........#
#.........#
#.........#
###########

3
6
###########
#.........#
#.###.....#
#..#......#
#...#.....#
l..##e....#
#.#.......#
#.........#
#.........#
#.........#
#####D#####
locked : 2
boss
enemies 1

2
4
#####D#####
#.........#
#.#.#.#...#
#.........#
#..#.#.#..#
D.........#
#.#.#.#.#k#
#.........#
#..#...#.##
#.........#
#####l#####
key : 2

3
2
#####D#####
#.........#
#.....##..#
#.....#...#
#....#.#..#
D.........D
#.#.###...#
#.##.#....#
#.........#
#..#......#
###########

3
1
#####D#####
###.......#
###.......#
#.##......#
#.#..#....#
#..##.....D
#.........#
#.........#
#.........#
#k........#
###########
key : 0

2
2
###########
#.........#
#.........#
#.........#
#.........#
D.........d
#......#..#
#.........#
#.........#
#.........#
#####D#####

