6
3
#####.#####
#.........#
#.........#
#.........#
#.....#...#
l..........
#.........#
#.........#
#.........#
#.........#
#####d#####
locked : 2

0
3
###########
#X........#
#.........#
#....###..#
#....#....#
#.........#
#.........#
#.........#
#......#..#
#.........#
#####.#####

5
2
#####.#####
#.........#
#..#......#
#.........#
#.........#
l..........
#.......#.#
#...#.....#
#.........#
#.........#
#####.#####
locked : 1

7
3
#####d#####
#.........#
#.........#
#.........#
#.........#
..........#
#.........#
#.........#
#.........#
#.........#
###########

4
2
###########
#.........#
#......#..#
#.......#.#
#.........#
#..........
#.........#
#.........#
#.........#
#.........#
#####.#####

6
0
###########
####......#
####..#..##
#..#....###
#...@##...#
#....###...
#.........#
#.........#
#.........#
#?........#
###########
sign A useful tool lies just ahead.

2
3
#####d#####
#.........#
#.........#
#.........#
#.........#
#.........#
#.........#
#.......#.#
#......#..#
#.........#
#####.#####

3
3
#####.#####
#.........#
#.........#
#.........#
#.........#
#....#....d
#..##.....#
#.###.....#
#..##.....#
#.##......#
#####l#####
locked : 4

7
2
#####.#####
#e........#
#.........#
#....#e#..#
#....##...#
...........
#.........#
#.........#
#.........#
#s...e....#
###########
enemies 3
switch 0 : 0 1

6
2
#####.#####
#.........#
#.......#.#
#.........#
#.........#
..........l
#.........#
#.........#
##........#
#k........#
#####.#####
key : 2

6
1
#####l#####
#k........#
#.........#
#.........#
#.........#
...........
#.........#
#.........#
#.........#
#.........#
#####.#####
key : 0

5
3
#####.#####
#.........#
#.........#
#.#.......#
#..#..###.#
...e###?...
#..##e###.#
#...#.#...#
#...#.....#
#.........#
#####.#####
enemies 2
sign Turn back; you are not yet ready.

4
3
#####l#####
#.........#
#..#......#
#.#.......#
#.........#
.........k#
#.........#
#.........#
#.........#
#.........#
#####.#####
key : 4

6
4
#####.#####
#.........#
#.........#
#.........#
#.........#
..........#
#.........#
#.........#
#........?#
#.......ee#
###########
enemies 2
door 0 : 0 1
sign A locked path — look elsewhere first.

5
4
###########
#.........#
#......#..#
#.......#.#
#.........#
..........#
#.........#
#.#.......#
#..#......#
#.........#
#####.#####

1
3
#####.#####
#.........#
#.........#
#.........#
#.........#
#....e....#
#.........#
##........#
#.........#
#.........#
#####d#####
boss
enemies 1

3
4
###########
#.........#
#..#.....##
#.........#
#.........#
d...#..#..#
#.........#
#.........#
#..#..#..##
#.........#
###########

7
1
#####.#####
#.........#
#.........#
#.........#
#.........#
#...#......
#.#.......#
#.#.#.....#
#.k#......#
###.......#
###########
key : 1

5
1
###########
#.........#
#......#..#
#.......#.#
#.........#
#.........l
#.........#
#.#.......#
#..#......#
#.........#
#####l#####
locked : 0

