0
3
###########
#........e#
#........e#
#........##
#.........#
D.........#
#...#..#..#
#.........#
#.........#
#..#.....##
#####D#####
enemies 2
door 0 : 0

2
3
#####D#####
#.........#
#.........#
#.........#
#.##......#
D.........D
#.#.#.....#
#####.....#
###.#.....#
#X........#
#####D#####

2
0
###########
#.........#
#.........#
#.........#
#.........#
#.........D
#.........#
#.#.......#
#..#......#
#.........#
#####D#####

3
4
#####D#####
#.........#
#.#.#.....#
#.........#
#...#.#.#.#
D.........#
#.#.#.....#
#.........#
#.#.......#
#........k#
###########
key : 1

4
2
#####D#####
#.........#
#.........#
#.........#
#.....#.#.#
D.....##..D
#.........#
#.........#
#.........#
#.........#
#####d#####

1
3
#####D#####
#.........#
#.##..#...#
#.#..##...#
#...##....#
l...##....#
#.#.e##...#
#.........#
#.........#
#.........#
#####D#####
locked : 2
boss
enemies 1

1
2
#####D#####
#k........#
##.....#.##
#.........#
#.#.....#.#
#.........l
#..#.#.#..#
#.........#
#.#.#.#...#
#.........#
#####D#####
key : 2

3
2
#####d#####
#.........#
#.........#
#.........#
#.........#
D.........d
#.........#
#.......#.#
#......#..#
#.........#
#####D#####

4
3
#####d#####
#.........#
#......#..#
#.......#.#
#.........#
D.........#
#.........#
#.......#.#
#......#..#
#.........#
###########

4
0
#####D#####
#.........#
#.........#
#.........#
#.........#
#.........D
#.........#
#.......#.#
#.........#
#k........#
###########
key : 0

2
2
#####D#####
#.........#
#.##......#
#.##......#
#.........#
D.........D
#.........#
#.........#
#.........#
#.........#
#####d#####

2
1
###########
##.....#.##
#.........#
#..#.#.#.##
#.........#
D....#.#..D
#.........#
#..#.#.#..#
#.........#
##.#...#..#
#####l#####
locked : 0

3
1
#####l#####
#.........#
#.........#
#.........#
#....##.#.#
D....#.#..D
#....#.#..#
#......e###
#......#e##
#........e#
#####D#####
enemies 3

4
1
#####D#####
#.........#
#......#..#
#.......#.#
#.........#
D.........D
#.........#
#.......#.#
#......#..#
#.........#
###########

3
3
#####D#####
#.........#
##..#..#..#
#.........#
#.........#
d....#....D
#.........#
#.........#
##..#..#..#
#.........#
#####d#####

3
0
#####D#####
#.........#
#.........#
#.....#.###
#...##.#..#
#...#@.#..D
#......#..#
#....#..###
#.........#
#.........#
#####D#####

5
2
#####d#####
#.#.......#
#..##.....#
#.####....#
#.###.....#
#...#.....#
#.........#
#.........#
#.........#
#.........#
###########

2
4
###########
#........k#
#.........#
#..#......#
#.........#
D.........#
#.........#
#.#.......#
#..#......#
#.........#
#####D#####
key : 4

0
2
###########
#e........#
#e........#
####......#
#s........#
#.........D
#.........#
#.........#
#.........#
#.........#
#####D#####
enemies 2
switch 0 : 0

