7
0
#####D#####
#.........#
#.........#
#.........#
#.........#
#.........#
#.........#
#.........#
#.........#
#k........#
###########
key : 3

3
2
#####D#####
#.......#.#
#.........#
#.#.#.#.#.#
#.........#
d.....#...D
#.........#
#.#.#.#.#.#
#.........#
#.#.....#.#
#####D#####

5
1
#####D#####
#.........#
#.#.......#
#.........#
#.........#
D.........#
#.........#
#.........#
#.#.....#.#
#.........#
#####D#####

5
0
#####D#####
#.........#
#.........#
#.........#
#.........#
#.....#...D
#....#..#.#
#....######
#........##
#......####
#####D#####

2
3
###########
#........e#
#.........#
#.......#.#
#.....###.#
D....#.#..#
#....#..#.#
#....#.#..#
#......##.#
#......#..#
#####D#####
enemies 1

1
1
#####D#####
#.........#
#.....#...#
#.##..#...#
#.##.#....#
D....e#...#
#.##......#
#.........#
#.........#
#.........#
#####l#####
locked : 3
boss
enemies 1

4
2
#####D#####
#.........#
#..#..#..##
#.........#
#.........#
l...#..#..#
#.........#
#.........#
#.....#..##
#.........#
###########
locked : 1

4
1
#####D#####
#k........#
#.........#
#......#..#
#..##.###.#
D..#...#..l
#..#...#..#
#...####..#
#.....##..#
#.........#
#####D#####
key : 1

3
0
#####l#####
#.........#
#.........#
#..#..#...#
#.........#
#k........D
#...#..#..#
#.........#
#.........#
#.........#
#####D#####
key : 0

6
0
#####D#####
#k#.....#.#
#.........#
#..#.#.#.##
#.........#
#.....#...d
#.........#
#....#.#.##
#.........#
#.......#.#
#####D#####
key : 2

1
0
###########
#..#......#
#.........#
#.........#
#..#..#...#
#.........D
#.........#
#.....#...#
#.........#
#.........#
#####D#####

2
2
###########
#.........#
#..#......#
#.#..#....#
#.#.......#
d.........D
#.........#
#.#.......#
#.##......#
#.........#
#####D#####

3
1
#####l#####
#e.......?#
#.p.......#
#.......p.#
#.........#
D..###....d
#..###....#
#..e##....#
#.........#
#e........#
#####D#####
enemies 3
sign Turn back; you are not yet ready.

2
0
#####D#####
#.........#
#......#..#
#.......#.#
#.........#
#.........D
#.........#
#.......#.#
#......#..#
#.........#
#####l#####
locked : 0

4
0
#####D#####
#.........#
#.........#
#.........#
#.........#
#....@....D
#.........#
#.........#
#.........#
#.........#
#####D#####

2
1
#####l#####
#.........#
#..#...#..#
#.#.....#.#
#.........#
D.........d
#.........#
#.........#
#.........#
#.........#
#####l#####
locked : 2

6
1
#####D#####
#.........#
#.....#...#
#...###...#
#....#....#
d..#......#
#...#.....#
#..#......#
#.........#
#.........#
###########

3
3
#####D#####
#.........#
#.........#
#.........#
#..#......#
D.........#
#.........#
#..#.....##
#.........#
#.........#
###########

0
1
###########
#X........#
#.....#...#
#.....#...#
#.....##..#
#..###....#
#....#....#
#.........#
#.........#
#.........#
#####D#####

