1
5
###########
#........k#
#.........#
#.........#
#.........#
..........#
#.........#
#.#.....#.#
#..#...#..#
#.........#
###########
key : 6

4
3
#####.#####
#.........#
#.........#
#....###..#
#.....#.#.#
#...###...#
#....##.#.#
#....###.##
#.........#
#X........#
###########

2
1
#####.#####
#e.#.....##
#.........#
#.........#
#...#.....#
...........
#.........#
#..#..#..##
#.........#
#e.......e#
#####.#####
enemies 3

1
1
###########
#.........#
#.#.#.....#
#.........#
#..#.#.#..#
...........
#.#.#...#.#
#.........#
#........##
#.........#
#####.#####

2
3
#####.#####
#.........#
#.........#
#.........#
#.........#
d.........#
#.........#
#.........#
#.........#
#.........#
#####.#####

3
0
#####.#####
#.........#
#.........#
#.........#
#.........#
#..........
#.........#
#.........#
#.........#
#.........#
###########

0
3
###########
#e..?e....#
#.........#
#.........#
#.........#
...........
#.........#
#.........#
#.........#
#s........#
#####.#####
enemies 2
switch 0 : 0 1
sign The dungeon remembers all who enter.

3
2
#####.#####
#......#..#
#.........#
#.........#
#.........#
..........l
#.........#
##..#.....#
#.........#
#....k....#
###########
key : 4

3
3
#####.#####
#.........#
#......#..#
#.........#
#...e.#...#
l....##...#
#......##.#
#.........#
#.........#
#.........#
#####.#####
locked : 2
boss
enemies 1

1
3
#####.#####
#.........#
#.........#
#.........#
#.........#
d..##......
#..#......#
#..##.....#
#.##......#
##........#
#####.#####

1
4
#####.#####
#e........#
#.........#
#.###.....#
#.#e#.....#
...........
#.........#
#.........#
#.........#
#?...e....#
###########
enemies 3
door 0 : 0 1
sign A useful tool lies just ahead.

1
0
#####d#####
#.........#
#.........#
#.........#
#.........#
#....@.....
#.........#
#.........#
#.........#
#.......#?#
#####.#####
sign Many have walked this path.

0
0
###########
#..#.....##
#.........#
#.........#
#...#..#..#
#.........#
#.........#
#..#..#..##
#.........#
#.........#
#####d#####

2
2
#####.#####
#.........#
#..#...#..#
#.#.....#.#
#.........#
..........d
#.........#
#.........#
#.........#
#.........#
#####.#####

1
2
#####d#####
#k........#
#.........#
#.........#
#.........#
..........d
#.........#
#.#.......#
#..#......#
#.........#
#####.#####
key : 0

3
1
#####.#####
#.........#
#......#..#
#.......#.#
#.........#
...........
#.........#
#.#.......#
#..#......#
#..k......#
###########
key : 2

0
2
###########
#.........#
##.#.....##
#.........#
#..#.#.#..#
#..........
#....#.#..#
#.........#
#......#.##
#.........#
#####d#####

2
0
#####.#####
#.........#
#......#..#
#.......#.#
#....#....#
#..........
#.........#
#.......#.#
#......#..#
#.........#
#####.#####

0
4
###########
#.......ee#
#........e#
#.........#
#.........#
...####...#
#.....#...#
#....#.#..#
#...#.....#
#..#......#
#####.#####
enemies 3

