5
1
#####D#####
##........#
#.........#
#.........#
#.......#.#
D.........D
#.........#
##..#..#..#
#.........#
#k........#
#####l#####
key : 1

1
1
###########
#.........#
#......#..#
#.........#
#.........#
#.........D
#.........#
#.........#
#.........#
#.........#
#####D#####

2
1
#####D#####
#.........#
#.........#
##..#..#..#
#.........#
#.........d
#.#..#..#.#
#.........#
#.........#
##........#
#####d#####

1
2
#####D#####
#.........#
##........#
#.........#
#.........#
D...#..#..D
#.........#
#.........#
##.....#..#
#.........#
#####D#####

4
1
#####D#####
#?........#
#.........#
#.#..#..#.#
#.........#
D.........D
#.#.....#.#
#.........#
#.........#
#e#.....#e#
#####D#####
enemies 2
sign Those who search shall find.

5
2
#####D#####
#e.......?#
#.........#
#.........#
#.........#
D........e#
#.........#
#.........#
#.........#
#e........#
#####D#####
enemies 3
sign Those who search shall find.

6
2
#####D#####
#.........#
#.........#
#.#.#.#...#
#.........#
d...#.#...#
#.........#
#.....#.#.#
#.........#
#.#.....#.#
#####D#####

3
1
#####d#####
#.........#
#.........#
#.........#
#..#.###..#
D.....##..#
#..#####..#
#......#..#
#..#...#..#
#.........#
#####D#####

5
0
#####D#####
#..#.....##
#.........#
#.........#
#.....#...#
#.........D
#.........#
#..#.....##
#.........#
#k........#
###########
key : 0

6
1
#####l#####
#.........#
#.........#
#.........#
#.........#
#.........d
#.........#
#.#.....#.#
#..#...#..#
#.........#
#####l#####
locked : 0

1
3
#####D#####
#.........#
#.........#
#.........#
#.........#
D..##.....#
#..#.#....#
#..#......#
#.........#
#........X#
###########

4
2
###########
#........k#
#.#.....#.#
#.........#
#.........#
D.....#...#
#.........#
#.........#
#.........#
#.........#
#####D#####
key : 2

7
2
#####D#####
#.........#
#......#..#
#.......#.#
#.........#
l.........#
#.........#
#.........#
#.........#
#.........#
###########
locked : 2

3
0
###########
##.....#..#
#.........#
#.........#
#...#..#..#
#.........D
#.........#
##..#.....#
#.........#
#.........#
#####D#####

2
2
#####D#####
#.........#
#.........#
#.........#
#.........#
d.........#
#.........#
#.......#.#
#......#..#
#.........#
###########

0
3
###########
#......#..#
#.........#
#....###..#
#.........#
d....e....#
#.........#
#.........#
#.........#
#.........#
#####D#####
boss
enemies 1

7
1
#####l#####
#.........#
#####.....#
###..#....#
#.#.##....#
#....#....l
#.###.....#
#.........#
#.........#
#.........#
###########
locked : 1

4
0
#####D#####
#......##.#
#.....###.#
#.......#.#
#.........#
#...#@....D
#.........#
#.........#
#.........#
#.........#
#####D#####

0
2
###########
#k........#
#.........#
#.........#
#.........#
#.........d
#.........#
#.......#.#
#......#..#
#.........#
#####D#####
key : 8

