2
0
#####l#####
#.........#
#.........#
#.........#
#.........#
#....@....D
#..#......#
#.........#
#.........#
#.........#
#####D#####

2
2
#####D#####
#.........#
#..#......#
#.####....#
#.##k.....#
D..##.....#
#.........#
#.....p...#
#.........#
#.........#
#####D#####
key : 1

3
2
#####D#####
#k#.....#.#
#.........#
#..#.#...##
#.........#
D...#.....#
#.........#
#..#.#.#..#
#.........#
#.#.....#.#
#####D#####
key : 3

1
2
###########
#.........#
#..#...#..#
#.#.....#.#
#.........#
l.........D
#.........#
#.......#.#
#......#..#
#.........#
#####D#####
locked : 3

1
3
###########
#.......ee#
#.........#
#.........#
#.........#
D.........#
#.........#
#.........#
#.p.......#
#........e#
###########
enemies 3

5
2
#####D#####
##........#
#.........#
##........#
#.........#
D.........D
#.........#
#.......#.#
#......##.#
#.........#
#####d#####

5
3
###########
#.........#
#.........#
#.........#
#.##......#
D.........d
#.#.......#
#.........#
#.........#
#.........#
###########

4
1
#####D#####
#.........#
#.........#
#.#.#.....#
#k##......#
#..#..#...d
#......##.#
#.....#.#.#
#.........#
#.........#
#####l#####
key : 2

1
1
#####d#####
#.........#
#.........#
#.........#
#.........#
D.........l
#.........#
#.......#.#
#......#..#
#.........#
#####l#####
locked : 1

3
1
#####D#####
#.........#
#.........#
##..#.....#
#.........#
D.........D
#.........#
#.........#
#.........#
##.....#..#
#####D#####

1
0
###########
#.........#
#.........#
#.........#
#.........#
#.........D
#.........#
#.........#
#.........#
#.........#
#####l#####
locked : 0

2
1
#####l#####
#k........#
#..#......#
#.#.......#
#.........#
D.........D
#.........#
#.#.....#.#
#..#...#..#
#.........#
#####D#####
key : 0

4
2
#####D#####
#.........#
#..#......#
#.#.......#
#.........#
d.........#
#.........#
#.#.......#
#..#......#
#.........#
#####D#####

6
4
#####D#####
#.........#
#.........#
#.........#
#.........#
#.........#
#.........#
#.........#
#.........#
#X........#
###########

5
4
###########
#......##.#
#.........#
#.........#
#...#.###.#
d....e....#
#.##......#
#.........#
##........#
#.........#
#####D#####
boss
enemies 1

0
1
###########
#.........#
#..#...#..#
#.#.....#.#
#.........#
#.........#
#.........#
#.......#.#
#......#..#
#.........#
#####d#####

6
2
#####d#####
#......#..#
#.........#
#.........#
#.........#
#.........#
#.........#
#.......#.#
#......#..#
#.........#
###########

5
1
#####l#####
#.........#
#.........#
#.........#
#.........#
#..#......D
#.####....#
#...##....#
#..#......#
#.........#
###########
locked : 2

3
0
#####D#####
#.........#
#.........#
#.........#
#.........#
#.........D
#.........#
#.........#
#.........#
#.........#
###########

