3
1
#####.#####
#.#.....#.#
#.........#
#..#.#.#..#
#.........#
l...#......
#.........#
#..#.#.#..#
#.........#
#.#.....#.#
#####.#####
locked : 0

5
1
#####d#####
#.........#
#.........#
#.........#
#.........#
#.........#
#.........#
#.........#
#.........#
#.........#
###########

1
3
#####.#####
#.........#
#.#.......#
#.........#
#.##e.....#
.....#....#
#....##...#
#.....#..##
#........##
#......#.##
#####l#####
locked : 6
boss
enemies 1

1
1
###########
#.........#
#..#......#
#.#.......#
#.........#
...........
#....#....#
#.#.......#
#..#......#
#.........#
#####.#####

1
0
###########
#?........#
#.........#
#.........#
#.........#
#....@.....
#.........#
#.........#
#.........#
#.........#
#####.#####
sign A useful tool lies just ahead.

1
2
###########
#..#......#
#.#.......#
#.###.....#
#.#.#.....#
....#......
#.#.......#
#..#.#....#
#.........#
#.........#
#####l#####

3
2
#####d#####
#.........#
#.........#
#.........#
#.........#
.....##....
#.....###.#
#....#.####
#......####
#........##
#####.#####

4
2
#####.#####
#.........#
#.........#
#.........#
#.........#
d.........#
#.........#
#.........#
#.........#
#.........#
###########

2
0
#####.#####
#k........#
##.#...#.##
#.........#
#....#.#..#
#..........
#..#.#.#..#
#.........#
##.#...#.##
#.........#
#####.#####
key : 0

2
4
###########
##.....#.##
#.........#
##.#.#.#.##
#.........#
...#.#.....
#.........#
##.#.#.#..#
#.........#
##k#...#.##
###########
key : 6

3
0
#####.#####
#.........#
#.......#.#
#.........#
#.........#
#....#....l
#.........#
#.........#
#.#.....#.#
#.........#
#####.#####

2
2
#####l#####
#.........#
#..#...#..#
#.#.....#.#
#.........#
...........
#.........#
#.........#
#.........#
#.........#
#####d#####
locked : 2

4
1
#####.#####
#.........#
##.....#..#
#.......#.#
#.........#
l.........d
#.........#
#.#.......#
#..#......#
#.........#
#####d#####
locked : 1

2
3
#####l#####
#..#......#
#.........#
#.........#
#.......#.#
...........
#.........#
#.#.....#.#
#.##...#..#
#.........#
#####.#####

2
5
###########
#........e#
#.#...#.#.#
#.........#
#..#.#.#..#
..........#
#.#.#.#.#.#
#.........#
#......#..#
#........?#
###########
enemies 1
sign What you seek is close.

3
3
#####.#####
#.......#.#
#.........#
#.........#
#..#..#...#
..........#
#.........#
#....#..#.#
#.........#
#.........#
###########

2
1
#####.#####
#k........#
##..#..#..#
#.........#
#.........#
....#......
#.........#
#.........#
##..#..#..#
#.........#
#####.#####
key : 1

0
3
###########
#X.....#..#
#..#..#...#
#..#..##..#
#..###....#
#...##....#
#...#.#...#
#.....#...#
#.........#
#.........#
#####.#####

4
0
#####.#####
#.........#
#.........#
#.........#
#....#..#.#
#...#.....l
#.##..#...#
#.####....#
#.###.....#
#k........#
###########
key : 2

