2
0
#####D#####
#.........#
#.........#
#.........#
#.........#
#?...@....D
#.........#
#.........#
#.........#
#.........#
#####D#####
sign What you seek is close.

5
1
###########
#.........#
#.........#
#.........#
#.........#
D.........#
#.........#
#.......#.#
#......#..#
#.........#
#####d#####

8
3
#####D#####
#.........#
#...#.....#
#.........#
#.......#.#
D..##.....#
#.#.#.....#
#.#..#....#
###.......#
###......X#
###########

8
2
#####D#####
#.........#
#.........#
#.........#
#.........#
D.........D
#....#....#
#.........#
#.........#
#....k....#
###########
key : 6

4
0
#####d#####
#.##......#
#.#....##.#
#..#......#
#..##.###.#
#..##.....#
#.........#
#.........#
#.........#
#.........#
#####D#####

1
1
###########
#.........#
#.........#
#.........#
#.........#
l..#......#
#.........#
#.#.......#
#..#......#
#.#.......#
#####D#####
locked : 0

1
0
#####D#####
#.......#.#
#.........#
#.........#
#.#..#..#.#
#.........l
#.........#
#.#.....#.#
#.........#
#.........#
#####D#####

5
0
#####D#####
#.........#
#.........#
#.........#
#.........#
#.........D
#.........#
#.........#
#.........#
#.........#
#####D#####

6
1
#####d#####
#.........#
#.........#
#.........#
#.........#
l.........D
#.........#
#.#.......#
#..#......#
#.........#
#####l#####
locked : 1

2
1
#####D#####
#.#.....#.#
#.........#
#.#.#.#.#.#
#.........#
D...#.#...#
#.........#
#.#.#.#.#.#
#.........#
#.#.....#k#
###########
key : 0

0
0
###########
#.........#
#.......#.#
#.......#.#
#.........#
#.........#
#.........#
#.#.....#.#
#..#...#..#
#.........#
#####D#####

8
1
#####D#####
#.........#
#.#.#.#.#.#
#.........#
#.#.#...#.#
#.........D
#.#.#.#.#.#
#.........#
#.#.#.#.#.#
#.........#
###########

6
0
#####D#####
#.........#
#..#......#
#.#.......#
#.........#
#.........l
#.........#
#...#...#.#
#......#..#
#........##
#####d#####

7
0
#####d#####
##........#
#.........#
#.........#
#.#..#..#.#
#.........D
#.........#
##........#
#.........#
#.........#
###########

7
2
#####D#####
#..#...##.#
#...#..#..#
#....##?#.#
#...#.#...#
D..##.##..d
#..#..e#..#
#..#.###..#
#.........#
#.........#
#####D#####
enemies 1
sign This door will not yield without a key.

3
0
#####D#####
#......####
#.....#..##
#....###.##
#....###.k#
#....#....#
#.........#
#.........#
#.........#
#.........#
#####d#####
key : 1

7
3
###########
#.........#
#.........#
#.........#
#.........#
d....e....#
#.........#
#.........#
#.........#
#.........#
#####D#####
boss
enemies 1

6
2
###########
#........k#
###.......#
#.........#
#....#....#
D.........#
#.........#
#.#.....#.#
#..#...#..#
#.........#
#####D#####
key : 5

7
1
#####l#####
#..#......#
##.##.....#
#..####...#
#.#.#.....#
D...###...D
#....##...#
#..####...#
#.....p...#
#.........#
#####D#####
locked : 5

