1
3
#####D#####
#.........#
#.........#
#.......#.#
#.........#
D....e....#
#.....#...#
#.........#
#.........#
#.........#
#####l#####
locked : 1
boss
enemies 1

2
4
###########
#........k#
#......#..#
#.......#.#
#.........#
D.........#
#.........#
#.......#.#
#......#..#
#.........#
###########
key : 5

3
2
#####D#####
#e.......e#
#.........#
#.........#
#.........#
D.........D
#.........#
#.........#
#.........#
#e.......?#
#####D#####
enemies 3
sign A useful tool lies just ahead.

4
3
#####D#####
#.........#
#.#....#..#
#.......#.#
#.........#
d.........#
#.........#
#..#....#.#
#......##.#
#.........#
###########

5
2
#####d#####
#.......#.#
#.........#
#.#...#.#.#
#.........#
#.....#...#
#.........#
#.#.#.#.#.#
#.........#
#.#.....#.#
###########

0
1
###########
#e.......e#
#.........#
#e#..#..#.#
#.........#
#.........#
#..#..#...#
#.........#
#.........#
#.#.....#.#
#####D#####
enemies 3
door 0 : 0 1

2
2
#####D#####
#.........#
#.........#
#.........#
#.........#
D.........D
#.........#
#.........#
#.........#
#.........#
#####D#####

0
3
###########
#X........#
#.........#
#.#.......#
#.###.....#
#.........#
#.........#
#.........#
#.........#
#.........#
#####D#####

1
2
###########
#.........#
#..#......#
#.#.......#
#.........#
D.........D
#.........#
#.#.......#
#..#......#
#.........#
#####D#####

2
3
#####l#####
#k........#
#..#......#
#.#.......#
#.........#
D.........D
#.........#
#.........#
#.........#
#.........#
#####D#####
key : 3

3
1
#####D#####
#.........#
##.#.....##
#.........#
#..#.#....#
D.........D
#..#.#.#..#
#.........#
##.#.....##
#.........#
#####l#####

3
0
###########
#?##......#
#.........#
###.......#
#......#..#
#....@....D
#....##...#
#.........#
#.........#
#.........#
#####D#####
sign Something glints behind that door…

1
1
#####D#####
#..#.....##
#.........#
#.........#
#...#.....#
#.........D
#.........#
#.....#..##
#.........#
#.........#
#####d#####

4
0
#####D#####
#..#.....##
#.........#
#.........#
#..#......#
#k........D
#.........#
#........##
#.........#
#.........#
#####d#####
key : 0

5
0
#####d#####
#.........#
#..#......#
#.#.......#
#.........#
#.........#
#.........#
#.........#
#.........#
#.........#
###########

3
3
#####D#####
#.........#
#.........#
#....##...#
#.####....#
D.........#
#..####k#.#
#.#.#####.#
#.........#
#.........#
#####D#####
key : 1

4
2
#####D#####
#e........#
##.#......#
##........#
#e#.......#
D.........d
#.........#
#.........#
#.........#
#s........#
#####d#####
enemies 2
switch 0 : 0 1

4
1
#####l#####
#.........#
#.........#
#.........#
#.........#
D.........D
#.........#
#.#.....#.#
#..#...#..#
#.........#
###########
locked : 0

2
1
#####d#####
#.......#.#
#.........#
#....#.#.##
#.........#
#...#.#...D
#.........#
#.........#
#.........#
#.......#.#
#####D#####

