6
1
###########
#........k#
#......#.##
#.........#
#..#.#.#..#
D.........#
#..#.#....#
#.........#
#..#...#.##
#.........#
#####d#####
key : 4

5
0
#####D#####
#.........#
#.........#
#.........#
#.........#
#..#...#..#
#..#...#..#
#..#####..#
#..#..##..#
#..#......#
#####d#####

1
2
###########
#.........#
#.........#
#.........#
#....#....#
D.........#
#.........#
#.......#.#
#......#..#
#.......#k#
###########
key : 5

1
1
#####d#####
#.........#
#.........#
#.........#
#.........#
D.........D
#.........#
#.......#.#
#......#..#
#.........#
#####D#####

4
0
#####D#####
#.........#
#........##
#.........#
#.........#
#....@....D
#.........#
#..#......#
#.........#
#.........#
#####D#####

7
1
#####d#####
##.....#..#
#.........#
#.........#
#...#..#..#
#.........#
#.........#
#...#.....#
#.........#
#.........#
#####l#####

3
1
#####D#####
#.........#
#..#......#
#.#.......#
#.........#
D.........#
#.........#
#.#.......#
#..#......#
#.........#
#####D#####

0
1
###########
#.........#
#.........#
#..###....#
#.##......#
#...#.....#
#.####....#
##........#
#.........#
#.........#
#####d#####

6
0
#####d#####
#.........#
#.........#
###.......#
#.........#
#..##.....D
#.###.....#
#.##......#
#.........#
#.........#
###########

1
0
###########
#.........#
#.........#
#.........#
#.........#
#.........D
#.........#
#.........#
#.........#
#.........#
#####l#####
locked : 3

8
1
#####l#####
#.........#
#.#.....#.#
#.........#
#.........#
#..#..#...D
#.........#
#.........#
#.......#.#
#.........#
#####D#####
locked : 0

8
2
###########
#.#......e#
#..##.....#
#.###.#...#
#..#.##...#
D..#..#...#
#.#..#....#
#.........#
#.........#
#.........#
#####D#####
enemies 1

9
1
#####D#####
#.........#
#.........#
##........#
#.........#
#.........d
#.........#
#.........#
#?........#
#e........#
###########
enemies 1
sign This door will not yield without a key.

2
1
#####D#####
#.........#
#........e#
#..#.....##
#........e#
D.........#
#..#..#...#
#.........#
#.........#
#..#.....##
#####D#####
enemies 2

10
2
#####D#####
#.........#
#.........#
#.........#
#.........#
#.........#
#.........#
#.........#
#.........#
#X........#
###########

2
0
#####l#####
#.........#
#.#.#.#.#.#
#.........#
#.....#.#.#
#.........D
#k#.#.#.#.#
#.........#
#.....#.#.#
#.........#
#####D#####
key : 3

3
0
#####D#####
#.........#
#.........#
#.........#
#....#....#
#k........D
#.........#
#.........#
#.........#
#.........#
#####D#####
key : 0

4
1
#####D#####
###.......#
#.##......#
#..#......#
#....##...#
D.....##..#
#....###..#
#.........#
#.........#
#.........#
###########

9
2
#####D#####
#......#..#
#.........#
#.........#
#.........#
d....e....#
#.........#
#.........#
#.........#
#.........#
#####D#####
boss
enemies 1

