4
3
#####.#####
#.........#
#.........#
#.........#
#.........#
..........#
#.........#
#.......#.#
#......#..#
#........k#
###########
key : 2

1
1
###########
##........#
#..#......#
#.#.......#
#.......#.#
l..........
#.........#
#.##....#.#
#..#...#..#
#.........#
#####.#####
locked : 1

5
1
#####d#####
#.........#
#.........#
#.........#
#.........#
...........
#.........#
#.......#.#
#......#..#
#.........#
###########

4
1
#####.#####
#.........#
#.....##..#
#.....##..#
#.........#
l..........
#.........#
#..#......#
#.........#
#.........#
#####d#####
locked : 0

6
0
#####d#####
#.........#
#.........#
#.........#
#.........#
#.........#
#.........#
#...#.....#
#.#.....#.#
#.........#
###########

3
1
#####d#####
#.........#
#.........#
#.........#
#.........#
......#....
#.....k#..#
#....##.###
#.....#.###
#.........#
#####.#####
key : 0

3
2
#####.#####
#e.......e#
#.........#
#.........#
#.........#
...........
#.........#
#.........#
#.........#
#e.......?#
#####.#####
enemies 3
sign Those who search shall find.

2
2
#####.#####
#.........#
#.........#
#.........#
#.........#
d....e....#
#.........#
#.........#
#.........#
#.........#
#####.#####
boss
enemies 1

2
1
#####.#####
#.........#
#..#......#
#.#.......#
#.........#
..........d
#.........#
#.......#.#
#......#..#
#.........#
#####d#####

2
0
#####.#####
#.........#
#.........#
#.........#
#.........#
#..........
#.........#
#.........#
#.........#
#.........#
#####.#####

3
0
#####.#####
#.........#
#.........#
#.........#
#.........#
#?..#@.....
#...#.....#
#.........#
#.........#
#.........#
#####.#####
sign The brave are rewarded.

4
2
#####.#####
#.........#
#...#.....#
#..###....#
#..####...#
...#.#.....
#.#..##...#
#...##....#
#...#.#...#
#.........#
#####.#####

1
2
###########
#........X#
##..#.....#
#..#...#..#
#...#.....#
....#.....#
#.........#
#.........#
#.........#
#.........#
#####.#####

5
2
#####.#####
#.........#
#.........#
#.........#
#.........#
..........#
#..#......#
#..#......#
#.........#
#.......?e#
###########
enemies 1
door 0 : 0 1
sign Beware what lurks ahead.

5
0
#####.#####
#.........#
#..#......#
#.#.......#
#.........#
#..........
#.........#
#.......#.#
#......#..#
#.........#
#####d#####

1
0
#####.#####
#.........#
#.#.#.#.#.#
#.........#
#k#.#.#...#
#.........l
#.#.#...#.#
#.........#
#.#.#.#.#.#
#.........#
#####.#####
key : 1

4
0
#####.#####
#.........#
#.#.....#.#
#.........#
#.........#
#..#......l
#.........#
#.........#
#.......#.#
#.........#
#####.#####

0
0
###########
#e.#s..#..#
#..##..#..#
#..#..##..#
#....#....#
#..#####..#
#.........#
#.........#
#.........#
#.........#
#####.#####
enemies 1
switch 0 : 0 1

3
3
###########
#........k#
#.........#
#.#.......#
#.........#
..........#
#.#..#..#.#
#.........#
#.........#
#.......#.#
#####.#####
key : 4

