4
0
#####D#####
#.#.....#.#
#.........#
#.#.#.#.#.#
#.........#
#.........d
#.........#
#...#.....#
#.........#
#.#.......#
#####D#####

3
1
#####D#####
#........k#
#........##
#.........#
#.........#
D.........D
#...#.....#
#.#.....#.#
#..#...#..#
#.........#
#####D#####
key : 3

3
0
#####D#####
#.........#
#.........#
#...#.....#
#.........#
#k........D
#.........#
#.........#
#.......#.#
#..#......#
#####D#####
key : 0

1
3
###########
#.........#
#..#......#
#.#.......#
#.........#
D.........#
#.........#
#.#.......#
#..#......#
#.........#
###########

5
2
#####D#####
#.........#
#......#.##
#.........#
#......#..#
D.........#
#....#.#..#
#.........#
#..#.....##
#........k#
###########
key : 5

4
3
#####D#####
#.........#
#.........#
##.##.....#
#.###.....#
D...#.....#
#..##.....#
#.........#
#.........#
#........X#
###########

0
2
###########
#.........#
#.........#
#.........#
#.........#
#.........#
#.........#
#.#.......#
#..#......#
#.........#
#####d#####

6
1
#####D#####
#.........#
#...#.#.#.#
#.........#
#.#.#...#.#
#.........#
#.#...#.#.#
#.........#
#.#...#.#.#
#k........#
###########
key : 4

1
2
#####d#####
#.........#
#..#...#..#
#.#..#..#.#
#.........#
#.........D
#.#.......#
#.........#
#.........#
#.........#
#####d#####

4
2
#####D#####
#e.......e#
#...#..#..#
#.........#
#.........#
D...#.....D
#.........#
#.........#
##..#..#..#
#e........#
#####D#####
enemies 3

5
1
#####D#####
#e......pe#
#.....#...#
#.....#...#
#.....###.#
D.........D
#...p.....#
#.........#
#.........#
#?........#
#####D#####
enemies 2
door 0 : 0 1
sign A useful tool lies just ahead.

2
2
#####d#####
#........e#
#..#..#..##
#........e#
#.........#
D..#......#
#.........#
#........?#
#........##
#........e#
#####l#####
enemies 3
sign A locked path — look elsewhere first.

3
2
#####l#####
#.........#
#.........#
#.........#
#.........#
D.........d
#.........#
#.........#
#.........#
##........#
#####D#####
locked : 0

2
1
###########
#.........#
#..#.....##
#.........#
#.........#
D...#..#..D
#.........#
#.........#
#..#..#..##
#.........#
#####D#####

5
0
#####D#####
#.........#
#.........#
#..#......#
#.........#
#.........D
#...#..#..#
#?........#
#s........#
#e........#
###########
enemies 1
switch 0 : 0 1
sign Beware what lurks ahead.

2
0
#####D#####
#.........#
#.........#
#.........#
#.........#
#?...@....D
#.........#
#.........#
#.........#
#.........#
#####D#####
sign Those who search shall find.

3
3
###########
#.........#
#.........#
#.........#
#.#.##e.#.#
d...####..#
#..###.#..#
#..#.#..#.#
##....#...#
#.........#
#####D#####
boss
enemies 1

1
0
###########
#.#.......#
#..#......#
#.#..#....#
#..##.#...#
#...#.#...#
#.........#
#.........#
#.........#
#.........#
#####D#####

4
1
#####D#####
#.........#
#.........#
#.........#
#.........#
d.........D
#.........#
#.#.....#.#
#..#...#..#
#.........#
#####D#####

