3
0
#####D#####
##.#......#
#k........#
##.#.#.#.##
#.........#
#..#.#.#..d
#.........#
##.#.#...##
#.........#
##.#.....##
#####D#####
key : 1

3
2
#####D#####
#k.....#..#
##.##.#...#
###...##..#
#.####.#..#
D..##.....D
#.........#
#.........#
#.........#
#.........#
#####D#####
key : 3

1
3
#####D#####
#e........#
#.........#
#.........#
#.##......#
D.e#......d
#.##......#
#.........#
#.........#
#e........#
#####D#####
enemies 3

2
1
###########
#.........#
####......#
#.##......#
#.#.#.....#
D...##....D
#..#.#....#
#.........#
#.........#
#.........#
#####D#####

1
5
###########
#........e#
#.....#..##
#.........#
#.........#
D.....#...#
#.........#
#.........#
#.....#..##
#........?#
###########
enemies 1
door 0 : 0
sign Many have walked this path.

4
0
#####D#####
##........#
#####.....#
##.#......#
#..#......#
#.........D
#.........#
#.........#
#s........#
#e........#
###########
enemies 1
switch 0 : 0

0
3
###########
#.........#
#..#...#..#
#.#.....#.#
#......#..#
#.........D
#.........#
#.........#
#......#..#
#.........#
#####D#####

1
2
###########
#.#.....#.#
#.........#
#.#.#.#.#.#
#.........#
#...#.....D
#.........#
#.#.#.#...#
#.........#
#.#.....#.#
#####d#####

4
2
#####D#####
#.........#
#.........#
#.........#
#.........#
d.........#
#.........#
#.........#
#.........#
#.........#
###########

1
0
###########
#k........#
#.........#
#.........#
#.........#
#..###....#
#.........#
#.##......#
#.#.......#
##........#
#####D#####
key : 0

4
1
#####D#####
#.........#
#.........#
#.........#
#.........#
D.........d
#.........#
#.#.....#.#
#..#...#..#
#.........#
###########

3
3
#####l#####
#.........#
#.........#
#.........#
#.........#
D.........#
#.........#
#.........#
#.........#
#.........#
###########
locked : 1

2
2
#####d#####
#.........#
#......#.##
##......#.#
#.........#
D.........D
#.........#
#.........#
#.........#
#.........#
#####D#####

2
4
#####D#####
#.........#
#.........#
#.........#
#.........#
l.........#
#.........#
#.........#
#.........#
#.........#
###########
locked : 2

3
1
#####D#####
#.........#
#.........#
#.........#
#.........#
d.........D
#.........#
#.......#.#
#......#..#
#.........#
#####D#####

2
3
#####D#####
#.........#
#......#..#
#.......#.#
#.........#
D.........l
#.........#
#.#.....#.#
#..#...#k.#
#.......#.#
#####l#####
key : 2

1
4
#####D#####
#.........#
#.........#
#.........#
#.........#
d....e....D
#.........#
#.........#
#.........#
#.........#
#####D#####
boss
enemies 1

0
4
###########
#........X#
#.........#
#.........#
#.........#
D....#.#..#
#.....#...#
#....#....#
#.........#
#.........#
#####D#####

2
0
#####D#####
#......#..#
#.....###.#
#.....##..#
#.........#
#....@##..D
#....###..#
#.........#
#.........#
#.........#
#####D#####

