7
1
#####.#####
#.........#
#..#...#..#
#.#.....#.#
#.........#
..........#
#.........#
#.........#
#.........#
#.........#
#####.#####

2
1
###########
#........e#
#.........#
#.#.....#?#
#.........#
..........#
#.....#...#
#.........#
#.........#
#.#.....#.#
#####.#####
enemies 1
door 0 : 0 1
sign What you seek is close.

6
0
#####.#####
#.........#
#.........#
#..#......#
#.........#
#....@.....
#.........#
#.........#
#.........#
##........#
#####l#####

5
1
#####.#####
#........k#
#.....#..##
#.........#
#.........#
....#..#..d
#.........#
#.........#
#.....#..##
#.........#
#####.#####
key : 1

2
0
#####d#####
#..#.....##
#.........#
#.........#
#...#.....#
#k.........
#.........#
#..#..#..##
#.........#
#.........#
#####.#####
key : 7

4
0
#####.#####
#.........#
#.........#
#..#..#..##
#.........#
#..........
#..#..#...#
#.........#
#.........#
#..#......#
#####d#####

5
2
#####.#####
#.........#
#......#..#
#.......#.#
#.........#
d.........#
#.........#
#.........#
#.........#
#.........#
###########

0
0
###########
#X........#
#.........#
#.........#
#...###.#.#
#....#....#
#.....###.#
#....##.#.#
#.....#...#
#.........#
#####.#####

3
1
#####.#####
#e........#
#.........#
#.........#
#.........#
.......#.e#
#.##......#
####......#
##........#
#e........#
#####.#####
enemies 3

6
1
#####.#####
#.........#
#..#...#..#
#.#.....#k#
#.........#
..........#
#.........#
#.....#...#
#.....#.#.#
#.........#
#####.#####
key : 0

1
0
#####.#####
#.........#
#..#......#
#..##.....#
#.###e....#
#...###...#
#.#####...#
#.#.#.#...#
#.......#.#
#......##.#
#####d#####
boss
enemies 1

3
0
#####.#####
#.........#
#?........#
##..#..#..#
#e........#
#..........
#e#..#....#
#.........#
#.........#
##.....#..#
#####.#####
enemies 2
sign Those who search shall find.

4
1
#####.#####
#......#..#
#.....#...#
#..##..#..#
#....#.#..#
.......#..d
#.........#
#.........#
#.........#
#.#.......#
#####.#####

4
2
###########
#.........#
#......#..#
#.......#.#
#.........#
d.........#
#.........#
#.........#
#.........#
#.........#
#####.#####

8
0
#####.#####
##.#...#.##
#.........#
#..#.#.#.##
#.........#
#..#.#.....
#.........#
##.#.#.#..#
#.........#
##.#.....##
#####.#####

9
0
#####.#####
#.........#
#.........#
##.....#..#
#.........#
#.........#
#....#..#.#
#.........#
#e........#
##s....#?e#
###########
enemies 2
switch 0 : 0 1
sign The dungeon remembers all who enter.

7
0
#####l#####
#.........#
#.........#
#.........#
#...#...#.#
#....#.#...
#...##.##.#
#...##..#.#
#.....###.#
#.........#
#####.#####
locked : 0

5
0
#####d#####
#.........#
#.#...#...#
#.........#
#..#.#.#..#
#..........
#.#.#.#...#
#.........#
#..#...#..#
#.........#
#####.#####

8
1
#####.#####
#.........#
#..#...#..#
#.#.....#.#
#.........#
..........#
#.........#
#.#.....#.#
#..#......#
#........k#
###########
key : 3

