3
2
#####D#####
#.........#
#.......#.#
#.........#
#.........#
D.........D
#.........#
#.#.....#.#
#..#...#..#
#.........#
#####D#####

2
2
#####d#####
#e........#
#..#..#...#
#.........#
#.........#
D..#..#...D
#.........#
#.........#
#..#..#..##
#e.......e#
#####D#####
enemies 3

3
3
#####D#####
#.........#
#.........#
#...###...#
#..####...#
D...##k#..d
#..###.#..#
#...##.#..#
#.........#
#.........#
###########
key : 1

3
4
#####d#####
##.#...#.##
#.........#
#..#.#...##
#.........#
d.........#
#.........#
##.#.#.#..#
#.........#
##.#...#.##
###########

1
4
###########
#........X#
#.........#
#....##...#
#.....###.#
D.....##..#
#.....##..#
#.........#
#.........#
#.........#
#####D#####

1
3
#####D#####
#k........#
#...#.....#
#.........#
#.#.....#.#
D.........D
#.#...#.#.#
#.........#
#.#.#.#...#
#.........#
#####D#####
key : 5

0
3
###########
#e.......e#
#.........#
#.........#
#.........#
#.........#
#.........#
#.........#
#.........#
#.........#
#####D#####
enemies 2
door 0 : 0 1

3
0
#####D#####
#.........#
#...#.....#
#...#.....#
#.....#...#
#....@....l
#.........#
#.........#
#.........#
#.........#
#####D#####

5
0
#####d#####
#.........#
#.........#
#.........#
#.........#
#.........#
#.........#
#.........#
#.........#
#.........#
###########

2
0
#####D#####
#.........#
#......#..#
#.......#.#
#.........#
#.........D
#.........#
#.........#
#.........#
#.........#
#####D#####

2
1
###########
#.........#
#......#..#
#.......#.#
#.....#...#
D.........D
#.........#
#.#.......#
#..#......#
#.........#
#####D#####

4
0
#####D#####
#.........#
#..#......#
#k#.......#
#.........#
#.........D
#.........#
#.#.....#.#
#..#...#..#
#.........#
#####d#####
key : 0

1
0
###########
#.........#
#.........#
#.........#
#..#......#
#.........#
#.........#
#.........#
#.........#
#.........#
#####D#####

4
1
#####D#####
#e........#
#.........#
#.........#
#.........#
D.........D
#.........#
#.........#
#.........#
#e.?se....#
###########
enemies 3
switch 0 : 0 1
sign This door will not yield without a key.

4
2
#####D#####
#.........#
#.#...#.#.#
#.........#
#.#...#.#.#
D.........#
#.#.#.#...#
#.........#
#.#.#.#.#.#
#.........#
###########

3
1
#####D#####
#.........#
#.........#
#.........#
#.........#
l.........D
#.........#
#.........#
#.........#
#.........#
#####D#####
locked : 0

2
3
#####D#####
#k........#
#.........#
#.........#
#.........#
D.........D
#.........#
#.#.....#.#
#..#...#..#
#.........#
#####D#####
key : 3

2
4
#####D#####
#.........#
#.###.....#
##.#......#
#...#.....#
D...#e....#
#.........#
#.........#
#.........#
#.........#
#####d#####
boss
enemies 1

1
2
###########
##.#.....##
#.........#
#.#.#...#.#
#.........#
#..#.#.#..D
#.........#
#.#...#.#.#
#.........#
##.#.....##
#####d#####

