2
0
#####d#####
#.........#
#.........#
#.........#
#.........#
#..........
#.........#
#.........#
#.........#
#.........#
#####.#####

1
0
###########
#.........#
#.........#
#...#..#..#
#.........#
#..........
#...#..#..#
#.........#
#.........#
##.....#..#
#####d#####

1
2
#####.#####
#.........#
#...#.....#
####.##...#
#..#.#....#
...#.e....#
#.........#
#.........#
#.........#
#.........#
#####l#####
locked : 2
boss
enemies 1

3
1
#####.#####
#.........#
#.........#
#.........#
#.........#
.......#...
#.........#
#.#.......#
#..#.....##
#.........#
#####d#####

4
1
#####d#####
#.........#
#.....#.#.#
#......##.#
#.....##..#
l...##....l
#.#####...#
#...#.....#
#.#.#....##
#.#.......#
#####.#####
locked : 0

2
3
###########
#.#.......#
#......#..#
#.......#.#
#.........#
d.........#
#.........#
#.#.......#
#..#......#
#.........#
#####.#####

5
1
#####.#####
#.........#
#..#...#..#
#.#.....#.#
#.........#
..........d
#.........#
#.........#
#.........#
#....k....#
###########
key : 3

0
2
###########
#X........#
#.........#
#.........#
#.........#
#.........#
#.........#
##...#....#
#.........#
#.........#
#####.#####

4
0
#####.#####
#.........#
#..#......#
#.#.......#
#.........#
#.........l
#.........#
#.........#
#.........#
#.........#
#####.#####

2
1
#####.#####
#k........#
#..#......#
#.#.......#
#.........#
...........
#.........#
#.........#
#.........#
#.........#
#####.#####
key : 2

3
0
#####.#####
#.........#
#.........#
#.........#
#...@#....#
#....#.#...
#....###..#
#.........#
#.........#
#.........#
#####.#####

4
3
#####.#####
#?........#
###.......#
##.###....#
#..##.....#
....##....#
#...##....#
#.........#
#........s#
#.......ee#
###########
enemies 2
switch 0 : 0
sign A locked path — look elsewhere first.

5
2
#####.#####
##........#
#.........#
#.........#
#.........#
d.........#
#.........#
#.......#.#
#......#..#
#.........#
###########

5
0
#####.#####
#.#.....#.#
#.........#
#..#.....##
#.........#
#...#.#....
#.........#
#..#.#.#..#
#.........#
#k#.....#.#
###########
key : 0

2
2
#####l#####
#.........#
#..#...#..#
#.#.....#.#
#.........#
..........d
#.........#
#.........#
#.........#
#.........#
#####.#####

4
2
#####.#####
#.........#
#.........#
#.........#
#.........#
l..........
#.........#
#.#.......#
#..#......#
#.........#
#####.#####
locked : 3

3
2
#####.#####
#k........#
#.........#
##..#..#..#
#.........#
...........
#....#..#.#
#.........#
#.........#
##........#
#####.#####
key : 5

3
3
#####.#####
#..#......#
#..##.#...#
#..###e...#
#.#####e..#
....##e#.?#
#.........#
#.........#
#.........#
#.........#
#####.#####
enemies 3
door 0 : 0
sign The brave are rewarded.

1
1
###########
#.........#
#.........#
#.........#
#.........#
...........
#.........#
#.........#
#.........#
#.........#
#####.#####

