4
3
#####.#####
#.........#
#..#..#..##
#.........#
#.........#
....#..#..#
#.........#
#.........#
#..#..#..##
#........k#
###########
key : 5

3
0
#####.#####
#.........#
#..#...#..#
#.......###
#.........#
#..........
#.........#
#.#.......#
#..#......#
#.........#
#####.#####

1
0
#####l#####
#.........#
#.........#
#.........#
#.........#
#....@.....
#.........#
#.........#
#.........#
#.........#
#####.#####

3
4
###########
#......#e.#
#......?#.#
#....#.#..#
#...#...#.#
..........#
#.........#
#.........#
#.........#
#.........#
###########
enemies 1
door 0 : 0 1
sign Beware what lurks ahead.

3
2
#####.#####
#.........#
#.........#
#.........#
#.........#
d.........d
#.........#
#.........#
#.........#
#.........#
#####.#####

3
1
#####.#####
#k........#
#..#......#
#.#..##...#
#.........#
..........d
#.........#
#.......#.#
#......#..#
#.........#
#####.#####
key : 1

4
2
#####.#####
##.....#..#
#.........#
#.........#
#.#..#....#
...........
#.........#
##..#..#..#
#.........#
#s...e....#
###########
enemies 1
switch 0 : 0 1

4
0
#####.#####
#.........#
#..#......#
#.#.......#
#.........#
#.........l
#.........#
#.#.....#.#
#..#...#.##
#.........#
#####.#####

1
1
###########
#.........#
#..#...#..#
#.#.....#.#
#.........#
..........d
#.........#
#.......#.#
#......#..#
#.........#
#####.#####

5
0
#####.#####
#.........#
#..#......#
#.#.......#
#.........#
#..........
#.........#
#.#.......#
#..#......#
#.........#
###########

1
2
###########
#.........#
#.........#
#.........#
#.........#
d......#..#
#.........#
#...#.#...#
#...#.....#
#.........#
#####.#####

2
0
#####.#####
#.........#
#k#.....#.#
#.........#
#.........#
#..#..#...d
#.........#
#.........#
#.#.....#.#
#.........#
#####.#####
key : 0

2
3
###########
#........X#
#......#..#
#.........#
#.........#
..........#
#.........#
#.........#
##........#
#.........#
#####.#####

5
1
#####.#####
#.........#
##.#...#.##
#.........#
#.#...#.#.#
..........#
#..#......#
#.........#
#.#.#.#.#.#
#........k#
###########
key : 4

0
0
###########
#.........#
#.........#
#.........#
#.........#
#.........#
#.........#
#.........#
#.........#
#.........#
#####l#####
locked : 0

2
1
#####.#####
#.........#
#......#..#
#.......#.#
#.........#
d..........
#.........#
#.......#.#
#......#..#
#.........#
#####.#####

2
2
#####.#####
#.........#
#......#..#
#.......#.#
#.........#
...........
#.........#
#.........#
#.........#
#.........#
#####.#####

4
1
#####.#####
#.........#
#.......#.#
#.........#
#.........#
l..........
#.........#
#........##
#.........#
#.........#
#####.#####
locked : 1

3
3
#####.#####
#.........#
#.....#...#
#.........#
#.........#
d....e.....
#.........#
#......#..#
#.........#
#.........#
#####.#####
boss
enemies 1

