1
4
#####D#####
#..#......#
#...#.....#
##.##.....#
#...#.....#
d..#e#....D
#....p....#
#.........#
#.........#
#.........#
#####D#####
boss
enemies 1

1
5
###########
#......X###
#......#.##
#......#..#
#.....#...#
D.........#
#.........#
#.........#
#.........#
#.........#
###########

2
2
#####D#####
#........##
#.........#
#.........#
#...#..#..#
D.........l
#.........#
#..#..#..##
#.........#
#.........#
#####D#####

2
1
#####l#####
##.#...#.##
#.........#
##.#.#...##
#.........#
#..#...#..D
#.........#
##.#.#.#..#
#.........#
##.#...#.##
#####D#####

1
1
###########
#.........#
#.#.....#.#
#.........#
#.........#
#..#..#...D
#.........#
#.........#
#.#.....#.#
#.........#
#####l#####
locked : 0

4
1
#####D#####
#.........#
#.....###.#
#...###.#.#
#.#.##..#.#
#..####...D
#.##.####.#
#.#...#...#
#.........#
#.........#
#####D#####

3
3
#####D#####
##.#.....##
#.........#
#.....#...#
#.........#
d..#.#....#
#.........#
#.#.#.#.#.#
#.........#
##.......##
###########

4
2
#####D#####
#.........#
#.........#
#...###...#
#.#k#.#...#
D..#..#...#
#.....#...#
#...#.#...#
#.p#......#
#.........#
#####D#####
key : 1

0
2
###########
#.........#
#.........#
#.........#
#.........#
#.........#
#.........#
#.........#
#.........#
#.........#
#####l#####
locked : 3

0
4
###########
#.........#
#..#...#..#
#.#....##.#
#.........#
#.........#
#.........#
#.......#.#
#......#..#
#.........#
#####D#####

3
0
###########
#.##......#
#.###.....#
#.##......#
#...#.....#
#...##....D
#...@.....#
#.........#
#.........#
#.........#
###########

5
1
#####D#####
#.........#
#.........#
##..#..#..#
#.........#
#.........D
#.#..#..#.#
#.........#
#k........#
##.....#..#
###########
key : 2

3
1
#####D#####
#.......#.#
#.........#
#.#.......#
#.........#
D...#.#...D
#.........#
#...#...#.#
#.........#
#k#.......#
#####D#####
key : 0

5
2
#####D#####
#.........#
##.#.....##
#.........#
#.#.#.#...#
D.........#
#..#......#
#.........#
#.#.#.#...#
#.........#
###########

3
2
#####D#####
#e##......#
#.##......#
#.##......#
#.........#
D..#..##..d
#.p...#e..#
#......#..#
#.........#
#e........#
#####D#####
enemies 3

2
4
#####D#####
#.##......#
#.........#
#.##......#
#.........#
d.........#
#.........#
#.........#
#.........#
#.........#
###########

1
3
###########
#....k....#
#.........#
#.........#
#...#.....#
D..##.....d
#.###.....#
#.........#
#.........#
#.........#
#####D#####
key : 3

1
2
#####l#####
#.........#
#.........#
#.........#
#.........#
D.........D
#.........#
#.......#.#
#......#..#
#.........#
#####D#####

2
3
#####D#####
#.........#
#.........#
#.........#
#.........#
l.........d
#.........#
#.........#
#.........#
#.........#
#####D#####
locked : 1

