1
0
###########
##k#...#.##
#.........#
#.#.#.#.#.#
#.........#
#....#....D
#.........#
#...#.#...#
#.........#
##.#.....##
#####D#####
key : 0

2
2
#####l#####
#.........#
##.#...#.##
#.........#
#..#.#.#..#
D.........d
#..#.#....#
#.........#
##.#...#.##
#.........#
#####D#####

3
1
#####D#####
#.........#
#.........#
#........##
#.........#
#.........D
#.#.......#
#..#......#
##.##.....#
#k........#
###########
key : 1

2
6
###########
#.........#
#.........#
#.......#.#
#.....#.#.#
D...###...#
#......#..#
#...##.##.#
#.........#
#.........#
###########

2
0
#####D#####
#.........#
#.........#
#.........#
#.........#
#....@....D
#.........#
#.........#
#.........#
#?........#
###########
sign Those who search shall find.

2
3
###########
#.........#
#.###.....#
#..###....#
#.##.#....#
d....#....D
#..###....#
#.........#
#.........#
#.........#
#####D#####

3
5
#####D#####
#.........#
#.........#
#.........#
#.........#
D.........#
#.........#
#........?#
#........s#
#.......ee#
###########
enemies 2
switch 1 : 2
sign Something glints behind that door…

3
2
#####D#####
#.........#
#..#......#
#.#.......#
#.........#
D.........D
#.........#
#.......#.#
#......#..#
#......s..#
###########
switch 0 : 0 1

2
1
#####l#####
###......##
#.e#....###
#.##.#?#.##
#.##.###..#
D.........D
#.........#
#.........#
#.........#
#.........#
#####D#####
enemies 1
sign Only the prepared may pass.

1
5
###########
#.........#
#......#..#
#.......#.#
#.........#
D.........#
#.........#
#.#.....#.#
#..#...#..#
#.........#
#####D#####
door 1 : 2

3
3
#####D#####
#e........#
#.........#
#.........#
#.........#
D..#......D
#.#.......#
#.........#
#.........#
#....e....#
###########
enemies 2
door 0 : 0 1

0
4
###########
#?........#
#......#..#
#.......#.#
#.........#
#.........#
#.........#
#.......#.#
#......#..#
#.........#
#####D#####
sign An eerie silence fills the chamber.

1
4
#####D#####
#.........#
#..#...#..#
#k#.....#.#
#.........#
#.........D
#.........#
#.......#.#
#......#..#
#.........#
#####D#####
key : 4

3
4
#####D#####
#.......#.#
#..##..##.#
#...####..#
#...#.##..#
D.........D
#.........#
#.........#
#.........#
#.........#
###########

1
2
#####D#####
###.......#
#..##.....#
##..##....#
#....#....#
D..#.e....#
#.........#
#.........#
#.........#
#.........#
#####l#####
locked : 1
boss
enemies 1

2
5
#####D#####
#k........#
#.........#
#..##.....#
#..##.....#
D..#......D
#.#...p...#
#.........#
#.........#
#.........#
#####D#####
key : 3

0
2
###########
##........#
#X###.....#
#..###....#
#...#.....#
#.....#...#
#......##.#
#.......#.#
#.....##.##
#.........#
#####D#####

1
1
###########
#.........#
#..#......#
#.##......#
#..##.....#
D..##.....D
#.........#
#.........#
#.........#
#.........#
#####l#####
locked : 0

2
4
#####D#####
#.........#
#.........#
#.........#
#.........#
D..##.....D
#.###.....#
##e.#.....#
#e#.#.....#
#.........#
#####D#####
enemies 2

