4
1
#####D#####
#.........#
#.........#
#.........#
#.........#
D.........D
#.........#
#.........#
#.........#
#.........#
#####l#####

2
2
###########
#....k....#
#.........#
#.........#
#.........#
D.........l
#.........#
#.........#
#.........#
#.........#
#####D#####
key : 4

4
3
#####D#####
#.........#
#.........#
#.........#
#.........#
d.........#
#.........#
#.........#
#.........#
#.........#
###########

4
0
#####D#####
#......#..#
#.....#...#
#....#....#
#.........#
#..##@....D
#.........#
#...##....#
#.........#
#.........#
#####D#####

2
4
###########
#........k#
#.........#
#..#..#..##
#.........#
D.........#
#..#..#...#
#.........#
#.........#
#........##
###########
key : 6

3
0
#####D#####
#.........#
#.....#.###
#.....#.###
#....#k#..#
#......#..D
#....####.#
#.........#
#.....#...#
#.........#
#####D#####
key : 0

2
0
#####D#####
#e........#
#.........#
#.........#
#.........#
#e........D
#.........#
#.........#
#.........#
#.........#
#####D#####
enemies 2

3
1
#####D#####
#k........#
##.#...#.##
#.........#
#..#...#..#
D.........D
#..#...#..#
#.........#
#..#...#.##
#.........#
#####D#####
key : 1

1
0
###########
#.........#
#.........#
#.........#
#.........#
#.........#
#.....#...#
#....#....#
#.........#
#..#......#
#####D#####

3
2
#####D#####
#.........#
#..#......#
#.#.......#
#.........#
D.........D
#.........#
#.#.....#.#
#..#...#..#
#.........#
#####d#####

1
3
#####D#####
#.........#
#.........#
#.........#
#.....###.#
#....e##..#
#.....##..#
#.........#
#.........#
#.........#
#####d#####
boss
enemies 1

2
3
#####d#####
#.........#
#.........#
#.#...#...#
#..#..#...#
l..#.#....D
#..###....#
####.##...#
###.......#
#.........#
#####D#####
locked : 1

4
2
#####d#####
#e#.....#.#
#.........#
#...#.#.#.#
#.........#
D.........d
#.........#
#.#...#...#
#.........#
#?#.......#
#####d#####
enemies 1
sign The dungeon remembers all who enter.

5
1
#####l#####
#.........#
#...#..#..#
#.........#
#.........#
D......#..D
#.........#
#.........#
##..#..#..#
#.........#
###########
locked : 0

5
2
#####d#####
#..#......#
#..#......#
#.#...#...#
#.........#
D.........#
#.........#
#.#.......#
#..#......#
#.........#
###########

2
1
###########
#.........#
#.#...#.#.#
#.........#
#..#.#.#..#
D.........D
#...#.#.#.#
#.........#
#......#..#
#.........#
#####D#####

3
3
#####D#####
#.........#
#.........#
#.........#
#.........#
D.........#
#.........#
#.......#.#
#......#..#
#.........#
#####D#####

0
3
###########
#X........#
#.........#
#.p.......#
#.........#
#.........#
#.........#
#.........#
#.........#
#.........#
#####D#####

5
0
#####D#####
#..#......#
#...#.....#
#..#......#
#.........#
#.........D
#.........#
#.........#
#?........#
#e........#
###########
enemies 1
sign A locked path — look elsewhere first.

