3
2
#####D#####
##.....#.e#
#.........#
#.........#
#...#..#..#
D.........D
#.........#
##..#..#..#
#.........#
#e.......s#
#####D#####
enemies 2
switch 0 : 0 1

3
0
#####D#####
#.........#
#.........#
#.........#
#.........#
#k........D
#.........#
#.........#
#.........#
#.........#
#####D#####
key : 0

2
2
###########
#k........#
##.#...#..#
#.........#
#......#..#
D.........D
#..#.#.#..#
#.........#
#..#...#.##
#.........#
#####D#####
key : 2

4
1
#####D#####
#k.....#..#
#.........#
#.........#
#...#..#..#
D.........d
#.........#
##.....#..#
#.........#
#.........#
#####D#####
key : 3

4
0
#####D#####
#.........#
#......#..#
#.........#
#.........#
#k........D
#.........#
#.....#...#
#.........#
#.........#
#####d#####
key : 1

2
1
#####D#####
#.........#
#.........#
#.........#
#.........#
D.........D
#.........#
#.........#
#...#.....#
#.........#
#####l#####

4
2
#####D#####
#.........#
#.........#
#.........#
#.........#
d.........#
#.........#
#.......#.#
#......#..#
#.........#
#####D#####

5
2
#####D#####
#.........#
#.........#
#.........#
#.........#
D.........#
#.####....#
#.##e..#..#
#...#....?#
#.......ee#
###########
enemies 3
door 0 : 0 1
sign The dungeon remembers all who enter.

3
3
#####D#####
#.........#
#.........#
#.........#
#...p.....#
D.........#
#......p..#
#.........#
#.........#
#........e#
###########
enemies 1
door 1 : 2

1
0
#####D#####
#.........#
####......#
###.......#
#.#.......#
#.........d
#.........#
#.........#
#.p.......#
#.........#
#####D#####

6
1
#####d#####
#.........#
#.........#
#.........#
#...e#.#..#
#....#....#
#..##.##..#
#......#..#
#..##..#..#
#.........#
#####D#####
boss
enemies 1

3
1
#####l#####
#..#....#.#
#.#...#...#
#..####...#
#.........#
D..##.#...D
#.......#.#
#.........#
#.........#
#.........#
#####D#####
locked : 1

2
3
###########
#.#....e#e#
#.......?s#
#...#.#...#
#.........#
D...#.#...#
#.........#
#...#...#.#
#.........#
#.......#.#
#####D#####
enemies 2
switch 1 : 2
sign Those who search shall find.

1
1
###########
#.........#
#.........#
#.........#
#.........#
d.........#
#.........#
#.#.....#.#
#..#...##.#
#.........#
#####D#####

0
0
###########
#.........#
#.........#
#.........#
#.........#
#...#.#...#
#.........#
#.#.##....#
#.#.#.....#
#p##......#
#####D#####

5
1
#####D#####
#.........#
#.#.....#.#
#.........#
#.........#
D....#....D
#.........#
#.........#
#.#.....#.#
#.........#
#####d#####

5
0
#####d#####
#.........#
#.........#
#.........#
#..#...##.#
#..#..##..D
#....#.##.#
#......#.##
#...p..#..#
#.........#
###########

7
1
#####D#####
#.........#
#.........#
#....#.#..#
#....#.#..#
#......#..#
#.........#
#.........#
#.........#
#X........#
###########

2
0
#####D#####
#.........#
#.........#
####..#...#
#?##....#.#
#....@....D
#.........#
#.........#
#.........#
#.........#
#####D#####
sign The brave are rewarded.

