2
3
#####D#####
#......#.##
#.....##..#
#....####.#
#.p..###..#
D.........D
#.........#
#..p......#
#.........#
#.........#
#####D#####

2
1
#####D#####
###.......#
#.###.....#
#.###.#...#
#..#.#....#
D....#....d
#.........#
#.........#
#..#......#
#.........#
###########

0
2
###########
#k........#
#.........#
#.........#
#.........#
#.........D
#.........#
#.........#
#.........#
#.........#
#####D#####
key : 5

2
4
###########
#......pee#
#.........#
#.........#
#..#......#
D....#....#
#.##.#.#..#
#....#.#.##
#.....#...#
#.......###
#####D#####
enemies 2

3
4
#####D#####
#.........#
#.........#
#.........#
#.........#
D.........#
#.........#
#.........#
#.........#
#........X#
###########

0
0
###########
##.#...#.##
#.........#
#.#.#.#.#.#
#.........#
#..#.#.#..#
#.........#
#...#.#...#
#.........#
##.#...#.##
#####D#####

4
3
#####D#####
#..#......#
#.##......#
#.##......#
#..###....#
D....#....#
#...##....#
#.........#
#p.......e#
#.......ee#
###########
enemies 3
door 0 : 0

2
0
#####D#####
#.........#
#...#.....#
#..###....#
#.........#
#?...@....D
#.........#
#.........#
#.p.......#
#.........#
#####D#####
sign Many have walked this path.

3
2
#####d#####
#.........#
#.........#
#.........#
#.###.....#
#..#......d
#.##......#
#.........#
#.........#
#.........#
#####D#####

1
0
#####D#####
#.......#.#
#.....###.#
#.....##..#
#.........#
#.........D
#.........#
#.........#
#.........#
#.........#
#####D#####

1
1
###########
#e..ees?..#
#.........#
##.....#..#
#.........#
D.........D
#...#.....#
#.........#
#.........#
##.....#..#
#####D#####
enemies 3
switch 0 : 0
sign Beware what lurks ahead.

0
4
###########
#.#......k#
#.........#
#.........#
#..#..#...#
D.........#
#.........#
#.#..#..#.#
#.........#
#.........#
###########
key : 10

2
2
#####d#####
#.........#
#.........#
#..#..#..##
#.........#
d.........D
#.....#...#
#.........#
#.........#
#.........#
#####d#####

1
2
#####D#####
#......####
#...#.#...#
#..###..#.#
#...#####.#
D.........D
#.....#...#
#.#.......#
#.........#
#.........#
#####d#####

3
0
#####D#####
##........#
#.........#
#.........#
#.........#
#...#.....#
#.........#
#.##......#
#.........#
#.##......#
###########

4
2
#####D#####
#.........#
#..##.....#
#...##....#
#..#......#
#.........D
#.........#
#..#......#
#.........#
#k........#
###########
key : 2

3
3
#####D#####
#.........#
#.........#
#..##.....#
#.###.....#
d....e....D
#..##.....#
#...#.....#
#.........#
#.........#
#####D#####
boss
enemies 1

1
3
#####D#####
#.........#
#.........#
#..#......#
#.........#
D........k#
#.........#
##........#
#.........#
#.........#
#####D#####
key : 4

0
3
###########
#e...e....#
#.........#
#..#..#..##
#.........#
D.........D
#...#..#..#
#.........#
#.........#
#e........#
#####D#####
enemies 3

