2
3
#####.#####
#.........#
#.....#...#
#.........#
#.........#
d.........#
#.........#
#.......#.#
##.....#..#
#.........#
###########

5
1
#####.#####
#.........#
#.........#
#.........#
#.........#
..........#
#.........#
#.#.....#k#
#..#...#..#
#.........#
#####.#####
key : 0

6
1
#####.#####
#.........#
#.........#
#...#...#.#
#.........#
....#.#...#
#.........#
#...#.#.#.#
#.........#
#.#......k#
###########
key : 3

2
2
#####l#####
#.........#
#......#..#
#.......#.#
#.........#
..........d
#.........#
#.........#
#.........#
#.........#
#####d#####

3
2
#####d#####
#.........#
#..#......#
#.#.......#
#.........#
..........#
#.........#
#.#.......#
#..#......#
#.........#
###########

7
0
#####.#####
#.........#
#.........#
#.........#
#.........#
#.........#
#.........#
#.........#
#.........#
#.........#
###########

3
1
#####.#####
#k........#
#.#.#.#.#.#
#.........#
#.#.....#.#
...........
#.#...#.#.#
#.........#
#.#...#.#.#
#.........#
#####.#####
key : 4

2
1
#####.#####
#k........#
#.........#
#.........#
#.........#
...#.......
#.........#
#..#......#
#.........#
#.........#
#####.#####
key : 7

3
0
#####d#####
#.........#
#.#.#...#.#
#.........#
#....#.#..#
#..........
#.#.....#.#
#.........#
#..#...#..#
#.........#
#####.#####

1
0
###########
##.#...#..#
#e........#
##.#.#.#.##
#.........#
#..#.#.#...
#.........#
##.#.#.#..#
#.........#
##.....#.##
#####.#####
enemies 1

1
2
###########
#.........#
#.#.....#.#
#.........#
#.........#
...#......d
#.........#
#.........#
#.......#.#
#.........#
#####l#####
locked : 7

1
1
###########
#.........#
#.........#
#.........#
#.........#
...........
#.........#
#.#.......#
#..#......#
#.........#
#####.#####

6
0
#####.#####
#?........#
##........#
#.........#
#....#....#
#..##@#....
#..##.....#
##.##.#...#
##........#
#.........#
#####.#####
sign What you seek is close.

1
3
#####.#####
#.........#
#.........#
#..###....#
#.#.#.....#
d...#e#...#
#.##.##...#
####..#...#
#.........#
#.........#
#####.#####
boss
enemies 1

5
0
#####.#####
#.#.......#
#.....#...#
##........#
#.........#
#..........
#.........#
#.......#.#
#......#..#
#.........#
#####.#####

4
0
#####.#####
#.........#
#.........#
#.........#
#e#...#...#
#..?#.....l
#..##.....#
#..##.#...#
#..##.....#
#.........#
#####.#####
enemies 1
sign Turn back; you are not yet ready.

0
3
###########
#X........#
#.........#
#.........#
#.........#
#.........#
#.........#
#.........#
#.........#
#.........#
#####.#####

2
0
#####.#####
#.........#
#.........#
#.........#
#.........#
#..........
#.........#
#.........#
#.........#
#.........#
#####d#####

4
1
#####.#####
#........##
#.....#.###
#.....#.###
#....##.#.#
l......#..#
#.....###.#
#.........#
#.........#
#.........#
#####.#####
locked : 0

