0
4
###########
#........X#
#.........#
#.........#
#....p#...#
D....#....#
#.....#...#
#....######
#......#.##
#.........#
#####D#####

2
1
#####D#####
#.........#
#.#....#..#
##......#.#
#.........#
D.........D
#.........#
#.......#.#
#......#..#
#.........#
#####l#####

0
1
###########
#k........#
##.##.#...#
##..#.....#
#..#..#...#
D.........D
#.........#
#.........#
#.........#
#.........#
#####D#####
key : 2

3
0
#####D#####
#.........#
#.#.#.#...#
#.#.......#
#.###.#...#
#.........D
#.........#
#.........#
#.........#
#.........#
###########

1
3
#####D#####
####......#
#####.....#
#..#......#
#..#......#
#.........d
#.........#
#.........#
#.........#
#.........#
#####D#####

3
2
#####D#####
#.........#
#.#.#.#.#.#
#...##.##.#
#....#.##.#
l.........D
#...#.#...#
#.........#
#.........#
#.........#
###########
locked : 1

0
3
###########
#?...e....#
#.........#
#.........#
#.#e#.....#
D..##.....D
#...#.....#
#.........#
#.........#
#.........#
#####D#####
enemies 2
sign Beware what lurks ahead.

0
2
###########
#.........#
#.........#
#.........#
#.........#
D.........D
#.........#
#.........#
#.........#
#.........#
###########

1
4
#####D#####
#.........#
#........p#
#..#.##...#
#..######.#
d...e#....#
#...###.#.#
#.....##..#
#.........#
#..p......#
#####D#####
boss
enemies 1

0
0
###########
#.........#
#.........#
#.........#
#.........#
#.........D
#....p....#
#.........#
#.........#
#.........#
#####D#####

2
3
#####D#####
#.........#
#.........#
#.........#
#.........#
d.........l
#.........#
#.......#.#
#......#..#
#.........#
#####D#####

1
0
#####D#####
#.........#
#.........#
##..#..#..#
#k........#
#.........d
#.#..#..#.#
#.........#
#.........#
##.....#..#
#####D#####
key : 0

2
4
#####D#####
#.........#
#..#......#
#.#.......#
#.........#
l.........d
#.........#
#.#.......#
#..#......#
#.........#
###########
locked : 2

3
3
#####D#####
#.........#
#..#......#
#.#.......#
#.........#
D.........#
#.........#
#.#.......#
#..#......#
#........k#
###########
key : 4

1
1
#####D#####
#.........#
#.........#
#.........#
#.........#
d.........#
#.........#
#.#.......#
#..#......#
#.........#
#####D#####

2
2
###########
#.........#
#...#.....#
#..#k##...#
#....#....#
D..###....d
#.........#
#.........#
#.........#
#.........#
#####D#####
key : 1

3
1
#####l#####
#.........#
#.........#
#.........#
#.........#
D.........l
#.........#
#.#.....#.#
#..#...##.#
#.........#
###########
locked : 0

2
5
###########
#.#.....#.#
#.........#
#..#.#.#.##
#.........#
d...#.#...#
#.........#
#..#.#.#.##
#.........#
#.......#.#
###########

2
0
#####D#####
#.........#
#...p.....#
#.........#
#.........#
#....@....D
#.........#
#.........#
#.........#
#.........#
#####D#####

