2
2
#####.#####
#.........#
#.........#
#.........#
#.........#
d.........#
#.........#
#.........#
#.........#
#.........#
#####.#####

2
0
###########
#e.s......#
#?.#..#..##
#.........#
#.........#
#...#......
#.........#
#.........#
#..#..#..##
#.........#
#####.#####
enemies 1
switch 0 : 0 1
sign Beware what lurks ahead.

5
1
#####.#####
#k........#
#.........#
#.........#
#.........#
...........
#.........#
#.#.......#
#..#......#
#.........#
#####d#####
key : 1

6
1
#####d#####
#.........#
#..#......#
#.#.......#
#.........#
#..........
#.........#
#.........#
#.........#
#.........#
###########

6
2
#####.#####
#.........#
#.........#
#.........#
#.........#
..........#
#.........#
#.........#
#.........#
#.......ee#
###########
enemies 2
door 0 : 0 1

3
0
#####.#####
#.........#
#.........#
#.........#
#.........#
#?...@.....
#.........#
#.........#
#.........#
#.........#
#####.#####
sign Seek the matching key before you proceed.

1
2
###########
#.........#
#.........#
#.........#
#.........#
d.........#
#.........#
#.#.......#
#..#......#
#.........#
#####.#####

2
1
#####.#####
#..#......#
#.........#
#...#.....#
#.#.......#
..........d
#.........#
#.........#
#.........#
#.........#
#####l#####

3
3
###########
#.........#
#......##.#
#...##.#..#
#...###.#.#
l....e....#
#.........#
#.........#
#.........#
#.........#
#####.#####
locked : 1
boss
enemies 1

4
1
#####.#####
#.........#
#...#.....#
#.........#
#.........#
...........
#..#......#
#.......#.#
#......#..#
#.........#
#####.#####

4
3
#####.#####
#.........#
#.....#...#
#......##.#
#.......#.#
..........#
#.........#
#.........#
#.........#
#........X#
###########

4
0
#####.#####
#e.#.....##
#.........#
#.........#
#?..#..#..#
#e.........
#.........#
#.....#..##
#.........#
#.........#
#####.#####
enemies 2
sign Many have walked this path.

3
2
#####.#####
#.........#
#...#.....#
#.........#
#.........#
d.........l
#.........#
#.........#
#.........#
#.........#
#####.#####

0
1
###########
#.........#
#..#......#
#.#.......#
#.........#
#.........#
#.........#
#.#.......#
#..#......#
#.........#
#####.#####

3
1
#####l#####
####......#
#..#......#
#.##......#
#..#......#
.....#....d
#.#.......#
#.........#
#.........#
#.........#
#####.#####
locked : 0

5
0
#####.#####
#.........#
#..#..#..##
#.........#
#.........#
#..#..#....
#.........#
#.........#
#..#..#..##
#.........#
###########

1
1
#####.#####
#.........#
#...#.....#
#......#..#
#.........#
#k........d
#.........#
#.........#
#.........#
#.........#
#####.#####
key : 0

4
2
#####.#####
#........k#
#..#..#..##
#.........#
#.........#
...#.......
#.........#
#.........#
#..#..#..##
#.........#
#####.#####
key : 3

5
2
#####.#####
#.........#
#.........#
#....#....#
#.........#
.........k#
#..#......#
#...#.....#
#.........#
#.........#
#####.#####
key : 6

