5
0
#####.#####
#.........#
#.........#
#.........#
#.##@.....#
#..###.....
#..##.....#
#...##....#
#####.....#
#.........#
#####.#####

3
2
#####.#####
#.........#
#..##.....#
#.####....#
#.#.##....#
d...#.....d
#.........#
#.........#
#.........#
#.........#
#####.#####

7
1
#####.#####
#.........#
#.....#...#
#.........#
#.........#
#......#..#
#.........#
#.#.......#
#..#...#..#
#k........#
###########
key : 3

6
0
#####.#####
#.##......#
#.#.......#
#....##...#
#.#####...#
#..........
#.........#
#...#.....#
#.........#
#k........#
###########
key : 0

2
2
#####l#####
#.........#
#.........#
##..#.....#
#.........#
..........l
#......#..#
#.........#
#.........#
#......#..#
#####.#####

4
2
#####.#####
#.........#
#.........#
#.........#
#.........#
..........#
#.........#
#.......#.#
#......#..#
#.........#
###########

3
3
#####.#####
#.........#
#.........#
#.........#
#.........#
d.........#
#.........#
#.........#
#.........#
#.........#
###########

2
3
#####d#####
#.........#
#.........#
#.........#
#.........#
l.........#
#.........#
#.#.....#.#
#..#...#..#
#.........#
#####.#####
locked : 0

0
3
###########
#X##......#
#...#.....#
#.##......#
#.#...#...#
#.........#
#.........#
#.........#
#.........#
#.........#
#####.#####

1
2
###########
#.........#
#.........#
#.........#
#.........#
#..........
#.........#
#.........#
#.........#
#.........#
#####l#####
locked : 1

3
0
###########
#.........#
#.........#
#.#.......#
#.........#
#..........
#..#..#...#
#.........#
#.........#
#.#.....#.#
#####.#####

2
1
###########
#.........#
#......#..#
#.......#.#
#.........#
#..........
#.........#
#.........#
#.........#
#.........#
#####d#####

5
1
#####.#####
#......#..#
#......#..#
#.......#k#
#.........#
......#...#
#.........#
#.#.......#
#..#......#
#.........#
#####.#####
key : 7

6
1
#####.#####
##e#...#..#
#e........#
##.#.#.#..#
#.........#
.....#.....
#.........#
##.#...#.##
#e........#
##.#.....##
#####.#####
enemies 3

1
3
#####.#####
#.........#
#.........#
#.........#
#.........#
.....e....#
#.........#
#.........#
#.........#
#.........#
#####d#####
boss
enemies 1

4
0
#####.#####
#e........#
#......##.#
#......#..#
#?........#
#e.........
#.........#
#.......#.#
#.........#
#.........#
#####.#####
enemies 2
sign What you seek is close.

4
1
#####.#####
#.......#k#
#.........#
#.#.#.#.#.#
#.........#
...........
#.........#
#.#.#.#.#.#
#.........#
#.......#.#
#####.#####
key : 1

6
2
###########
#.........#
#.#...#.#.#
#.........#
#.#.#.#.#.#
..........#
#.#.#.#...#
#.........#
#.#.....#.#
#.........#
###########

3
1
#####d#####
#e.#.....##
#.........#
#.........#
#...#..#..#
..........d
#.........#
#..#..#..##
#.........#
#e.......e#
#####.#####
enemies 3

