3
2
#####d#####
#.........#
#.........#
#..#..#..##
#.........#
d..........
#..#......#
#.........#
#.........#
#..#.....##
#####d#####

1
0
#####.#####
#.........#
#..#......#
#k#.......#
#.........#
#.........#
#.........#
#.#.....#.#
#..#...#..#
#.........#
#####.#####
key : 1

4
3
#####.#####
#.#.....#.#
#.........#
#.#.#...#.#
#.........#
....#.#...#
#.........#
#.#.#.#...#
#.........#
#.......#.#
#####.#####

2
1
###########
#.........#
##.#...#.##
#.........#
#.....#.#.#
...........
#..#...#..#
#.........#
#.#...#.#.#
#.........#
#####.#####

7
2
#####.#####
#......#..#
#...#.....#
#.#..####.#
#....#.#..#
#.........#
#.........#
#.........#
#.........#
#X........#
###########

2
0
#####.#####
##........#
#.........#
#.....#...#
#.........#
#..........
#.........#
#.........#
#.........#
#.........#
#####.#####

3
1
#####.#####
#.........#
#......#..#
#.......#.#
#....#....#
..........d
#.........#
#.###...#.#
#..#...#..#
#.........#
#####.#####

3
3
###########
#........k#
#..#......#
#.#.......#
#.........#
..........#
#.........#
#.......#.#
#......#..#
#.........#
#####.#####
key : 2

4
1
#####.#####
#k#.....#.#
#.........#
#.#.#...#.#
#.........#
....#......
#.........#
#.#...#.#.#
#.........#
#.#.....#.#
#####l#####
key : 0

4
0
#####.#####
#.........#
#..#.....##
#.........#
#.........#
#...#..#...
#.........#
#.........#
#?.......##
#e........#
###########
enemies 1
sign Something glints behind that door…

4
2
#####d#####
#........##
#......##.#
#....##.#.#
#....#..#.#
.....##....
#...#.....#
#....##...#
#.........#
#.........#
#####.#####

5
1
#####l#####
#.........#
#.........#
##.....#..#
#.........#
#..........
#.#.....#.#
#.........#
#.........#
##.....#..#
###########
locked : 2

2
2
###########
#.#.....#.#
#.........#
#..#.#.#..#
#.........#
....#.#...#
#.........#
#..#.#....#
#.........#
#.........#
#####d#####

3
0
#####.#####
#..#......#
##.##.....#
#.........#
#..#.#....#
#....@.....
#.........#
#.........#
#.........#
#.........#
#####.#####

5
3
#####.#####
#......#..#
#.........#
#..#...#.##
#.........#
...#.......
#.........#
##.#.#.#..#
#.........#
#..#...#e##
###########
enemies 1
door 0 : 0

0
0
###########
#s........#
#e##......#
######....#
#?###.....#
#..##.....#
#...#.....#
#.........#
#.........#
#.........#
#####.#####
enemies 1
switch 0 : 0
sign The brave are rewarded.

6
2
#####d#####
#.........#
#.........#
#.........#
#.........#
#....e....#
#.........#
#.........#
#.........#
#.........#
#####.#####
boss
enemies 1

5
2
#####.#####
#.......###
#........k#
#....##..##
#.#..##.#.#
...#.......
#.##......#
#.........#
#.........#
#.........#
#####d#####
key : 3

5
4
###########
#........e#
##.#......#
###.......#
#..#.###..#
.....#....#
#....###..#
#.....#...#
#...#..#..#
#.........#
###########
enemies 1

