3
2
#####l#####
#.........#
#.........#
#..#......#
#...#.....#
#..........
#.........#
#.........#
#.........#
#.........#
#####.#####
locked : 0

1
0
###########
###?......#
#####.##..#
####..#...#
#..#...#..#
#..##@.....
#.........#
#.........#
#.........#
##........#
###########
sign The brave are rewarded.

4
3
#####d#####
#.........#
#......#..#
#.........#
#.........#
....#......
#.........#
#.........#
#.........#
#.........#
#####l#####

3
4
#####.#####
#......#..#
#.........#
#.........#
#.........#
l.........#
#..#......#
#.........#
#.........#
#.........#
#####.#####
locked : 3

2
3
#####.#####
#.........#
#.........#
#..#.#....#
#..##.....#
....##....d
#.........#
####......#
#..#......#
#.........#
#####.#####

0
1
###########
#.........#
#..#......#
#.#.......#
#.........#
#.........#
#.........#
#.......#.#
#......#..#
#.........#
#####.#####

2
2
#####.#####
#.........#
#...#..#..#
#.......#.#
#.....#...#
d..........
#.........#
#.......#.#
#......#..#
#.........#
#####l#####

6
3
#####.#####
#.........#
#.........#
#.........#
#.........#
#......#..#
#.........#
#......#..#
#.........#
#X........#
###########

2
1
#####.#####
#.........#
#.........#
#.........#
#......#..#
#.........d
#.........#
#.##....#.#
#..#...#..#
#.........#
###########

4
2
#####.#####
#.........#
#.........#
#.........#
#.........#
#..........
#.........#
#.........#
#e........#
#ee.......#
###########
enemies 3

1
3
###########
#.........#
#..#......#
#.#.......#
#.........#
...........
#.........#
#.........#
#.........#
#.........#
#####.#####

1
1
#####.#####
#.........#
#.........#
#.#..#..#.#
#.........#
...........
#....#....#
#.........#
#.........#
#k#.....#.#
#####.#####
key : 0

4
4
#####.#####
#.........#
#.........#
#.#..#..#.#
#.........#
..........#
#.......#.#
#.........#
#.........#
#.#.....#k#
###########
key : 4

5
3
#####l#####
#.........#
#.........#
#...#.#...#
#...e####.#
#....##...#
#..####...#
#.#.#..##.#
#.........#
#.........#
#####.#####
locked : 4
boss
enemies 1

2
5
###########
#.........#
#.........#
#.........#
#.........#
l.........#
#.........#
#.......#.#
#......#..#
#.........#
###########
locked : 1

3
3
#####.#####
#k........#
#.#.....#.#
#.........#
#.........#
...#..#...l
#.........#
#.........#
#.#.....#.#
#.........#
#####d#####
key : 3

2
4
#####d#####
#......#..#
#...#.....#
#..##.....#
#.....#...#
d..##.....l
#...#.....#
#..#.#....#
#..#......#
#.........#
#####.#####

1
4
###########
#.........#
#.....#####
#...#.##..#
#...###.#.#
......#...#
#..#####..#
#....###..#
#.....##..#
#.........#
#####d#####

1
2
###########
#.........#
#.........#
#.........#
#.........#
....#......
#.#..#....#
#.####....#
#.###.....#
#k##......#
#####.#####
key : 1

