1
0
#####.#####
#.......#.#
##........#
##.#......#
#..#......#
#..#.@.#...
#....#.#..#
#.....#...#
#.........#
#.........#
#####.#####

5
3
#####.#####
#.........#
#..#.....##
#.........#
#.........#
#.....#...#
#.........#
#........?#
#..#..#..##
#e.e.....e#
###########
enemies 3
sign Something glints behind that door…

3
1
#####.#####
#.........#
#.........#
#....#....#
#...#.....#
...........
#.........#
#.........#
#.........#
#.........#
#####.#####

4
4
#####.#####
#.........#
#......##.#
#.......#.#
#.....###.#
..........#
#.........#
#.........#
#.........#
#.......ee#
###########
enemies 2
door 0 : 0

1
1
###########
#.........#
#.........#
#..#..#..##
#.........#
..........#
#..#......#
#.........#
#.........#
#..#.....##
#####l#####
locked : 2

3
4
###########
#.........#
#.........#
#.........#
#.........#
..........#
#.........#
#.#.......#
#..#......#
#.........#
#####.#####

2
0
#####.#####
#k#.....#.#
#.........#
#.........#
#.#..#..#.#
#.........l
#.........#
#....#..#.#
#.........#
#.........#
#####.#####
key : 0

3
0
#####.#####
#.........#
#.#.....#.#
#.........#
#.........#
#....#.....
#.........#
#.........#
#.......#.#
#k........#
###########
key : 2

2
3
#####.#####
#.........#
#.........#
#.........#
#.........#
....#e....#
#.........#
#...#.....#
#.###.....#
##........#
#####l#####
locked : 4
boss
enemies 1

4
1
#####.#####
#e........#
##.#...#..#
#?........#
#s#.#.#.#.#
#..........
#..#.#.#..#
#.........#
#.#.#.#.#.#
#.........#
#####d#####
enemies 1
switch 0 : 0
sign The dungeon remembers all who enter.

4
2
#####d#####
#.........#
#.........#
#.........#
#.........#
...........
#.........#
#.#.......#
#..#......#
#.........#
###########

3
3
#####l#####
#.........#
#..#...#..#
#.#.#...###
#.........#
...........
#.........#
#.#.......#
#..#..#...#
#.........#
#####.#####

5
1
#####d#####
#.........#
#......#..#
#.......#.#
#.........#
#..#......#
#.........#
#.........#
#.....#...#
#.........#
###########

2
2
###########
#.........#
#.........#
#.........#
#.........#
...........
#.........#
#.........#
#.........#
#.........#
#####d#####

3
2
#####d#####
#.........#
#.........#
#.........#
#.........#
...........
#.........#
#.........#
#.........#
#.........#
#####d#####

1
3
###########
#X........#
#.........#
#.........#
#.........#
#....#.#..#
#.....###.#
#....#.##.#
#......#..#
#......##.#
#####.#####

2
1
#####l#####
#.........#
#...#.....#
#...#.#...#
#.....##..#
l..#.##....
#.........#
#.........#
#........##
#.........#
#####.#####
locked : 0

0
0
###########
#k........#
#.........#
#.........#
#.........#
#.........#
#.........#
#.#...#...#
#..#......#
#.........#
#####.#####
key : 1

4
3
#####.#####
#.........#
#.........#
#....#....#
#....k#...#
....###....
#.........#
#.........#
#.........#
#.........#
#####.#####
key : 4

