5
0
#####.#####
#?........#
##........#
#.........#
#..#......#
#....@.....
#.........#
#.........#
#.........#
#.........#
#####.#####
sign Those who search shall find.

2
1
#####d#####
#.........#
#..#...#..#
#.#.....#.#
#.........#
l..........
#.........#
#.#.......#
#..#......#
#.........#
#####.#####
locked : 3

2
2
###########
#..#...#.##
#.........#
##.......##
#.........#
...#...#..#
#.........#
##.#.#.#.##
#.........#
##.#...#.##
###########

3
0
#####d#####
#.........#
#..#......#
#.#.......#
#.........#
#..........
#.........#
#.#.......#
#..#......#
#.........#
#####.#####

9
0
#####.#####
#.........#
#.........#
#.........#
#.........#
#.........#
#.........#
#.......#.#
#......#..#
#.........#
###########

2
0
#####d#####
#.......#.#
#.........#
#..#.#.#.##
#.........#
#.....#...l
#.........#
#..#.#.#..#
#.........#
#.......#.#
#####d#####

1
1
#####.#####
#.........#
#...#.....#
##..##....#
#...#..#..#
....e###..#
#....#.#..#
#....#...##
#.....#...#
#.........#
#####d#####
boss
enemies 1

1
0
###########
#.........#
#.........#
#.........#
#.........#
#....#.....
#...#.#...#
#.....##..#
#.......#.#
#......#..#
#####d#####

0
1
###########
###X......#
#####.#...#
##..##....#
#.#.##....#
#...##....#
#...##....#
#.........#
#.....#...#
#.........#
#####.#####

8
1
###########
##.#...#.##
#.........#
#.#.#.#.#.#
#.........#
l....#.#..#
#.........#
#.#.#.#...#
#.........#
##.#...#..#
###########
locked : 1

4
1
#####.#####
#k........#
#.........#
#.....#..##
#.........#
...........
#...#.....#
#.........#
#.........#
#..#......#
#####.#####
key : 1

6
0
#####.#####
#..#......#
#.##..##..#
#.#.......#
#..####...#
#.........#
#.........#
#.........#
#.........#
#.........#
#####d#####

5
2
#####.#####
#.........#
#.........#
#.........#
#.........#
....#.....#
#.#.......#
#.#.......#
####......#
#........k#
###########
key : 2

4
2
###########
#........k#
#.........#
#.........#
#.........#
..........#
#.........#
#.........#
#.........#
#.........#
#####.#####
key : 3

5
1
#####.#####
#.........#
#.........#
#.........#
#.........#
...........
#.........#
#.........#
#.........#
#..#......#
###########

8
0
#####.#####
#..#......#
#.........#
#.........#
#...#..#..#
#.........l
#.........#
#..#......#
#.........#
#.........#
#####.#####

3
1
#####.#####
#?........#
#...#..#..#
#.........#
#.........#
.....#...e#
#.........#
#.........#
##..#..#..#
#e........#
#####.#####
enemies 2
sign Turn back; you are not yet ready.

4
0
#####.#####
##.#...#..#
#.........#
#...#.#.#.#
#.........#
#..#.#.#...
#.........#
#k#.#.#.#.#
#.........#
##.#.....##
#####.#####
key : 0

7
0
#####d#####
#.........#
##.##.....#
#.##......#
#.........#
#.........#
#.........#
#.........#
#.........#
#.........#
#####.#####

