3
0
#####.#####
#.........#
#.........#
#.........#
#......#..#
#..#.@.....
#?##..#...#
#.#.......#
#.........#
#.........#
#####.#####
sign Something glints behind that door…

3
2
#####.#####
#k........#
#.#.....#.#
#.........#
#.........#
.....#.....
#.........#
#.........#
#.......#.#
#.........#
#####.#####
key : 1

2
3
#####l#####
#.........#
#...#...#.#
#.........#
#.#.#.#...#
..........l
#.#.#.#.#.#
#.........#
#...#.....#
#.........#
#####d#####

3
4
#####.#####
##.....#..#
#.........#
#....#.#.##
#.........#
d..#.#.#..#
#.........#
##.#.#.#.##
#.........#
#..#......#
###########

2
2
###########
#.........#
#.........#
#.........#
#.........#
...........
#.........#
#.........#
#.........#
#.........#
#####.#####

4
0
#####.#####
#.........#
#......#..#
#.......#.#
#.........#
#...#......
#.........#
#.......#.#
#......#..#
#.........#
###########

2
0
###########
#k##......#
#.........#
#.#.#.....#
#.........#
#..........
#.........#
#.........#
#.........#
#.........#
#####.#####
key : 0

4
1
#####.#####
#.........#
#.........#
#....##.###
#...##.##.#
...##..#..d
#.#.#..#..#
##.....####
#####.....#
#.........#
#####.#####

3
3
#####d#####
#.........#
#.........#
#....#..#.#
#.........#
..........d
#..#..#...#
#.........#
#.........#
#.#.......#
#####.#####

5
2
#####.#####
#.........#
#.........#
#.........#
#.........#
..........#
#.........#
#.#.....#.#
#..#...#..#
#........k#
###########
key : 4

1
4
#####.#####
#.........#
#..##.....#
#...#.....#
#..#e.....#
d..###....#
#.##.#....#
###.......#
##..#.....#
#.........#
#####.#####
boss
enemies 1

3
1
#####.#####
#e........#
#.........#
#.........#
#.........#
.....###...
#.....e#..#
#.....##..#
#.........#
#?........#
#####.#####
enemies 2
sign Those who search shall find.

4
2
#####.#####
#.........#
#..#...#..#
#.#.....#.#
#.........#
d.........l
#.........#
#.........#
#.........#
#.........#
#####.#####

5
1
#####.#####
#.........#
#.....#..##
#.........#
#.........#
#...#..#...
#.........#
#.........#
#........##
#.........#
###########

4
3
#####.#####
#.........#
##.....#.##
#.........#
#..#.#....#
l.........#
#..#...#..#
#.........#
##.#...#.##
#.........#
###########
locked : 2

2
4
#####.#####
#.........#
#.........#
#.........#
#.........#
l.........#
#.#.......#
#.........#
#.........#
#.........#
#####.#####
locked : 4

2
1
###########
##....k#..#
#.........#
#.........#
#...#.....#
...........
#.........#
#...#..#..#
#.........#
#.........#
#####.#####
key : 2

1
3
###########
#..#......#
#...#.#####
#...#..#..#
#....#....#
#.....#...d
#.....###.#
#.........#
#.........#
#.........#
#####l#####
locked : 0

0
4
###########
#......#X.#
#.....#.#.#
#..##.....#
#..##.#...#
#.........#
#..#.##...#
#...#...#.#
#.........#
#.........#
#####.#####

