4
0
#####D#####
#k#.....#.#
#.........#
#.........#
#.....#...#
#.........D
#.........#
#.#.......#
#.........#
#.........#
#####d#####
key : 0

5
0
#####d#####
#..#......#
#.........#
#.........#
#...#..#..#
#.........D
#.........#
#..#.....##
#.........#
#.........#
#####d#####

5
2
#####D#####
#.........#
#.........#
#.........#
#.........#
D.........#
#.........#
#.....#...#
#.........#
#........e#
###########
enemies 1
door 0 : 0

3
2
#####d#####
#.##......#
#..#......#
##.##.....#
#.........#
D..#......D
#.........#
#.........#
#.........#
#.........#
#####D#####

1
0
###########
#k........#
##..#..#..#
#.........#
#.........#
#.........#
#.........#
#.........#
##..#..#..#
#.........#
#####D#####
key : 1

2
3
#####d#####
#k........#
##.#...#.##
#.........#
#...#.#.#.#
D.........#
#..#.#.#..#
#.........#
#.#.#.#.#.#
#.........#
#####D#####
key : 5

1
3
#####D#####
#.........#
##.#......#
###.......#
#..#......#
D...#e....#
#..##.....#
#.........#
#.........#
#.........#
#####d#####
boss
enemies 1

4
1
#####D#####
#.........#
#...#.#.#.#
#.........#
#..#...#..#
D.........D
#.....#.#.#
#.........#
#..#.....##
#........k#
#####D#####
key : 2

3
1
#####D#####
#.........#
#..#......#
#.#.......#
#.........#
D.........D
#.........#
#.......#.#
#......#..#
#.........#
#####D#####

2
0
#####D#####
#..#...#..#
#.........#
#......#..#
#...##?#..#
#..##e##..l
#.........#
#.........#
#.........#
#........##
#####D#####
enemies 1
sign Turn back; you are not yet ready.

1
2
###########
#.........#
#.........#
#.........#
#.#.......#
#....#....D
#.........#
#.#.....#.#
#..#...#..#
##........#
#####D#####

2
1
###########
#.........#
#.........#
#.........#
#.........#
l.........D
#.........#
#.........#
#.........#
#.........#
#####D#####
locked : 0

2
2
#####D#####
#..#.....##
#..#..#...#
#...##..###
#.#####.#.#
D....#....D
#.........#
#.........#
#.........#
#.........#
#####d#####

4
2
#####D#####
#e........#
##.#...#.##
#.........#
#..#.#....#
D.........#
#..#.#.#..#
#.........#
##.#...#.##
#s........#
#####D#####
enemies 1
switch 0 : 0

0
3
###########
#X........#
#.........#
#.........#
#.........#
#.........#
#.........#
#.........#
#.........#
#.........#
#####D#####

3
0
#####D#####
#.........#
#.#.#.#...#
#..###....#
#...@#p...#
#...###...D
#...##....#
#.........#
#..p......#
#.........#
#####D#####

3
3
#####D#####
#.........#
#.........#
#....###..#
#......#..#
D.....#...#
#........e#
#.......pp#
#........e#
#........e#
###########
enemies 3

6
0
#####d#####
#.........#
#......#..#
#.......#.#
#.........#
#.........#
#.........#
#.#.......#
#..#......#
#.........#
###########

5
1
#####D#####
#.........#
##.....#.##
#.........#
#.#...#.#.#
D.........D
#..#.#.#..#
#.........#
#...#...#.#
#.........#
###########

