3
0
#####.#####
#.........#
#.........#
#.........#
#.........#
#.........d
#.........#
#.........#
#.........#
#.........#
#####d#####

0
0
###########
#.#.......#
#.#.......#
#.#......##
#.#...#...#
#...#.##..#
#....#..#.#
#......##.#
#.....#####
#.........#
#####l#####
locked : 0

4
3
#####.#####
#.........#
#.........#
#.........#
#.........#
#..........
#..#......#
#.........#
#.........#
#e........#
###########
enemies 1

3
1
#####.#####
#.........#
#.........#
#.#..#....#
#.........#
d..........
#..#..#...#
#.........#
#.........#
#.#.......#
#####.#####

2
1
#####.#####
#.........#
#.........#
#.........#
#.........#
....#......
#.........#
#.........#
#.........#
#.........#
#####.#####

1
3
###########
#k........#
##..#.....#
#.........#
#.........#
#....#....#
#.........#
#.........#
#...#.....#
#.........#
#####.#####
key : 3

3
2
#####.#####
#.......#k#
#.........#
#....#.####
#....##.#.#
..........d
#.........#
#.........#
#.........#
#.........#
###########
key : 2

2
0
#####.#####
###.......#
###.......#
#.........#
#.........#
#....@.#...
#....#..#.#
#.....#.#.#
#......#..#
#?#......##
#####.#####
sign A useful tool lies just ahead.

5
0
#####.#####
#.........#
#......#..#
#.......#.#
#.........#
#.........#
#.........#
#.......#.#
#......#..#
#.........#
###########

2
4
###########
#.......ee#
#.........#
#.........#
#.........#
..........#
#.........#
#.........#
#.........#
#.........#
#####.#####
enemies 2

2
2
###########
#.........#
#.........#
#.........#
#.........#
...........
#.........#
#.........#
#.........#
#.........#
#####.#####

1
1
###########
#.........#
#.#.....#.#
#.........#
#.........#
d..#..#...#
#.........#
#.........#
#.#.....#.#
#.........#
#####.#####

2
3
#####.#####
#e......#e#
#...#.#...#
#...e##...#
#...##....#
...........
#.........#
#.........#
#.........#
#?........#
#####.#####
enemies 3
sign The brave are rewarded.

4
0
#####d#####
##.....#.##
#.........#
##.#...#..#
#.........#
#..#.#.#...
#.........#
#..#.#.#.##
#.........#
##.#.....##
#####.#####

3
3
#####.#####
##........#
#.........#
#.........#
#.#..#..#.#
d.........l
#.........#
#...#.....#
#.........#
#.........#
#####.#####

3
4
#####.#####
#.........#
#.....#...#
#......#..#
#.....##..#
l....e....#
#.........#
#......#..#
#......##.#
#.........#
#####.#####
locked : 2
boss
enemies 1

4
1
#####.#####
#.......#.#
#.........#
#..#.#.#.##
#.........#
....#.....#
#.........#
#..#.#.#..#
#.........#
#.#......k#
###########
key : 1

1
0
#####l#####
#.........#
#.........#
#...#.#...#
#...###...#
#k....#...d
#.........#
#.........#
#.........#
#.........#
#####.#####
key : 0

4
4
#####.#####
#.........#
#...#..##.#
#...#..#..#
#....##...#
.....#.#..#
#...#.....#
#.........#
#.........#
#........X#
###########

