3
1
#####.#####
#.........#
#.#.......#
#....#....#
#...e.##..#
.....###...
#.........#
#....#....#
#.....###.#
#......####
#####d#####
boss
enemies 1

0
1
###########
##.#...#..#
#.........#
#...#.#.#.#
#.........#
d..#.#.#...
#.........#
#.#.#.#.#.#
#.........#
##.#...#..#
#####.#####

0
2
###########
#........k#
#......#..#
#.......#.#
#.........#
..........#
#.........#
#.........#
#.........#
#.........#
#####.#####
key : 3

1
1
#####.#####
#k........#
#..##.....#
#.#.......#
#....#....#
...........
#.........#
#.#......##
#..#......#
#.........#
#####.#####
key : 0

3
2
#####l#####
#.........#
#.........#
#.........#
#.........#
...........
#.........#
#.........#
#.........#
#.........#
###########
locked : 1

1
0
#####d#####
#.........#
#.........#
#.........#
#.........#
#..........
#.........#
#.........#
#.........#
#.........#
#####.#####

2
0
#####.#####
#.........#
#.........#
#.........#
#.........#
#....@.....
#.#.......#
##........#
#.........#
#.........#
#####.#####

4
1
#####d#####
#.........#
#.........#
##..#..#..#
#.........#
..........#
#.#.....#.#
#.........#
#.........#
##........#
#####.#####

1
3
###########
#.......ee#
#.........#
##..#..#..#
#.........#
..........#
#......#..#
#.........#
#.........#
#.........#
#####.#####
enemies 2
door 0 : 0

3
3
#####.#####
#.........#
#.........#
#.........#
#.........#
..........#
#.........#
#.#.......#
#..#......#
#........k#
###########
key : 4

4
0
#####.#####
#.........#
#......#..#
#.......#.#
#.........#
#..........
#.........#
#.......#.#
#......#..#
#.........#
###########

3
0
#####.#####
#e#.....#.#
#.........#
#.........#
#e#.....#.#
#..........
#.........#
#.#.....#.#
#.........#
#.........#
#####.#####
enemies 2

1
2
#####.#####
#e.......?#
#.........#
#.........#
#..#e#....#
...#.s.....
#...##....#
#.........#
#.........#
#e........#
#####.#####
enemies 3
switch 0 : 0
sign A locked path — look elsewhere first.

2
4
###########
#.........#
#.#.#.#.#.#
#.........#
#....#.#..#
d.........#
#.#.#.#.#.#
#.........#
#......#.##
#.........#
###########

2
3
#####.#####
#.......#k#
#...#.....#
#.........#
#...##..#.#
..........d
#.........#
#.........#
#.........#
#.........#
#####.#####
key : 1

0
0
###########
#.........#
#......#..#
#.......#.#
#.........#
#.........d
#.........#
#.......#.#
#......#..#
#.........#
#####d#####

2
2
#####.#####
#.........#
#.........#
#.........#
#.........#
l..........
#.........#
#.........#
#.........#
#.........#
#####l#####
locked : 0

5
1
#####.#####
#.........#
#.........#
#.........#
#.........#
#.........#
#.........#
#.........#
#.........#
#X........#
###########

2
1
#####.#####
#..#...#.##
#.........#
##.#.#.#.##
#.........#
.....#....l
#.........#
##.....#.##
#.........#
##.....#.##
#####.#####

