3
1
#####D#####
#.........#
##..#..#..#
#.........#
#.........#
#...#..#..l
#.........#
#.........#
##..#..#..#
#.........#
#####d#####

3
3
#####D#####
##.....#.##
#.........#
##...#.#.##
#.........#
D..#...#..#
#.........#
##.#...#.##
#.........#
##.#...#k##
###########
key : 3

5
2
#####D#####
#.........#
#.....#...#
##........#
#.###.###.#
D...#.....#
#..##.....#
#.........#
#.........#
#........X#
###########

2
0
###########
#.........#
#.........#
#.........#
#..#@.....#
#..#####..D
#..###.#..#
#.........#
#.........#
#.........#
###########

4
1
#####d#####
#.........#
#..#......#
#.#.......#
#.........#
#.........D
#.........#
#.#.......#
#..#......#
#.........#
#####d#####

0
2
###########
#...e.....#
#.###e....#
#.s###....#
#.#..##...#
D..#......D
#.#####...#
#.........#
#.........#
#.........#
#####D#####
enemies 2
switch 0 : 0

4
2
#####D#####
##.#...#..#
#.........#
##.#.#....#
#.........#
D....#.#..#
#.........#
##.....#.##
#........e#
##.#...#.##
#####D#####
enemies 1

5
1
#####d#####
#.........#
#.........#
#...#.....#
#..##e....#
#..###....D
#.####....#
#..##.....#
###.#.....#
###.......#
#####D#####
boss
enemies 1

6
1
#####D#####
#..#...#..#
#...#..#..#
#..##.##..#
#..##.....#
#...#.#...#
#.........#
#.........#
#e........#
#e.......e#
###########
enemies 3

2
2
#####d#####
#.........#
#.........#
#.........#
#.........#
D.........D
#.........#
#.........#
#.........#
#.........#
#####D#####

1
2
#####D#####
#k#.....#.#
#.........#
#.#.#.#...#
#.........#
D...#.....D
#.........#
#.#.#.#.#.#
#.........#
#.#.....#.#
#####d#####
key : 0

2
3
#####D#####
#k........#
#.........#
#.........#
#.........#
D.........D
#.........#
#.........#
#.........#
#.........#
#####D#####
key : 1

0
1
###########
#.#.....#.#
#.........#
#...#.#.#.#
#.........#
#...#.#...D
#.........#
#.#.#.#.#.#
#.........#
#.#.......#
#####d#####

1
1
#####d#####
#.........#
#.........#
#.........#
#.........#
#.........D
#.........#
#.#.....#.#
#..#...#..#
#.........#
#####D#####

3
2
#####D#####
#.........#
#.........#
#.........#
#.........#
l.........D
#.........#
#.........#
#.........#
#.........#
#####D#####
locked : 0

2
4
###########
#........k#
#..#...#..#
###.....#.#
#.........#
D.........#
#.........#
#.#..#....#
#..#......#
#.........#
###########
key : 4

0
3
###########
#.##....ee#
#.#.......#
#....##...#
#.##......#
D.........#
#.........#
#.........#
#.........#
#.........#
#####D#####
enemies 2
door 0 : 0

2
1
#####D#####
#.........#
#.........#
#.........#
#.........#
D.........D
#.........#
#.........#
#.........#
#.........#
#####D#####

1
3
#####D#####
#.........#
#..#......#
#..##.....#
#..##.....#
D..###.p..#
#.####p...#
##.#.#....#
##........#
##........#
#####D#####

