1
2
#####d#####
#.........#
#.........#
#.........#
#.........#
l.........D
#.........#
#.........#
#.........#
#.........#
#####D#####
locked : 1

3
0
#####D#####
##.....#..#
#.........#
#.........#
#.........#
#.........D
#.........#
#...#.....#
#.........#
#.........#
#####d#####

2
1
#####D#####
#.........#
#.........#
#.......p.#
#......p..#
D.........D
#.........#
#.........#
#.........#
#.........#
#####D#####

3
2
#####D#####
#.#.......#
#...#.....#
#..#......#
#.........#
D.........#
#.........#
#.........#
#.........#
#........k#
###########
key : 2

1
3
#####l#####
#.........#
#.........#
#.........#
#.........#
D..##.....D
#.##......#
#...##....#
#.........#
#.........#
#####D#####

5
1
#####D#####
#.........#
#e#.......#
##........#
#.........#
#......#..#
#......#..#
#.....##..#
#?........#
#e.......e#
###########
enemies 3
sign Seek the matching key before you proceed.

2
3
#####D#####
##.....#..#
#.........#
#.........#
#...#..#..#
D.........d
#.........#
##..#..#..#
#.........#
#....k....#
###########
key : 4

3
4
#####D#####
#.........#
#.........#
#.........#
#...##....#
#..###....#
#....##...#
#.........#
#.........#
#X........#
###########

1
4
###########
#.........#
#.....#.#.#
#.....#####
#....####.#
D.........#
#.......#.#
#.....##.##
#.........#
#.........#
#####D#####

0
3
###########
#.........#
#..#......#
#.#.......#
#.....#...#
D.........#
#.........#
#.#.......#
#..#......#
#.........#
#####l#####
locked : 0

2
2
#####D#####
#.......#.#
#.........#
#.#.#.#.#.#
#.........#
D...#.#...D
#.........#
#.#...#.#.#
#.........#
#k#.....#.#
#####D#####
key : 0

2
0
#####d#####
#.........#
#.........#
#.........#
#....###..#
#....@....D
#....###..#
#.........#
#.........#
#.........#
#####D#####

1
1
###########
#.........#
##.#...#.##
#.........#
#..#.#.#..#
D.........l
#....#.#..#
#.........#
##.#...#.##
#.........#
#####D#####

4
1
#####l#####
#......#.##
#.#...##..#
#.##..##.##
#..##.#...#
D.........#
#.........#
#.........#
#.........#
#.........#
#####D#####
locked : 2

3
1
#####D#####
#k........#
##..#.....#
#.........#
#.........#
D....#....D
#.........#
#.........#
##..#..#..#
#.........#
#####l#####
key : 1

4
0
#####d#####
#.........#
#......#..#
#.......#.#
#.........#
#.........D
#.........#
#.#.......#
#..#......#
#.........#
###########

1
0
###########
#.........#
#.........#
#....#.#..#
#..#......#
#...#.#...D
#..#......#
#.........#
#.........#
#.........#
#####d#####

0
2
###########
#........##
#.........#
#.........#
#.........#
#.........D
#.........#
#.........#
#.........#
#.........#
#####d#####

2
4
#####D#####
#.........#
#.........#
#.........#
#.........#
d....e....#
#.........#
#.........#
#.........#
#.........#
#####D#####
boss
enemies 1

