5
3
#####D#####
#.#.....#.#
#.........#
#...#...#.#
#.........#
D...#.#...#
#.........#
#.#.#.#.#.#
#.........#
#.#......k#
###########
key : 2

6
2
#####D#####
#......#..#
#.......#.#
#.....###.#
#......#..#
#....#....#
#.........#
#.........#
#.........#
#.........#
#####l#####

5
1
#####D#####
#.........#
#.#.#...#.#
#.........#
#.#.#.#.#.#
D.........D
#.#...#.#.#
#.........#
#.#.#.#.#.#
#...k.....#
###########
key : 1

7
2
#####l#####
#.........#
#......#..#
#.......#.#
#.........#
#.........#
#.........#
#.#.....#.#
#..#...#..#
#.........#
###########
locked : 0

3
4
#####d#####
#.........#
#..#...#.##
#.........#
#..#.#....#
D.........#
#.........#
#.........#
##.#...#..#
#.........#
###########

1
4
#####D#####
#.........#
#..##.##..#
#..#####..#
#....##...#
#...#e#...#
#.###.#.#.#
#.........#
#.........#
#.........#
#####d#####
boss
enemies 1

4
1
###########
#.........#
#.........#
#.........#
#.........#
D.........D
#.........#
#.........#
#.........#
#.........#
#####D#####

4
2
#####D#####
#.........#
##.#...#.##
#.........#
#.#.#.#.#.#
D.........d
#..#.#....#
#.........#
#.#.#.#.#.#
#.........#
#####D#####

0
4
###########
#X........#
#.........#
#.........#
#.........#
#....#....#
#.......#.#
#....##.###
#......#..#
#........##
#####D#####

4
3
#####D#####
#.........#
#.........#
#.........#
#.........#
d.........#
#.........#
#.........#
#.........#
#.........#
#####D#####

3
2
#####D#####
##k#...#..#
#.........#
#..#.#.#.##
#.........#
#..#.#.#..d
#.........#
#..#.#.#.##
#.........#
#..#...#..#
#####D#####
key : 4

3
0
###########
#.........#
#......#..#
#.......#.#
#.........#
#.........#
#.........#
#.......#.#
#......#..#
#.........#
#####l#####
locked : 1

3
3
#####l#####
#.........#
##........#
#...#.....#
#.........#
d.........D
#.........#
#.........#
#.........#
#.........#
#####D#####

4
0
#####l#####
#.........#
#......#.##
#....#...##
#.........#
#..#k##...D
#..##.##..#
#...#.##..#
#...#.##..#
#......#..#
#####D#####
key : 0

5
2
#####D#####
#.........#
#..#.....##
#.........#
#.#.....#.#
D.........D
#..#.#.#..#
#.........#
#.#.#.#.#.#
#.........#
#####D#####

2
2
###########
#.........#
#..#......#
#.#.......#
#.........#
#.........D
#.........#
#.#.......#
#..#......#
#.........#
#####D#####

2
4
#####d#####
#.........#
#.........#
#.........#
#.........#
D.........#
#.........#
#.......#.#
#......#..#
#.........#
#####d#####

2
3
###########
#.........#
#.###.....#
#..##.#####
#.#...#...#
D...####..D
#.####....#
#.....##.##
#.........#
#.........#
#####l#####
locked : 2

5
0
#####D#####
#.........#
#.........#
#.........#
#.........#
#....@....D
#.........#
#.........#
#.........#
#?........#
###########
sign Those who search shall find.

