0
3
###########
#X........#
#...#.....#
#...##....#
#.#.#.....#
#..#......#
#..#......#
#.........#
#.........#
#.........#
#####.#####

6
3
#####d#####
#.#.......#
#.........#
#.........#
#.........#
..........#
#.........#
#.#.....#.#
#..#...##.#
#.........#
###########

2
4
###########
#.........#
#..#......#
#.#.......#
#.........#
..........#
#......#..#
#.....#...#
#.....#...#
#.........#
###########

5
0
#####.#####
#.........#
##.....#..#
#.........#
#.#.#...#.#
#..........
#..#.#.#..#
#.........#
#e#.#.#...#
#es.......#
###########
enemies 2
switch 0 : 0 1

3
3
#####.#####
#.#.......#
#.###.....#
#.....#...#
#.#.##....#
l...#..#..#
#......##.#
#.....#...#
#.....##..#
#.........#
#####.#####
locked : 0

4
1
#####.#####
#e.......?#
#.........#
#.........#
#.#.......#
...#.......
#..##.....#
#.........#
#.........#
#e........#
#####.#####
enemies 2
sign Those who search shall find.

5
1
#####.#####
#.........#
#...#.#.#.#
#...#.#...#
#.....###.#
..........d
#.........#
#..#......#
#.........#
#.........#
#####.#####

2
3
#####d#####
#.........#
#.........#
#.........#
#.........#
#..........
#....#....#
#.........#
#......#..#
#........##
#####.#####

4
2
#####.#####
#k........#
#.........#
#.........#
#.........#
...........
#.........#
#.........#
#.........#
#.........#
#####.#####
key : 0

5
4
###########
#.........#
#.........#
#.........#
#.........#
d..#......#
#.#.##....#
#.#..#....#
##.#......#
##........#
###########

4
3
#####.#####
#.........#
#.........#
#.........#
#...#.###.#
....#.##..#
#.#.#.....#
#.#.....#.#
##.##.#...#
#.........#
#####.#####

1
3
#####.#####
#.........#
#.........#
#.........#
#.........#
#....e....#
#.........#
#.........#
#.........#
#.........#
#####d#####
boss
enemies 1

4
0
###########
#.........#
#.........#
#.........#
#.........#
#....@.....
#.........#
#.........#
#.........#
#.........#
#####.#####

6
2
#####.#####
#e.#.....##
#.........#
#.........#
#...#..#..#
...........
#.........#
#..#..#..##
#.........#
#?...e....#
###########
enemies 2
door 0 : 0 1
sign Those who search shall find.

5
2
#####.#####
#.........#
#.........#
#.........#
#.........#
d.........l
#.........#
#.#.......#
#..#......#
#.........#
#####.#####

3
1
###########
#k.#......#
#.........#
#.........#
#..#..#...#
#..........
#.........#
#..#..#...#
#.........#
#.........#
#####.#####
key : 1

5
3
#####.#####
#.........#
#......#..#
#.......#.#
#.........#
l.........d
#.........#
#.#.......#
#..#......#
#.........#
#####d#####
locked : 1

6
1
#####.#####
#.........#
#..#......#
##.#......#
#.##......#
#..........
#.........#
#.........#
#.........#
#k........#
###########
key : 3

3
2
###########
#....k....#
#.........#
#.........#
#.........#
....#.....l
#.........#
#.........#
#.........#
#.........#
#####.#####
key : 2

