1
2
#####.#####
#.........#
#.........#
#...#.....#
#....##...#
#..#.e....#
#.........#
#.........#
#.........#
#.........#
#####d#####
boss
enemies 1

2
2
#####d#####
#.........#
##..#..#..#
#.........#
#.........#
.....#.....
#.........#
#.........#
##..#..#..#
#.........#
#####.#####

4
0
#####.#####
#......#.k#
#.....##.##
#.....#..##
#.....#...#
#..........
#.........#
#.........#
#.........#
#.........#
#####.#####
key : 0

4
3
#####.#####
#e.......e#
##.#.....##
#.........#
#.#.#.#.#?#
..........#
#..#.#.#..#
#.........#
#.#.#.#.#.#
#.........#
#####d#####
enemies 2
sign What you seek is close.

4
1
#####.#####
##.....#..#
#.........#
#.........#
#.#..#..#.#
...........
#.........#
#...#.....#
#.........#
#.........#
#####l#####

5
1
#####l#####
#.........#
#.........#
#.#.#.....#
#.........#
....#.#...l
#.........#
#.#.#.#.#.#
#.........#
#.#.....#.#
#####l#####
locked : 0

6
1
#####l#####
#.........#
#.........#
#.........#
#.........#
..........#
#.........#
#.........#
#.........#
#.........#
###########
locked : 2

5
0
#####.#####
#.........#
#.........#
#.........#
#.........#
#....@.....
#.........#
#.........#
#.........#
#.........#
#####.#####

0
2
###########
#X........#
#.........#
#.........#
#..#......#
#..#......#
#.#.......#
###.......#
##.#......#
#.........#
#####.#####

5
2
#####.#####
#.........#
##.#......#
#.#.......#
#.........#
l..........
#.......#.#
#.#.....#.#
#......#..#
#.........#
###########
locked : 1

3
2
#####.#####
#.........#
#.........#
#.........#
#.........#
d..........
#.........#
#.........#
#.........#
#.........#
#####.#####

2
3
###########
#.........#
#.........#
##..#.....#
#.........#
..........#
#......#..#
#.........#
#.........#
##.....#..#
#####.#####

6
0
#####.#####
#.........#
#.......#.#
#....#.##.#
#......##.#
#......#...
#.........#
#.........#
#.........#
#.........#
###########

3
0
###########
#.........#
#.........#
#.........#
#.........#
#..........
#.........#
#.........#
#.........#
#.........#
#####.#####

3
1
#####d#####
#k........#
#.#.#.#.#.#
#.........#
#...#.#...#
..........d
#.#.#.#.#.#
#.........#
#.#.#.#.#.#
#.........#
#####.#####
key : 1

3
3
#####.#####
##.#......#
#..##.....#
#.##..#.#.#
#.....#k#.#
...#...#..#
#.........#
#.........#
#.........#
#.........#
#####.#####
key : 4

2
1
###########
#.........#
#.........#
#.#.......#
#.#.......#
#..........
#.........#
#.........#
#.........#
#.........#
#####d#####

4
2
#####.#####
#.........#
#.........#
#.........#
#.........#
....#......
#.#.##....#
##.###....#
#k.##.....#
##........#
#####.#####
key : 2

5
3
#####d#####
#.#.......#
#.........#
#.#.......#
#.........#
......#...#
#.........#
#.#.....#.#
#.........#
#.......#.#
###########

