2
0
#####l#####
#.........#
#..#......#
#.#.......#
#.........#
#..........
#.........#
#.......#.#
#......#..#
#.........#
#####.#####

4
0
#####.#####
#.........#
#.......#.#
#.........#
#.........#
#....@##...
#.....#...#
#.....#.#.#
#..#......#
#?........#
###########
sign A useful tool lies just ahead.

3
0
#####.#####
#.#.....#.#
#.........#
#..#.#...##
#.........#
#...#.#....
#.........#
#..#.#.#.##
#.........#
#.......#.#
#####.#####

5
1
#####d#####
#.........#
#..#......#
#.#.......#
#.........#
#..........
#.........#
#.........#
#.........#
#.........#
#####.#####

1
2
###########
#.....e..e#
#.##..#...#
#.###.....#
#.....#...#
....##....#
#.####....#
##........#
###.......#
##........#
#####.#####
enemies 2
door 0 : 0

2
2
#####.#####
#.........#
#.........#
#.........#
#.........#
..........#
#....###..#
#.....X#..#
#.....##..#
#.........#
#####.#####

0
1
###########
#.##.....k#
#.###.....#
#...##....#
#..##.....#
..........#
#...##....#
#.#.#.#...#
#.###.....#
#.........#
#####.#####
key : 4

1
1
#####.#####
#.........#
#.........#
#.........#
#..#e#.##.#
d..#.#.....
#..#..##..#
#....#.##.#
#.......###
#.........#
#####.#####
boss
enemies 1

4
2
#####d#####
#.........#
#.....#..##
#.........#
#.........#
.......#...
#.........#
#.........#
#..#..#..##
#.........#
#####.#####

4
3
###########
#.........#
#.........#
##..#..#..#
#.........#
..........#
#...#..#..#
#.........#
#.........#
##.....#..#
###########

3
1
#####.#####
#e.......e#
#.........#
#..#.....##
#.........#
...........
#...#..#..#
#.........#
#.........#
#e?#.....##
#####.#####
enemies 3
sign The brave are rewarded.

3
2
#####.#####
#.........#
#...#.#.#.#
#.........#
#..#.#.#..#
..........#
#.#.#.#.#.#
#.........#
#..#...#.##
#.........#
#####d#####

6
2
#####.#####
##.......##
#..#......#
#.#.......#
#.........#
..........#
#.........#
#.........#
#.........#
#........k#
###########
key : 2

6
1
#####.#####
#.........#
#.........#
#....######
#....##...#
#...#..#...
#s##..#...#
##.#...##.#
##........#
#e.......##
###########
enemies 1
switch 0 : 0

5
2
#####.#####
#..#...#..#
#.........#
##.#.#...##
#........e#
.....#?#..#
#........e#
#..#.#...##
#.........#
##e#......#
#####.#####
enemies 3
sign A useful tool lies just ahead.

0
0
###########
##.....#..#
#.........#
#.........#
#.......#.#
#..........
#.........#
##..#..#..#
#.........#
#.........#
#####d#####

2
1
#####.#####
#........k#
#.....#..##
#.........#
#.........#
....#..#...
#.........#
#.........#
#..#.....##
#.........#
#####.#####
key : 3

4
1
#####.#####
#k.......##
#.........#
#.........#
#...#..#..#
...........
#.........#
#..#.....##
#.........#
#.........#
#####d#####
key : 0

1
0
#####d#####
#.........#
#......#..#
#.......#.#
#.........#
#.........d
#.........#
#.........#
#.........#
#.........#
#####l#####
locked : 0

