1
2
#####.#####
#e........#
#.........#
#.....#...#
#.....#...#
.....##....
#....####.#
#....#..###
#.........#
#?........#
#####.#####
enemies 1
sign Seek the matching key before you proceed.

0
2
###########
#k#.....#.#
#.........#
#.........#
#..#..#...#
..........d
#.........#
#.#..#..#.#
#.........#
#.........#
#####.#####
key : 6

4
2
#####.#####
##.....#.##
#.........#
#.#.#.#.#.#
#.........#
..........#
#.........#
#.#.#.#...#
#.........#
#......#..#
###########

2
2
#####.#####
#.........#
##.#...#.##
#.........#
#....#.#..#
d..........
#..#.#.#..#
#.........#
#..#......#
#.........#
#####.#####

3
1
#####.#####
#.........#
#.........#
##..#..#..#
#.........#
..........d
#....#..#.#
#.........#
#.........#
#......#..#
#####.#####

1
3
#####.#####
#.........#
#.........#
#.........#
#.........#
.........X#
#.........#
#.........#
#.........#
#.........#
#####.#####

4
0
#####.#####
#.........#
#.........#
#...#.###.#
#...@.#...#
#...##.....
#...##....#
#.......#.#
#.........#
#.........#
#####.#####

5
0
#####.#####
#......#.##
#.........#
#.#...#.#.#
#.........#
#..#.#....#
#.........#
#.#.#.#.#.#
#.........#
##.......k#
###########
key : 0

1
0
#####.#####
#.........#
#.........#
#.........#
#e#.#.....#
#.?.#......
#e#.#.....#
#.#.......#
#.........#
#.........#
#####.#####
enemies 2
sign This door will not yield without a key.

2
3
#####.#####
#.........#
#..#......#
#..#......#
#..#......#
..........#
#.........#
#.........#
#.........#
#.........#
###########

0
1
###########
#..k......#
#..#......#
#.#.......#
#.........#
...........
#.........#
#.........#
#.........#
#.........#
#####.#####
key : 5

4
1
#####.#####
##.....#.##
#.........#
#.#.#.#.#.#
#.........#
.....#.#...
#.........#
#.#.#.#...#
#.........#
##.....#.##
###########

1
1
#####.#####
#.........#
#.........#
#.........#
#.#.......#
...........
#.........#
#.......#.#
##.....#..#
#.......#.#
#####l#####
locked : 1

2
0
#####.#####
#.........#
#.........#
#...#.....#
#.######..#
#...##.#...
#.#.#.....#
#..##.#...#
#..#..##..#
#.........#
#####d#####

0
3
###########
#..#......#
#..##.....#
#....##...#
#...###...#
d....e....#
#.........#
#.........#
#.........#
#.........#
#####.#####
boss
enemies 1

2
1
#####l#####
#k........#
#.........#
#.........#
#.........#
..........d
#.........#
#.........#
#.........#
#.........#
#####.#####
key : 1

0
0
###########
#ee.......#
#e........#
#.........#
#.........#
#..........
#.........#
#.........#
#.........#
#.........#
#####.#####
enemies 3

3
2
#####.#####
#..#...#.##
#.........#
##.#.#.#.##
#.........#
d....#....#
#.........#
##...#.#.##
#.........#
##.#...#.##
#####.#####

3
0
#####d#####
#.........#
#.........#
#.#..#..#.#
#.........#
#..........
#.#.....#.#
#.........#
#.........#
#.......#.#
#####.#####

