3
1
#####D#####
#.........#
#.........#
#..#.#.#.##
#.........#
#...#.#...#
#.........#
#..#.#...##
#.........#
#.......#.#
#####D#####

4
0
###########
#.........#
#.........#
###..#....#
#...@.....#
#..#.#....D
#.##......#
#..#......#
#.........#
#.........#
#####D#####

4
1
#####D#####
#.........#
#.........#
#......#..#
#......##.#
D.....##..D
#.##......#
###.......#
#.........#
#....k....#
###########
key : 0

4
2
###########
#.........#
#......#..#
#.......#.#
#.........#
D.........D
#.........#
#.#.....#.#
#..#...#..#
#.........#
#####D#####

5
0
#####D#####
##.#......#
#.........#
#.#.##....#
#.####....#
#.........#
#.........#
#.........#
#.........#
#.........#
###########

4
4
#####d#####
#k........#
#.........#
#.........#
#.........#
D.........d
#.........#
##........#
#.........#
#.........#
#####l#####
key : 2

5
4
#####l#####
#.#.......#
#.###.#..p#
#..###....#
#.##.#....#
#..#.##...#
#.........#
#.........#
#.........#
#.p.......#
###########
locked : 1

4
5
#####D#####
#.........#
#.........#
#.........#
#.........#
d.........#
#.........#
#.........#
#.........#
#.........#
###########

0
4
###########
#X........#
#.........#
#.........#
#..#..##..#
#....#....#
#..#......#
#....#p#..#
#.p#......#
#.........#
#####D#####

4
3
#####d#####
#.........#
#.........#
#.........#
#.........#
D.........D
#.........#
#.........#
#.........#
#....k....#
###########
key : 1

5
2
#####D#####
#.........#
#.........#
#.........#
#.........#
#.........#
#.........#
#.......#.#
#......#..#
#.........#
#####d#####

2
1
###########
#.........#
#.........#
#.........#
#.........#
#.........#
#.........#
#.........#
#.........#
#.........#
#####D#####

3
4
#####l#####
#..#......#
#..#......#
#..#...#..#
#..#####..#
D.........D
#.........#
#.........#
#.........#
#.........#
#####d#####

6
2
#####d#####
#.........#
#.......p.#
#.........#
#....##.#.#
#....##...#
#....#.#..#
#..p.....##
#......#.##
#.........#
###########

3
3
###########
#.........#
#.........#
#.........#
#.........#
#..#......D
#.........#
#.##......#
#.........#
#.........#
#####d#####

2
4
#####l#####
#.........#
##.#...#.##
#.........#
#.#.#...#.#
#.........D
#..#......#
#.........#
#.#.#.#.#.#
#.........#
#####l#####
locked : 2

3
5
#####D#####
#........##
#.........#
#.........#
#.....#...#
D.........#
#........k#
#..#..#..##
#.........#
#.........#
#####D#####
key : 3

2
5
###########
#.....e#?e#
#.....##.##
#......#..#
#....##.#.#
D.........#
#.........#
#.........#
#.........#
#.........#
#####D#####
enemies 2
sign Seek the matching key before you proceed.

1
4
#####D#####
###.......#
####......#
###.......#
#..##.....#
#...e#....#
#....#....#
#....#....#
#.........#
#.........#
#####l#####
locked : 3
boss
enemies 1

