2
0
###########
#?........#
#...#.....#
#.........#
#.........#
#....@....D
#.....##..#
#.........#
#.........#
#.........#
###########
sign Many have walked this path.

1
2
###########
#..#.....##
#.........#
#.........#
#..#..#...#
D.........D
#.........#
#..#.....##
#.........#
#.........#
#####D#####

2
1
#####D#####
#.........#
#.........#
##..#..#..#
#.........#
D.........d
#.#..#..#.#
#.........#
#.........#
#......#..#
#####d#####

1
3
#####D#####
#.........#
#.........#
#.........#
#.........#
D.........D
#.........#
#.#.....#.#
#..#...#..#
#.........#
#####d#####

3
4
#####l#####
#......##.#
#.....#...#
#...#.....#
#...#.##..#
D....###..#
#.........#
#.........#
#.........#
#.........#
###########
locked : 0

4
1
#####D#####
#..#......#
#......#..#
#...#...#.#
#.........#
#.........#
#...#.....#
#.........#
#.........#
#.........#
###########

0
3
###########
#k........#
#......#..#
#.......#.#
#.........#
#.........D
#.........#
#.......#.#
#......#..#
#.........#
#####D#####
key : 3

0
1
###########
#k#.....#.#
#.........#
#..#.#.#.##
#.........#
#...#.#...#
#.........#
#..#.#.#.##
#.........#
#.#.....#.#
#####D#####
key : 1

0
4
###########
#........X#
#.........#
#.........#
#...#.##..#
D...##.#..#
#...#...#.#
#...#.....#
#...#.#.#.#
#.........#
#####D#####

1
4
#####D#####
#.........#
#.........#
#.........#
#..##.....#
D....e....D
#.........#
#..#......#
###.......#
#.........#
#####l#####
locked : 1
boss
enemies 1

3
2
#####D#####
#.........#
#.....#..##
#.........#
#.........#
D..#......D
#.........#
#.........#
#..#..#..##
#.........#
###########

1
5
###########
#.........#
#..#..#..##
#.........#
#.........#
D...#.....#
#.........#
#.........#
#..#..#...#
#.........#
#####D#####

3
1
#####d#####
#.......#.#
#.........#
#..#.#.#.##
#.........#
#.....#...D
#.........#
#..#.#...##
#.........#
#.#.......#
#####D#####

1
1
#####D#####
#.........#
#.........#
#.....#..##
#.........#
#.........D
#...#..#..#
#.........#
#.........#
#........##
#####D#####

2
2
#####D#####
#......#.##
#......#.##
#......#.##
#.........#
d.........D
#...#.....#
#.........#
#........##
#.........#
#####D#####

2
4
#####l#####
#.......#.#
#......##.#
#....##k..#
#.....##..#
D.....##..D
#.........#
#.........#
#.........#
#.........#
#####l#####
key : 2

2
5
#####D#####
#.........#
#.........#
#.........#
#.........#
D.........#
#.........#
#.........#
#........e#
#.......ee#
###########
enemies 3

3
3
#####d#####
#.........#
#.....#.#.#
#.........#
#..#.#.#..#
D.........D
#.#.#.#.#.#
#.........#
#......#.##
#.........#
###########

2
3
#####d#####
#.........#
#.........#
#.........#
#.........#
D.........D
#.#.......#
#..#......#
###.......#
#k........#
#####d#####
key : 0

