0
0
###########
#.........#
#..#......#
#.#.......#
#.........#
#.........#
#.........#
#.........#
#.........#
#.........#
#####d#####

3
3
###########
#.......?e#
#.........#
#.........#
#.....#...#
......e#..#
#....###..#
#.....##.##
#......#..#
#.........#
#####.#####
enemies 2
sign This door will not yield without a key.

5
3
#####.#####
#.........#
#.....#...#
#....##.###
#.....##..#
#....#.#...
#....#....#
#.........#
#.........#
#k........#
###########
key : 5

4
4
###########
#.......#.#
#####.....#
#.#..#....#
#.##..#...#
d.........#
#.........#
#.........#
#.........#
#.........#
#####d#####

3
0
#####.#####
#.........#
#.........#
#.........#
#.........#
#?...@.....
#.........#
#.........#
#.#.......#
#.........#
#####.#####
sign Those who search shall find.

6
4
#####.#####
#.##......#
#.###.....#
#.#####...#
#.##.##...#
#..#......#
#.........#
#.........#
#.........#
#X........#
###########

1
0
#####d#####
#.##......#
#.#.#.#...#
#.#.#.....#
#.#.##....#
#.........d
#.........#
#.........#
#.........#
#.........#
#####.#####

4
0
#####.#####
#.........#
#..#......#
#.#.......#
#.........#
#..........
#......#..#
#..#....#.#
#......#..#
#.......#.#
###########

2
1
#####.#####
#.........#
#.........#
#.........#
#.........#
l..........
#.........#
#.........#
#.........#
#.........#
#####.#####
locked : 0

4
1
#####.#####
#.........#
#.....#..##
#.........#
#.........#
....#......
#.........#
#.........#
#..#..#..##
#.........#
#####.#####

3
1
#####.#####
#.........#
#......#..#
#.......#.#
#.........#
...........
#.........#
#.......#.#
#......#..#
#.........#
#####.#####

5
1
#####.#####
#.........#
#......#..#
#.........#
#.........#
#.........#
#..#......#
#.........#
#.........#
#k........#
###########
key : 2

3
2
#####.#####
#.........#
#..#......#
#.#.......#
#.........#
...........
#.........#
#.#.....#.#
#..#...#..#
#.........#
#####l#####
locked : 1

2
2
###########
#.......k##
#.........#
#.........#
#..#..#...#
..........#
#.........#
#..#..#...#
#.........#
#.........#
#####.#####
key : 1

4
3
#####.#####
#.........#
#.........#
#.........#
#.........#
l.........d
#.........#
#.#.......#
#..#......#
#.........#
#####.#####
locked : 2

4
2
#####l#####
#.........#
#.#.......#
#.........#
#....#....#
..........l
#.........#
#.#.......#
#..#......#
#.#.......#
###########

5
4
#####d#####
#.........#
#.........#
#.........#
#...#.#...#
...##e#...#
#.#.#.....#
#.#.......#
#.#.#.....#
#.........#
#####.#####
boss
enemies 1

2
0
#####.#####
##.....#..#
#.........#
#.........#
#....#....#
#.........l
#k........#
##.....#..#
#.........#
#.........#
#####.#####
key : 0

1
1
###########
#.........#
#.........#
#.........#
#.........#
d..#..#...#
#..#......#
#..#...#..#
#..##.....#
#......#..#
#####.#####

