3
2
#####D#####
#k........#
#.........#
#.........#
#.........#
D.........l
#.........#
#.........#
#.........#
#.........#
#####d#####
key : 4

5
1
#####d#####
#.........#
#..#...#..#
#.#.....#.#
#.........#
#.........D
#.........#
#.#.....#.#
#..#...#..#
#.........#
###########

4
0
#####D#####
#.........#
#.........#
#.........#
#.........#
#.........D
#.........#
#.........#
#e........#
##e.......#
###########
enemies 2

1
3
###########
#.........#
#.........#
#p........#
#.####....#
D..#......#
#.###.#...#
#.#..#....#
#...p.#...#
#.........#
###########

3
3
###########
#.........#
#.........#
#.........#
#.........#
l.........#
#.........#
#.......#.#
#......#..#
#.........#
#####D#####
locked : 0

1
2
###########
#.........#
#......#.##
#.........#
#..#.#.#..#
D.........D
#..#.#.#..#
#.........#
#..#...#.##
#.........#
#####D#####

4
1
#####l#####
#.........#
#.........#
#.....##..#
#.....#.#.#
D.........D
#......#..#
#......#..#
#.........#
#.........#
#####d#####
locked : 4

4
3
#####D#####
#.........#
#.........#
#.........#
#.........#
d....e....#
#.........#
#.........#
#.........#
#.........#
#####D#####
boss
enemies 1

2
1
#####l#####
#.........#
#......#..#
#.......#.#
#...#.....#
D.........D
#.........#
#.......#.#
#......#..#
#.#.......#
#####D#####

4
2
#####d#####
#.........#
#..#......#
#.#.......#
#.........#
D......#..d
#.........#
#.#.....#.#
#..#...#..#
#.........#
#####d#####

5
3
#####D#####
#.........#
#.........#
#..#......#
#.##......#
D.........#
#.........#
#.........#
#.........#
#........X#
###########

3
0
#####D#####
#.........#
#.........#
#...#...#.#
#.........#
#...#.#...D
#.........#
#...#.#...#
#.........#
#k#.....#.#
#####D#####
key : 0

3
1
#####D#####
#........##
#.........#
#.........#
#...#..#..#
D.........D
#.........#
#.........#
#.........#
#.........#
#####l#####

0
1
###########
#k........#
#..#......#
#.#.......#
#.........#
#.........#
#.........#
#.#.#.....#
#..#......#
##........#
#####D#####
key : 5

5
2
#####d#####
#.........#
#.........#
#.........#
#.........#
D.........D
#.........#
#.........#
#.........#
#.........#
###########

1
0
###########
#e........#
#.........#
#.........#
#.........#
#.........D
#.........#
#.........#
#.........#
#.........#
#####D#####
enemies 1

1
1
#####D#####
#.........#
#......#..#
#.......#.#
#.........#
D.........D
#.........#
#.......#.#
#......#..#
#.........#
#####l#####
locked : 1

2
0
#####D#####
#.........#
#.........#
#.........#
#.........#
#....@....D
#.....##..#
#......#..#
#.........#
#.........#
#####D#####

2
2
#####D#####
#.........#
#..#......#
#.#.......#
#.........#
D........k#
#.........#
#.#.......#
#..#......#
#.........#
#####D#####
key : 1

