2
0
#####.#####
#.........#
#......##.#
#.........#
#.........#
#....@.....
#.........#
#.........#
#.........#
#.........#
#####.#####

1
1
#####.#####
#.........#
#.........#
#.........#
#.........#
...........
#.........#
#.........#
#........##
#.........#
#####.#####

1
3
###########
#......#..#
#...#..#..#
#..#...#..#
#..#.#.#..#
..........#
#.........#
#.........#
#.........#
#.........#
#####.#####

1
2
###########
#....k....#
#.........#
#.........#
#.........#
...........
#.........#
#.........#
#.........#
#.........#
#####.#####
key : 3

4
1
#####d#####
#.........#
#.........#
####......#
#.###.....#
..........#
#.#.#.....#
#####.....#
#.........#
#.........#
###########

3
2
#####.#####
#.........#
#.........#
#.........#
#.........#
..........d
#..#......#
##.#......#
#..##..#..#
#.##...#..#
###########

0
0
###########
#.........#
#.........#
#....##...#
#....##...#
#..####....
#..#......#
#.#####...#
#.........#
#.........#
#####d#####

3
1
#####.#####
#.......#.#
#.........#
#.........#
#..##.....#
....#.#....
#...#..#..#
#......#..#
#..##.....#
#.........#
#####d#####

1
0
#####d#####
##.....#..#
#e........#
#.........#
#e#..#..#.#
#?.........
#e........#
##..#.....#
#.........#
#.........#
#####.#####
enemies 3
sign The dungeon remembers all who enter.

3
4
#####.#####
#.........#
#.........#
#.#..#..#.#
#.........#
..........#
#.#.....#.#
#.........#
#.........#
#.#.....#k#
###########
key : 7

2
3
#####.#####
#.........#
#.........#
#....#....#
#.....#...#
....#e.....
#.........#
#.........#
#.........#
#.........#
#####d#####
boss
enemies 1

4
3
#####.#####
#.........#
#...#.....#
#.........#
#.........#
#.........#
#.........#
#.........#
#.........#
#.......#.#
###########

3
0
#####.#####
#........k#
#..#..#..##
#.........#
#.........#
#..#..#....
#.........#
#.........#
#..#..#...#
#.........#
#####.#####
key : 0

4
0
#####.#####
#.........#
#..##.#...#
#.....#...#
#...##....#
#..........
#.........#
#.........#
#.........#
#k........#
###########
key : 1

3
3
#####d#####
#.#.....#.#
#.........#
#.........#
#..#..#...#
d..........
#.........#
#.#..#..#.#
#.........#
#.........#
#####.#####

0
1
###########
##.#...#.##
#.........#
##.#.#.#.##
#.........#
...#...#..#
#.........#
#..#.#.#.##
#.........#
#..#...#.##
#####.#####

2
2
#####.#####
#.........#
#.........#
#.........#
#.........#
l..........
#.........#
#.........#
#.........#
#.........#
#####.#####
locked : 0

2
1
#####.#####
#.........#
#.##......#
#.#....#..#
#.........#
....#.....l
#.........#
#.......#.#
#......#..#
#.........#
#####.#####

2
4
###########
#........X#
#.........#
#.........#
#.........#
...#.#....#
#..#.#....#
#....#....#
#.........#
#.........#
#####.#####

