0
0
###########
#.#.......#
#...#.....#
#.###.....#
#...#.....#
#.........#
#.........#
#.........#
#.........#
#.........#
#####D#####

4
4
###########
#.........#
#.........#
#.........#
#.........#
d....e....#
#.........#
#...p.....#
#........p#
#.........#
#####D#####
boss
enemies 1

5
4
#####D#####
#.........#
#.........#
#.........#
#.........#
D.........#
#.........#
#.........#
#.........#
#........X#
###########

1
3
###########
#........k#
#......#..#
#.......#.#
#.........#
D.........#
#.........#
#.#.......#
#..#......#
#.........#
###########
key : 4

4
1
#####l#####
#.........#
#.........#
#.....#..##
#.........#
#.........D
#...#.....#
#.........#
#.........#
#..#.....##
#####D#####
locked : 1

1
2
###########
#.........#
#.........#
#...##k#..#
#....###..#
D.........D
#...#.#...#
#.........#
#.........#
#.........#
###########
key : 1

5
1
#####D#####
#.#.....#.#
#.........#
#..#...#.##
#.........#
#.....#...D
#.........#
#..#.....##
#.........#
#k#.......#
###########
key : 2

4
3
#####d#####
#e........#
#.........#
#.........#
#.........#
D.........d
#.........#
#........##
#.........#
#.........#
#####D#####
enemies 1

1
1
###########
#.........#
#.........#
#.........#
#.........#
D.........D
#...#...#.#
#.#.......#
#..#......#
#.........#
#####D#####

1
0
#####D#####
#.........#
#..#......#
#.#.......#
#.........#
#.........D
#.........#
#.#.....#.#
#..#...#..#
#.........#
#####D#####

5
2
#####d#####
#.........#
#.........#
#.........#
#.........#
D.........D
#.........#
#.#.....#.#
#..#...#..#
#.........#
###########

3
0
#####D#####
#......#..#
#.........#
#.........#
#.#.....#.#
#.........l
#.........#
##..#..#..#
#.........#
#k........#
###########
key : 0

2
1
#####D#####
#.........#
#...#..#..#
#.........#
#.........#
d.........#
#.........#
#.........#
##..#..#..#
#.........#
#####D#####

3
3
###########
#.........#
#......#..#
#.......#.#
#.........#
D.........#
#.........#
#.#.....#.#
#..#...#..#
#.........#
#####d#####

2
0
#####D#####
#.........#
#.........#
#.........#
#...@#....#
#?...#....d
#......#..#
#.........#
#.....##..#
#.........#
#####D#####
sign A useful tool lies just ahead.

5
3
#####D#####
#.........#
#.#.#...#.#
#.........#
#..#.#.#..#
D.........D
#.#.#.#.#.#
#.........#
#..#...#.##
#........e#
###########
enemies 1

3
2
###########
#...e.....#
#.#.#...#.#
#.........#
#.#.#.#.#.#
D.........D
#.#...#.#.#
#.........#
#.#.#.#.#.#
#.........#
#####D#####
enemies 1

3
1
#####D#####
#.........#
#.........#
#........p#
#.........#
l...#.#...D
#......#..#
#....##.#.#
#...#.#...#
#.......#.#
#####l#####
locked : 0

4
2
#####D#####
#.........#
#.#....#..#
#....#..#.#
#.........#
D.........D
#....#....#
#.........#
#.........#
#.........#
#####d#####

