3
2
#####D#####
#.........#
#......#..#
#.......#.#
#.........#
D.........D
#.........#
#.........#
#.........#
#.........#
###########

3
4
###########
#........e#
#.........#
#.........#
#.........#
D....#....#
#.##......#
###.......#
#..#......#
#........e#
###########
enemies 2

7
2
###########
#.........#
#.....##..#
#....###.##
#....####.#
l....###..#
#.....#.#.#
#.........#
#.........#
#.........#
#####D#####
locked : 0

3
0
#####d#####
#.........#
#.........#
#.........#
#.........#
#.........D
#.........#
#.........#
#.........#
#.........#
#####D#####

6
1
#####d#####
#.........#
#..#......#
#.#.......#
#.........#
#.........#
#.........#
#.......#.#
#......#..#
#.........#
#####D#####

7
1
#####D#####
#e........#
#.........#
#.........#
#.........#
#e........l
#.........#
#.........#
#.........#
#.........#
#####D#####
enemies 2

2
2
###########
#........k#
#..#......#
#.#.......#
#.........#
D.........#
#.........#
##........#
#.........#
#.........#
#####D#####
key : 2

10
1
#####D#####
#.........#
#.........#
#.........#
#.........#
#.........#
#.........#
#.........#
#.........#
#X........#
###########

8
2
#####D#####
#.........#
#..#......#
#.#.......#
#.........#
D.........#
#.........#
#.........#
#.........#
#.........#
###########

5
1
#####d#####
#.........#
#.........#
#.......#.#
#.........#
#.........#
#.........#
#.......#.#
#...#..#..#
#.#.......#
#####d#####

2
1
#####D#####
#k........#
#.........#
##.....#..#
#.........#
D.........D
#.#..#..#.#
#.........#
#.........#
##........#
#####D#####
key : 1

2
0
#####d#####
#.........#
#.....#..##
#.........#
#.........#
#...#..#..D
#.........#
#.........#
#..#..#...#
#.........#
#####d#####

9
1
#####l#####
#......#..#
#.......#.#
#....##.#.#
#...####..#
#....e....#
#.....##..#
#.....#...#
#.........#
#.........#
#####D#####
locked : 1
boss
enemies 1

3
1
#####D#####
#.........#
#......#..#
#.........#
#..#.#....#
D.........D
#..#.#.#..#
#.........#
#..#...#.##
#.........#
#####D#####

0
0
###########
#.........#
#.........#
#.##.##...#
#..#......#
#....#....#
#..###....#
#.........#
#.........#
#.........#
#####D#####

4
1
#####D#####
#..#.....##
#........k#
#.........#
#...#.....#
D.........#
#.........#
#..#..#...#
#.........#
#.........#
#####d#####
key : 0

1
1
###########
#.........#
#.........#
#..#.....##
#.........#
l.........#
#.....#...#
#.........#
#.........#
#.........#
#####D#####
locked : 2

3
3
###########
#..#k.....#
#..##.....#
#...#.....#
#.........#
D.........D
#.....##..#
#....##...#
#.....#...#
#.........#
###########
key : 3

4
0
#####D#####
#.........#
#.........#
#.........#
#...@#....#
#....#.#..D
#....#.##.#
#........##
#.....#####
#.........#
###########

1
0
#####D#####
#.........#
#.........#
#.........#
#.........#
#.........l
#.........#
#.#.....#.#
#..#...#..#
#.........#
#####d#####

8
1
#####D#####
#.........#
#.........#
#.........#
#.........#
#.........D
#.........#
#.........#
#.........#
#.........#
#####l#####

