0
0
###########
#.........#
#.........#
#.........#
#.........#
#.........D
#.........#
#.........#
#.........#
#.........#
#####d#####

4
2
#####D#####
#.........#
#.....#...#
#.....##..#
#..##..#..#
D.........D
#.....#...#
#.........#
#.........#
#.........#
###########

2
2
#####D#####
#k........#
#..#...#..#
#.#.....#.#
#.........#
D.........D
#.........#
#.........#
#.........#
#.........#
#####D#####
key : 3

4
3
#####D#####
#.........#
#..#.....##
#.........#
#.........#
D..#..#...D
#.........#
#.........#
#..#..#..##
#.....e...#
###########
enemies 1

1
0
#####d#####
#.........#
#.........#
#.###.....#
#.#.##....#
#...#.....D
#k###.....#
####......#
#.........#
#.........#
#####D#####
key : 0

0
1
###########
#......#.##
#.........#
#.#.#.#.#.#
#.........#
D..#.#.#..#
#.........#
#.#.#.#.#.#
#.........#
##.#.....##
#####D#####

3
3
#####D#####
#.........#
#.........#
#.........#
#...###...#
d.........d
#...#..#..#
#...##....#
#.....#...#
#.........#
#####D#####

3
0
#####D#####
#.........#
#.........#
#.........#
#...####..#
#...####..l
#...#####.#
#...#.###.#
#...#.#...#
#.........#
###########

3
2
#####D#####
#.........#
##.....#..#
#.........#
#.........#
l....#....d
#.........#
#.........#
##..#..#..#
#.........#
#####D#####
locked : 2

4
1
#####D#####
##.....#..#
#.........#
#.........#
#k#..#....#
#.........D
#.........#
#...#..#..#
#.........#
#.........#
#####D#####
key : 2

3
4
###########
#.........#
#.........#
#.........#
#...e.....#
d...##....#
#...##..p.#
#.....#...#
#.........#
#.........#
#####D#####
boss
enemies 1

1
1
#####D#####
#.........#
#.........#
#.##......#
#.####....#
D..#k#....d
#..#.#....#
####.#....#
#.........#
#.........#
#####D#####
key : 1

3
1
#####D#####
#.........#
#..#......#
#.........#
#.....#...#
l.........l
#.........#
#.........#
#.........#
#.........#
#####D#####
locked : 1

2
1
#####D#####
#.........#
#.........#
#.........#
#...#.....#
D.........D
#.........#
#.#.......#
#..#......#
##.....#..#
#####D#####

2
0
#####D#####
#.........#
#.........#
#.........#
#.........#
#....@....D
#.........#
#.........#
#.........#
#.........#
#####D#####

2
3
###########
#.......ee#
#.........#
#.........#
#..##.....#
D..###....#
#.#.......#
#...#.....#
###.#.....#
#.........#
#####D#####
enemies 2

1
2
###########
#.........#
#.#.#.#.#.#
#.........#
#.#.#.#.#.#
d.........#
#...#...#.#
#.........#
#.#.#...#.#
#.........#
#####D#####

4
4
#####D#####
#.........#
#.........#
#.........#
#.........#
D.........#
#.........#
#.........#
#.........#
#........X#
###########

5
1
#####D#####
##.....#.##
#.........#
#.#.#...#.#
#.........#
#..#.#.#..#
#.........#
#...#.#.#.#
#.........#
#..#......#
###########

