5
3
#####D#####
#.........#
#.........#
#.........#
#.........#
#.........#
#.......p.#
#.........#
#.........#
#X........#
###########

0
1
###########
#k........#
#.#.#.#.#.#
#.........#
#.#.#.#.#.#
#.........#
#.#.#.#...#
#.........#
#.#.#.#.#.#
#.........#
#####D#####
key : 3

1
2
###########
#.......?e#
#.#...#.#.#
#.........#
#.#.#.....#
D.........#
#...#.#...#
#.........#
#...#.#.#.#
#.........#
#####D#####
enemies 1
door 1 : 2 3
sign Beware what lurks ahead.

3
1
#####D#####
#.........#
#.........#
#.........#
#.........#
D..#......d
#.##......#
#.........#
#.........#
#.........#
#####D#####

5
0
#####D#####
#.........#
#.........#
#.........#
#...##....#
#....##...D
#...#.#...#
#......#..#
#.........#
#k........#
###########
key : 0

4
3
#####D#####
#.........#
#......#..#
#.......#k#
#.........#
D.........#
#.........#
#.........#
#.........#
#.........#
#####D#####
key : 4

5
1
#####D#####
#.........#
#.........#
#.........#
#.........#
D.........#
#.........#
#.........#
#.........#
#......?se#
###########
enemies 1
switch 1 : 2 3
sign Something glints behind that door…

2
3
###########
#.......ee#
#........e#
#.........#
#.....#...#
D....##...#
#.....#...#
#....#...##
#.....#####
#.........#
#####D#####
enemies 3
door 0 : 0 1

1
1
#####D#####
#.........#
#.........#
#.........#
#.........#
#.........D
#.........#
#.........#
#.........#
#.........#
#####D#####

3
2
#####D#####
#.........#
#.#.......#
#.........#
#.........#
d....#....d
#.........#
#.........#
#.......#.#
#.........#
#####D#####

2
0
###########
#.........#
#..#......#
#.#.......#
#.........#
#.........D
#.........#
#.........#
#.........#
#.........#
#####d#####

2
2
#####D#####
#.........#
#.........#
#.........#
#....#e#..#
D..####s..D
#..#e####.#
#.....##e.#
#.....###.#
#.........#
#####D#####
enemies 3
switch 0 : 0 1

4
2
#####D#####
#.........#
#......#..#
#.......#.#
#.....#...#
D.........D
#......#..#
#.........#
#......#..#
#.........#
###########

2
1
#####D#####
#.........#
#.........#
#.........#
#.........#
D.........D
#.........#
#.#.....#.#
#..#...#..#
#.........#
#####D#####

4
1
#####D#####
#.........#
#......#..#
#.......#.#
#.........#
d.........D
#.........#
#.......#.#
#......#..#
#.........#
#####D#####

3
3
#####D#####
#..#......#
#...#.....#
#....###..#
#....###..#
d...#e#...D
#...#.#...#
#.........#
#.........#
#.........#
#####D#####
boss
enemies 1

3
4
###########
#........k#
#..#...#..#
#.#.....#.#
#.........#
D.........#
#.........#
#.#.......#
#..#......#
#.........#
###########
key : 5

4
0
#####D#####
#.........#
#..#......#
#.#.......#
#.........#
#.........d
#.........#
#.........#
#.........#
#.........#
#####D#####

3
0
#####d#####
#.........#
#.........#
#.........#
#.........#
#....@....D
#.........#
#.........#
#.........#
#.........#
#####D#####

