8
1
#####d#####
#.........#
#.........#
#.........#
#.........#
#....e....#
#.........#
#.........#
#.........#
#.........#
#####.#####
boss
enemies 1

1
2
###########
##.....#k##
#.........#
#.#.#.....#
#.........#
...#...#..#
#.........#
#.#.#.#.#.#
#.........#
##.#...#.##
###########
key : 2

1
0
###########
#k........#
#......#..#
#.#....##.#
#.........#
#..........
#.........#
#.#.......#
#..#......#
#.........#
#####.#####
key : 1

4
1
#####.#####
#.........#
#.........#
#.#.......#
#.........#
...#.#....#
#.#.##....#
#.#.###...#
#.#...#...#
#.#.......#
#####d#####

3
2
###########
#.........#
#.........#
#.........#
#.........#
..........#
#.........#
#.#.......#
#..#......#
#.........#
###########

3
0
#####.#####
#.........#
#.........#
#...#.....#
#..##.....#
#...@#.....
#....#....#
#.........#
#.........#
#.........#
#####.#####

5
1
#####d#####
#.........#
#.........#
#.........#
#.........#
...........
#.........#
#.......#.#
#......#..#
#.........#
#####d#####

2
0
#####.#####
#.........#
#.....##.##
#......####
#....###..#
#....#.#...
#....#..#.#
#.........#
#.........#
#.........#
#####.#####

7
1
#####.#####
#k........#
##.#...#.##
#.........#
#.....#...#
#.........#
#..#.#.#..#
#.........#
#.#...#.#.#
#.........#
#####d#####
key : 3

4
0
#####.#####
##.#...#.##
#.........#
#...#.#.#.#
#.........#
#..#...#...
#.........#
#...#.....#
#.........#
#........##
#####.#####

1
1
#####d#####
#.........#
##.#...#.##
#.........#
#.#.#.#.#.#
...........
#..#......#
#.........#
#.#.#.#.#.#
#.........#
#####.#####

0
1
###########
#.........#
#..#..#..##
#.........#
#.........#
#.........#
#.........#
#.........#
#..#..#..##
#.........#
#####d#####

9
1
#####.#####
#.........#
#.........#
#...##....#
#..#.#....#
#..#......#
#.........#
#.........#
#.........#
#X........#
###########

3
1
#####.#####
#e#.....#e#
#.........#
#.........#
#..#..#...#
...........
#.........#
#.#.......#
#.........#
#?........#
#####.#####
enemies 2
sign What you seek is close.

6
1
#####d#####
#.........#
#...#..#..#
#.........#
#.........#
#...#..#..l
#.........#
#.........#
##.....#..#
#.........#
#####.#####

6
2
#####.#####
#.........#
#.........#
##..#..#..#
#.........#
l.........#
#...#..#..#
#.........#
#.........#
##.....#..#
###########
locked : 2

5
0
#####.#####
#.........#
#..#.....##
#.........#
#.........#
#..#..#....
#.........#
#.........#
#..#..#..##
#e.e......#
###########
enemies 2

2
1
#####.#####
#.........#
#..#......#
#.##......#
#.........#
..........#
#.........#
#.......#k#
#...#..#..#
#.........#
#####.#####
key : 0

5
2
###########
#.#......e#
#.........#
#.#.#...#?#
#.........#
....#.#...#
#.........#
#.#.#.#.#.#
#.........#
#.......#.#
#####.#####
enemies 1
sign Turn back; you are not yet ready.

