3
2
#####D#####
#.........#
#..#......#
#.#.......#
#.........#
D.....#...#
#.#.......#
#.........#
#..#......#
#.........#
###########

1
3
#####l#####
#.........#
#.........#
#.........#
#..#.#....#
l..##.#...d
#.##......#
#.###.....#
#...#.....#
#.........#
#####D#####
locked : 1

2
2
#####D#####
#.........#
#.........#
#.........#
#...#p....#
D..#......D
#.##p#....#
##..#.....#
##..#.....#
#k........#
#####D#####
key : 3

2
3
#####D#####
#.........#
#.........#
#.........#
#.........#
D.........#
#.........#
#.......#.#
#......#..#
#.........#
###########

2
0
###########
#k........#
#......#..#
#.......#.#
#.........#
#.........D
#.........#
#.#.......#
#..#......#
#.........#
#####D#####
key : 0

1
4
#####D#####
#.........#
#.........#
#.......#.#
#.........#
d.........d
#.........#
#.........#
#.........#
#.........#
###########

4
1
#####d#####
#.........#
#.........#
#.........#
#.........#
D.........#
#.........#
#.........#
#.........#
#.........#
###########

3
1
#####D#####
#e........#
#.........#
#.#..#....#
#.........#
D.........D
#.....#...#
#.........#
#.........#
#.......#e#
#####d#####
enemies 2

1
1
#####d#####
#.........#
#..#......#
#.#.......#
#.........#
#.........D
#.........#
#.#.....#.#
#..#...#..#
#.........#
#####l#####
locked : 0

0
1
###########
#.........#
#.........#
#.........#
#.##......#
#.........D
#.........#
#.........#
#.........#
#.........#
#####d#####

0
3
###########
#.........#
#.........#
#.........#
#.........#
D.........l
#.........#
#.........#
#.........#
#.........#
#####l#####
locked : 3

2
5
#####D#####
#.##......#
#.##......#
#.##......#
#.###.....#
#.........#
#.........#
#.........#
#.........#
#X........#
###########

0
2
###########
#.........#
#..#...#..#
#.........#
#..#.#.#..#
D.........D
#..#.#....#
#.........#
##.#...#.##
#k........#
#####D#####
key : 2

3
0
#####D#####
#.........#
#.........#
#.........#
#.........#
#....@....D
#.........#
#.........#
#.........#
#.........#
#####D#####

4
0
#####D#####
#.........#
##.....#..#
#.......#.#
#.........#
#......#..D
#.........#
#.......#.#
#......#..#
#.........#
###########

2
1
#####l#####
#.........#
#......#..#
#.......#.#
#.........#
D.........D
#.........#
#.........#
#.........#
#.........#
#####D#####

0
4
###########
#.........#
#...#.#...#
#.....#...#
#.........#
l.........#
#.........#
#.........#
#.........#
#.........#
#####D#####
locked : 2

1
2
#####D#####
#k........#
#.........#
#.........#
#.........#
D.........l
#.........#
#..p......#
#.........#
#.........#
#####D#####
key : 1

1
5
###########
#.........#
#####.....#
##.##.....#
#.........#
d..#.e....#
#.#.......#
#.........#
#.........#
#.......#.#
#####D#####
boss
enemies 1

