3
0
#####l#####
#e#.....#?#
#.........#
#.#.#.#.#.#
#.........#
#.....#...D
#.........#
#.#.#.#...#
#.........#
#s#.......#
#####D#####
enemies 1
switch 0 : 0
sign A locked path — look elsewhere first.

4
0
#####D#####
#.........#
#.........#
#.........#
#.........#
#?...@....D
#.........#
#.........#
#.........#
#.........#
#####D#####
sign A useful tool lies just ahead.

6
2
#####D#####
###.......#
##..#..##.#
##.#k..##.#
#..#####..#
D..##..p..D
#.........#
#.........#
#.........#
#......p..#
#####d#####
key : 3

8
2
#####D#####
#......#..#
#.....#...#
#..#.#....#
#..#####..#
#..####...#
#...####..#
#.....##..#
#.........#
#X........#
###########

7
2
#####d#####
#.........#
#.........#
#.........#
#...#.....#
#..##e....#
#.##......#
###.......#
###.......#
#.........#
#####D#####
boss
enemies 1

0
0
###########
#e.......e#
#e#.#.#.#.#
#.........#
#.#.....#.#
#.........#
#.#.#.#...#
#.........#
#.#...#.#.#
#.........#
#####D#####
enemies 3
door 0 : 0

4
2
###########
#.........#
#.........#
#.........#
#.........#
D.........#
#.........#
#.........#
#.........#
#.........#
#####l#####
locked : 3

2
0
#####D#####
#.........#
#.........#
#.........#
#.........#
#.........D
#.........#
#.#.......#
#..#......#
#.........#
#####l#####
locked : 0

5
3
###########
#.......ee#
#..#......#
#...#.....#
#.##......#
D...#.....#
#.#.......#
#.#.......#
#.........#
#......#..#
#####D#####
enemies 2

5
1
#####d#####
#.........#
##.....#.##
#.........#
#.#.#...#.#
D.........d
#..#...#..#
#.........#
#.........#
#.........#
#####D#####

5
2
#####l#####
#.........#
#..#......#
#.#.......#
#.........#
d.........D
#.........#
#.#.......#
#..#......#
#.........#
#####D#####

6
3
#####D#####
#.........#
#.........#
#.........#
#.........#
D.....p...#
#....p....#
#.........#
#.........#
#........k#
###########
key : 5

3
1
#####d#####
#.........#
#......#..#
#.......#.#
#...#.....#
D.........#
#.#.......#
#.#.......#
#..#......#
#.........#
#####D#####

6
1
#####D#####
#.........#
#.........#
#...#.....#
#.##......#
#..#......D
#..#......#
#.........#
#.........#
#.........#
###########

5
0
#####D#####
#.........#
#.#.#.#.#.#
#.........#
#..#.#.#..#
#.........D
#.#.#.#.#.#
#.........#
#..#...#.##
#k........#
###########
key : 0

2
1
#####D#####
#.........#
#......#..#
#.......#.#
#.........#
D.........#
#.........#
#.#.....#.#
#..#...#..#
#.........#
#####d#####

1
1
###########
#.........#
#.........#
#.........#
#.........#
D.........#
#.........#
#.........#
#.........#
#.........#
#####D#####

1
0
#####D#####
#.........#
#.........#
#.........#
#.........#
#k........D
#.........#
#.........#
#.........#
#.........#
#####D#####
key : 1

4
1
#####D#####
#.........#
#.#.....#.#
#.........#
#.........#
D....#....D
#.........#
#.........#
#.#.......#
#.........#
#####d#####

