2
0
#####D#####
#.........#
#.........#
#.........#
#.........#
#....@....D
#.........#
#.........#
#.........#
#.........#
#####D#####

3
0
#####D#####
#.........#
#.#.#.#.#.#
#.........#
#k#.#.#...#
#.........D
#.#.#.#.#.#
#.........#
#.#.#.#.#.#
#.........#
#####l#####
key : 1

1
1
#####D#####
#.........#
#......#..#
#.......#.#
#.........#
d.........l
#.........#
#.........#
#.........#
#.........#
#####D#####

5
0
#####l#####
#.........#
#.........#
#.........#
#.........#
#.........D
#.........#
#.........#
#.........#
#.........#
#####D#####
locked : 0

1
0
#####D#####
#.........#
#.........#
#..#..#..##
#.........#
#.........d
#...#..#..#
#.........#
#.........#
#..#.....##
#####D#####

1
2
###########
#.........#
#.........#
#.........#
#.........#
l.........#
#.........#
#.#.......#
#..#......#
#.........#
###########
locked : 2

5
2
###########
#........e#
##.#...#.##
#.........#
#..#.#.#..#
D.........#
#..#.#....#
#.........#
##.....#.##
#........?#
###########
enemies 1
sign Many have walked this path.

2
1
#####D#####
#.........#
#..#......#
###.......#
#....#....#
D........k#
#.........#
#.........#
#.........#
#.........#
#####D#####
key : 0

7
0
#####D#####
#.........#
#......#..#
#.......#.#
#.........#
#.........D
#.........#
#.......#.#
#......#..#
#.........#
###########

0
1
###########
#.........#
#.#.#.....#
#.#.......#
#.###.....#
D..##.....#
#..##.....#
#.........#
#.........#
#.........#
#####D#####

0
0
###########
#k........#
#..#......#
#.##......#
#.........#
#.........D
#.........#
#.......#.#
#......#..#
#.......#.#
#####D#####
key : 2

6
1
#####D#####
#.........#
#.........#
#.........#
#.........#
d....ep...#
#.........#
#.........#
#..p......#
#.........#
#####D#####
boss
enemies 1

5
1
#####d#####
#.........#
#.........#
#.........#
#.........#
D.........D
#.........#
#.#.......#
#.........#
#......#..#
#####D#####

3
1
#####D#####
#k........#
#.........#
#.........#
#.........#
D.........l
#.........#
#.........#
#.........#
#.........#
#####D#####
key : 3

4
1
#####D#####
#.........#
#.........#
#.........#
#.........#
D.........#
#.........#
#.#.....#.#
#..#...#..#
#.........#
#####d#####

6
0
#####D#####
#.........#
#.........#
#.........#
#.........#
#.........d
#.........#
#.........#
#.........#
#.........#
#####D#####

3
2
###########
#.........#
##.#...#..#
#.........#
#....#....#
l.........#
#..#.#.#..#
#.........#
##.#...#.##
#.........#
###########
locked : 1

7
1
#####D#####
#.........#
#.........#
#.#.......#
#.##......#
D..#......#
#.........#
#.........#
#.........#
#........X#
###########

4
0
#####l#####
##.......##
#.........#
#.#.......#
#.........#
#..#.#.#..D
#.........#
#...#.....#
#.........#
##.#...#..#
#####l#####
locked : 3

