3
3
###########
#........e#
#.........#
#..#..#...#
#....###..#
D....#s#..#
#..###....#
#..####...#
#.....###.#
#.........#
#####D#####
enemies 1
switch 0 : 0

5
0
#####D#####
#.........#
#..#...#.##
#.........#
#..#...#..#
#.........#
#..#...#..#
#.........#
##.#...#.##
#.........#
###########

1
2
###########
#..#......#
#.###.....#
#.#.#.....#
#.#.#.....#
D.........#
#.........#
#.........#
#.........#
#.........#
#####D#####

4
2
#####l#####
#.........#
#.........#
#.........#
#.........#
D.........D
#.........#
#.........#
#.........#
#.........#
#####d#####
locked : 3

2
2
#####D#####
#k#.....#.#
#.........#
#.#.#.#...#
#.........#
D.....#...#
#.........#
#.#.#.#.#.#
#.........#
#.......#.#
#####D#####
key : 1

1
1
###########
#......#..#
#...#..##.#
#...####..#
#...#...#.#
D....#.#..D
#.........#
#.........#
#.........#
#.........#
#####d#####

2
1
#####d#####
##.....#..#
#.........#
#.........#
#.#..#....#
D.........D
#.........#
##..#..#..#
#.........#
#k........#
#####D#####
key : 0

2
0
#####d#####
#.........#
##.#......#
##.##.....#
#?#.......#
#..##@....D
#.#.......#
#...p.....#
#.........#
#.........#
#####D#####
sign Those who search shall find.

1
0
#####D#####
#.#.....#.#
#.........#
#.#.#...#.#
#.........#
#...#.#...D
#.........#
#.#.#.#.#.#
#.........#
#.#.....#.#
#####d#####

4
4
###########
#.##.....e#
#.........#
#..##.....#
#.........#
D.........#
#.........#
#.........#
#.........#
#........e#
###########
enemies 2

5
2
#####d#####
#.........#
#.........#
#.........#
#.........#
#....e....#
#.........#
#.........#
#.........#
#.........#
#####D#####
boss
enemies 1

3
1
#####D#####
#.........#
#.......#.#
#.........#
#.........#
D..#..#...D
#.........#
#.........#
#.#.....#.#
#.........#
#####D#####

3
0
#####D#####
#.........#
##..#..#..#
#.........#
#.........#
#....#....D
#.........#
#.........#
##..#.....#
#.........#
#####D#####

4
1
#####D#####
#.........#
#.#.#.....#
#..##.....#
#.###.....#
d.........D
#....#....#
##...#....#
#.........#
#.........#
###########

0
0
###########
#k#.......#
#.........#
#.........#
#..#..#...#
#.........#
#.........#
#.......#.#
#.........#
#.........#
#####D#####
key : 3

3
2
#####D#####
#e........#
#.........#
#.........#
#.p.......#
D.........D
#.........#
#.........#
#.........#
#.........#
#####l#####
enemies 1

4
3
#####D#####
#e........#
#.........#
#.........#
#.........#
D.........D
#.........#
#.........#
#.........#
#....e....#
###########
enemies 2
door 0 : 0

6
2
#####D#####
####......#
#..#......#
#..#......#
#.........#
#.........#
#.........#
#.........#
#.........#
#X........#
###########

4
0
#####D#####
#.........#
#.........#
#.........#
#.........#
#.........d
#.........#
#k#.....#.#
#..#...#..#
#.........#
#####D#####
key : 2

