4
0
#####l#####
#.........#
#.........#
#.........#
#.........#
#....e....#
#.........#
#.........#
#.........#
#.........#
#####D#####
locked : 3
boss
enemies 1

0
4
###########
#........e#
##..#..#..#
#.........#
#.........#
D...#..#..#
#.........#
#.........#
##..#..#..#
#.........#
#####D#####
enemies 1
door 0 : 0 1

0
0
###########
#.........#
#.........#
#.#..#..#.#
#.........#
#.........D
#..#..#...#
#.........#
#.........#
#.......#.#
#####l#####
locked : 0

2
2
#####D#####
#......#..#
#.........#
#.........#
#......#..#
D........k#
#.........#
##..#.....#
#.........#
#.........#
#####D#####
key : 3

3
3
###########
#.##.....e#
#.#.#.....#
#.#.......#
#.........#
D.........#
#.........#
#.........#
#.........#
#.........#
###########
enemies 1
door 1 : 2 3

0
1
###########
#.........#
#......#..#
#.........#
#...##....#
D..##k....D
#....#....#
#.......#.#
#.........#
#.........#
#####D#####
key : 2

5
0
#####D#####
#.........#
#.........#
#.........#
#.........#
#.........#
#.........#
#.........#
#.........#
#X........#
###########

1
3
#####D#####
##.#...#.##
#.........#
#.#.#.#.#.#
#.........#
d..#.#.#..D
#.........#
#.#.#.#.#.#
#.........#
##.#...#..#
###########

3
2
#####D#####
#e........#
#.........#
#.......#.#
#.........#
D.........D
#.........#
#.........#
#.........#
#s?..e....#
###########
enemies 2
switch 1 : 2 3
sign Something glints behind that door…

3
0
#####l#####
#.........#
#.#.#.#.#.#
#.........#
#.#.#.#.#.#
#.........D
#...#...#.#
#.........#
#...#.#.#.#
#.........#
#####l#####
locked : 2

1
0
#####l#####
#.........#
#.........#
#.........#
#.........#
#....@....D
#..#......#
#.........#
#.........#
#.........#
#####D#####

2
0
#####D#####
#.........#
#.........#
#....#..#.#
#.........#
#.........D
#..#..#...#
#.........#
#.........#
#k#.....#.#
#####l#####
key : 1

3
1
#####D#####
##.....#..#
#.........#
#.........#
#.#.....#.#
D.........D
#.........#
##.....#..#
#.........#
#.........#
###########

1
2
#####d#####
#.........#
#.........#
#.........#
#.........#
l.........d
#.........#
#.........#
#.........#
#.........#
#####D#####
locked : 1

1
4
#####D#####
#.........#
#.........#
#.........#
#.........#
D.........#
#.........#
#.........#
#.........#
#.........#
###########

0
2
###########
#.........#
#.........#
#.........#
#.........#
D.........D
#.........#
#.#....##.#
#..#...#..#
#.........#
#####d#####

1
1
#####D#####
#k.#.....##
#.........#
#.........#
#..#......#
D.........l
#.........#
#..#..#..##
#.........#
#.........#
#####D#####
key : 0

0
3
###########
#e.?se....#
#.........#
#..##.....#
#.##......#
D.........D
#.........#
#.........#
#.........#
#e........#
#####D#####
enemies 3
switch 0 : 0 1
sign The dungeon remembers all who enter.

2
1
#####D#####
#.........#
#...#.....#
#...#.#...#
#...##....#
D.........D
#.........#
#.##......#
#.........#
#.........#
#####D#####

