5
0
#####l#####
#.........#
#..#...#..#
#.#.....#.#
#.........#
#.........#
#.........#
#.#.....#.#
#..#...#..#
#.........#
###########
locked : 0

2
0
#####.#####
#.........#
#.........#
#.........#
#..#......#
#..#.@.....
#.#.#.....#
#.........#
#.........#
#.........#
#####.#####

0
0
###########
#.........#
#......#..#
#.......#.#
#.........#
#.........#
#.........#
#.#.....#.#
#..#...#..#
#.........#
#####.#####

1
0
#####.#####
#.........#
#..#......#
#k#.......#
#.........#
#..........
#.........#
#.#.....#.#
#..#...#..#
#.........#
#####.#####
key : 0

4
0
#####.#####
#.........#
#..#......#
#.#.......#
#.........#
#..........
#.........#
#.#.....#.#
#..#...#..#
#.........#
#####l#####

2
2
#####.#####
#.........#
#......#..#
#.......#.#
#.........#
...........
#.........#
#.#.....#.#
#..#...#..#
#..k......#
###########
key : 1

2
1
#####d#####
#.......#.#
#.....#...#
#....##...#
#...##....#
......##...
#.......#.#
#.....#.#.#
#.........#
#.........#
#####l#####

3
4
#####.#####
#.........#
#.........#
#.........#
#.........#
#.........#
#.........#
#.........#
#.........#
#X........#
###########

3
0
#####.#####
#.........#
#.........#
#.........#
#.........#
#..........
#.........#
#.........#
#.........#
#.........#
#####.#####

1
2
###########
#.k.......#
#.#.......#
#.........#
#.........#
.....#....l
#.........#
#.........#
#.#.....#.#
#.........#
#####.#####
key : 3

1
1
###########
#.........#
#.........#
#.........#
#.........#
...........
#....###..#
#.........#
#.......#.#
#.........#
#####d#####

3
1
#####l#####
#..#...#..#
#..##.#...#
#...##....#
#...##....#
...##.....#
#..##.....#
##.#......#
#.#.......#
#.........#
#####.#####
locked : 1

1
3
#####.#####
##........#
#.........#
#..#.#.#.##
#.........#
l..#...#..d
#.........#
##.#.#.#.##
#.........#
##.#...#..#
#####.#####
locked : 3

1
4
###########
#.........#
#..#......#
#.#.......#
#.........#
d.........d
#.........#
#.#.......#
#..#..#...#
#.........#
#####d#####

1
5
###########
#.........#
#.........#
#.#.#.#...#
#.........#
d...#.#...#
#.........#
#.#.#.#.#.#
#.........#
#.#.....#.#
###########

2
3
#####.#####
#.........#
#..#......#
#.#.......#
#.........#
...........
#.........#
#.#.....#.#
#..#...#..#
#.........#
###########

4
1
#####.#####
#.......#.#
#..#...#..#
#.#.....#.#
#.........#
..........#
#.........#
#.........#
#.........#
#.......k##
###########
key : 2

2
4
#####d#####
#.........#
#.........#
#.........#
#.........#
.....e....#
#.........#
#.........#
#.........#
#.........#
#####.#####
boss
enemies 1

0
3
###########
#.........#
#......#..#
#.......#.#
#.........#
#.........#
#.........#
#.#.......#
#..#......#
#.........#
#####.#####

