4
0
#####.#####
#.........#
#.........#
#.........#
#.........#
#?...@.....
#.........#
#.........#
#.........#
#.........#
#####.#####
sign Those who search shall find.

4
2
#####l#####
#.........#
#.........#
#.........#
#.........#
..........#
#.........#
#.........#
#.........#
#.........#
###########
locked : 2

3
3
#####d#####
##.#...#..#
#.........#
#..#...#.##
#.........#
.....#.#...
#.........#
#..#...#.##
#.........#
##e#...#e##
###########
enemies 2

2
3
#####.#####
#.........#
#..##.....#
#..###....#
#.........#
.....e....#
#.....#.#.#
#.....##..#
#.....###.#
#.........#
#####d#####
boss
enemies 1

2
1
#####.#####
#k........#
#......#..#
#.......#.#
#.........#
...........
#.........#
#.#.....#.#
#..#...#..#
#.........#
#####.#####
key : 1

1
1
###########
#e...e....#
#.........#
#.........#
#.........#
...........
#.........#
#.........#
#.........#
#.........#
#####.#####
enemies 2

3
2
#####d#####
#k........#
#.........#
#.........#
#.........#
...........
#.........#
#.#.......#
#..#......#
#.........#
#####l#####
key : 2

1
3
###########
#........X#
#.#.#.#...#
#.#...#...#
#.##.#....#
...###....#
#..#..#...#
#.........#
#.........#
#.........#
#####.#####

3
0
#####d#####
#.........#
#..#......#
#.#.......#
#.........#
#.........l
#.........#
#.......#.#
#......#..#
#.........#
#####.#####

2
0
#####.#####
#......#..#
##.#......#
#.#.......#
#.........#
#..........
#.#.......#
#.#.....#.#
#..#...#..#
#.........#
#####d#####

3
4
###########
#........k#
#.........#
#.........#
#.........#
..........#
#.........#
#.........#
#.........#
#.........#
###########
key : 4

5
0
#####.#####
##.#...#.##
#.........#
##.#.#.#.##
#.........#
#......#..#
#.........#
##.....#.##
#.........#
##........#
#####d#####

4
1
#####.#####
#.........#
#.........#
#.........#
#.........#
...........
#.........#
#.........#
#.........#
#....k....#
###########
key : 0

1
0
#####.#####
#.........#
#.........#
#.....#..##
#.........#
#..........
#...#.....#
#.........#
#.........#
#........##
#####.#####

0
0
###########
#.........#
#..#...#..#
#.#.....#.#
#.........#
#.........#
#.#.......#
#........##
#.........#
#.........#
#####.#####

1
2
###########
#.........#
#.........#
#..#..#..##
#.........#
...........
#..#..#...#
#.........#
#.........#
#..#......#
#####.#####

3
1
#####.#####
#.........#
#.........#
#.........#
#.........#
l..........
#.........#
#.#.......#
#..#......#
#.........#
#####.#####
locked : 0

2
2
#####.#####
#.........#
#.........#
#.........#
#.........#
...........
#.........#
#.........#
#.........#
#.........#
#####d#####

6
0
#####d#####
#.........#
##.#...#..#
#.........#
#....#.#..#
#.........#
#..#.#....#
#.........#
##.#...#..#
#.........#
###########

