3
1
#####D#####
#.........#
#.........#
#######...#
#.#.###...#
D....##...#
#.........#
#.........#
#.........#
#........k#
###########
key : 2

1
2
#####D#####
#.......#.#
#.........#
#.........#
#..#..#...#
l.........D
#.........#
#....#..#.#
#.........#
#.........#
#####D#####
locked : 0

1
3
#####D#####
#.........#
#..#...#..#
#.##....#.#
#.........#
D.........#
#.........#
#..#......#
#.........#
##........#
#####D#####

1
1
#####D#####
#.........#
#...#.....#
#....#....#
#.........#
D...#.#...l
#...k#.##.#
#...##.#..#
#.......#.#
#.........#
#####D#####
key : 1

2
2
#####D#####
#.........#
#.........#
#.........#
#....#..#.#
D....###..D
#.###k#.#.#
#..##.#...#
##......#.#
#.........#
###########
key : 3

2
1
#####D#####
#.........#
#.........#
#.........#
#.........#
D.........D
#...#.....#
#...k#....#
#...#.#...#
#.........#
#####D#####
key : 0

0
0
###########
#.........#
#......#..#
#.......#.#
#.........#
#.........D
#.........#
#.#.....#.#
#..#...#..#
#.........#
#####d#####

0
3
###########
#......see#
#........e#
#.........#
#.........#
D.........#
#.........#
#.........#
#.........#
#.........#
#####D#####
enemies 3
switch 0 : 0

2
0
#####D#####
#?#.......#
#.....#...#
#..####...#
#..#.#....#
#....@....D
#.........#
#.........#
#.........#
#.........#
#####D#####
sign A useful tool lies just ahead.

3
3
#####l#####
#.........#
#.........#
#.........#
#.........#
#.........D
#.........#
#.........#
#.........#
#.........#
#####d#####
locked : 2

2
4
###########
#.........#
#.........#
#.........#
#.........#
d.........#
#.........#
#.........#
#.........#
#.........#
#####D#####

4
3
#####d#####
#.........#
#.........#
#.........#
#.........#
#....e....#
#.........#
#.........#
#.........#
#.........#
#####D#####
boss
enemies 1

0
1
###########
#.........#
#.........#
#.........#
#.........#
D.........d
#.........#
#.........#
#.........#
#.........#
#####D#####

0
2
###########
#.........#
#..#......#
#.#.......#
#.........#
d......#..D
#.........#
#.#.......#
#..#......#
#.........#
#####D#####

3
4
#####D#####
#.........#
#.........#
#...#.....#
#.........#
D..##..#..#
#...##?#..#
#..####...#
#..#..#...#
#........e#
###########
enemies 1
door 0 : 0
sign Only the prepared may pass.

5
3
#####D#####
#.........#
#.........#
#.........#
#....#.#..#
#....#.#..#
#....###..#
#....###p.#
#..p..#...#
#X........#
###########

3
0
#####D#####
##.......##
#.........#
#.#.#.#.#.#
#.........#
#..#.#.#..D
#.........#
#.#.#.#.#.#
#.........#
##.#...#.##
###########

2
3
#####D#####
#.........#
#.....##.##
#....######
#.....###.#
D....###..d
#....###..#
#.........#
#.........#
#.........#
#####l#####

1
0
#####d#####
#.#.....#.#
#.........#
#.#...#...#
#.........#
#...#.....D
#.........#
#.#...#.#.#
#.........#
#.#.....#.#
#####D#####

