3
0
#####D#####
#p........#
#.........#
#.#.#.....#
#.........#
#...#@##..D
#?##..#...#
##....#####
#......#..#
#.........#
#####D#####
sign Beware what lurks ahead.

5
0
#####D#####
#.........#
#......#..#
#.......###
#.........#
#.........#
#.........#
#.........#
#.....#...#
#k........#
###########
key : 2

2
3
###########
#........k#
##.#...#.##
#.........#
#...#.#.#.#
D.........#
#..#.#.#..#
#.........#
#...#.#...#
#.........#
#####D#####
key : 7

5
3
#####D#####
#.........#
#.........#
#.........#
#.........#
D..##.....#
#...#.....#
#.##......#
#.........#
#........X#
###########

4
2
#####D#####
#......#..#
#.........#
#.........#
#.........#
D.........D
#.........#
#.#.....#.#
#..#...#..#
#.........#
#####d#####

4
3
#####d#####
#.#.......#
#..#......#
##..##....#
#..#......#
D...#e.#..#
#.....#.#.#
#....#..#.#
#......#..#
#......#..#
#####D#####
boss
enemies 1

4
1
#####D#####
#.#.......#
#.........#
#.#...#.#.#
#.........#
d...#.#...D
#.........#
#...#.#...#
#.........#
#.#.....#.#
###########

2
2
#####D#####
#.........#
#......#.##
#.........#
#.#.#.#.#.#
l.........D
#..#.#.#..#
#.........#
#.#...#.#.#
#.........#
#####D#####
locked : 1

4
0
#####D#####
##........#
#e........#
#.........#
#....#..#.#
#e........d
#.........#
#...#..#..#
#.........#
#.........#
#####D#####
enemies 2

1
0
###########
#k........#
#.........#
#.........#
#.#.......#
#..##.....D
#..##.....#
#.###.....#
###.#.....#
#.........#
#####D#####
key : 1

2
1
#####D#####
##........#
#.........#
#..#.#.#.##
#.........#
D..#.#.#..l
#.........#
##.#.#.#.##
#.........#
##.#...#..#
#####D#####

1
2
#####D#####
#.........#
#.........#
#....###..#
#..##.....#
D..#.....e#
#....#....#
#.........#
#.........#
#.........#
#####D#####
enemies 1

3
3
#####D#####
#.........#
#......#..#
#.......#.#
#.........#
d.........#
#.........#
#.#.....#.#
#..#...#..#
#.........#
#####d#####

3
2
#####D#####
#e........#
#.........#
#.........#
#.........#
D.........d
#.........#
#.........#
#.........#
#e........#
#####D#####
enemies 2

1
1
###########
##.....#k##
#.........#
##.#...#..#
#.........#
D....#.#..D
#.........#
##.#.#.#.##
#.........#
##.#...#.##
#####D#####
key : 3

5
2
#####d#####
#.........#
#......#..#
#.......#.#
#.........#
#.........D
#.........#
#.........#
#.........#
#.........#
###########

2
0
#####D#####
#.#.......#
#.........#
#.........#
#.#..#..#.#
#.........D
#.........#
#.........#
#.........#
#.........#
#####D#####

0
2
###########
#.........#
#.........#
#.........#
#.........#
#.........#
#.........#
#.........#
#.........#
#.........#
#####D#####

3
1
#####D#####
#.........#
#.........#
#.........#
#.....#...#
D.....#...D
#.......#.#
#.........#
#.........#
#.........#
#####D#####

