2
1
#####D#####
#.........#
#..#......#
#.#.......#
#.........#
D.........D
#.........#
#.#.......#
#..#......#
#..k......#
###########
key : 1

2
3
#####D#####
#.........#
#.........#
#.........#
#.........#
D.........#
#.........#
#.........#
#.........#
#........X#
###########

1
4
###########
#.........#
#.........#
#.........#
#.........#
D.........#
#.........#
#.#.....#.#
#..#...#..#
#.........#
###########

2
2
#####d#####
#.........#
#.........#
#.........#
#....#....#
D..#.#....D
#.#.###...#
#.........#
#..##.....#
#.........#
###########

4
0
#####D#####
#.........#
#......#..#
#.......#.#
#..#......#
#.........D
#s#.......#
#?#.....#.#
#..#...#..#
#.........#
#####D#####
switch 0 : 0 1
sign Those who search shall find.

6
0
#####D#####
#.#.....#.#
#.........#
#.........#
#.#.......#
#.........D
#.........#
#.#..#..#.#
#.........#
#k........#
###########
key : 3

4
1
###########
#........e#
#..#..#..##
#.........#
#.........#
D..#..#...#
#.........#
#.........#
#.....#..##
#.........#
#####D#####
enemies 1
door 0 : 0 1

1
1
###########
#.........#
#..#...#..#
#.#.....#.#
#.........#
d.........l
#.........#
##........#
#.........#
#......#..#
#####D#####

0
0
###########
#k........#
#.........#
#.........#
#.........#
#.........#
#.........#
#.#.....#.#
#..#...#.##
#.........#
#####D#####
key : 0

5
0
#####D#####
#.........#
#.........#
#.#.....#.#
#.........#
#.........D
#.......#.#
#.........#
#.........#
#.......#k#
#####D#####
key : 2

0
3
###########
#e.......s#
#.........#
#.........#
#.........#
#.........#
#.###.....#
#.#.......#
#.........#
#.........#
#####D#####
enemies 1
switch 1 : 2 3

5
1
#####D#####
#e#.....#.#
#.........#
#..#.#.#.##
#.........#
D...#.#...D
#.........#
#..#.#.#..#
#.........#
#?#.....#.#
#####D#####
enemies 1
sign A useful tool lies just ahead.

1
3
#####D#####
#.........#
#.p.......#
#.........#
#.........#
l....e....D
#.........#
#.........#
#.........#
#.p.......#
#####D#####
locked : 0
boss
enemies 1

2
0
#####D#####
#.........#
#......#..#
#.......#.#
#.........#
#..#......D
#.........#
#.#.....#.#
#..#...#..#
#.........#
#####D#####

5
2
###########
#.........#
#..#...#..#
#.#.....#.#
#.........#
D.........#
#.........#
#.........#
#.........#
#.........#
###########
door 1 : 2 3

1
2
###########
##.....#..#
#.........#
#.........#
#.#..#..#.#
l.........l
#.........#
##..#..#..#
#.........#
#.........#
#####d#####
locked : 1

3
0
#####D#####
#.........#
#.###.....#
#####.....#
#..#.#....#
#..#......#
#....#....#
#.........#
#.........#
#.........#
#####D#####

1
0
#####D#####
#.........#
#.........#
#.........#
#...@.....#
#....#....d
#.####....#
#####.....#
#...#.....#
##........#
#####D#####

6
1
#####D#####
#.........#
#.........#
#p.......p#
#.........#
D.........#
#.........#
#.........#
#........?#
#.......ee#
###########
enemies 2
sign A useful tool lies just ahead.

