5
2
#####.#####
#........k#
#..#...#.##
#.........#
#.#.....#.#
...........
#..#.#.#..#
#.........#
#.#.....#.#
#.........#
###########
key : 1

2
2
###########
#....X....#
#.........#
#.........#
#.###.....#
....#......
#.........#
#.........#
#.........#
#.........#
###########

4
2
###########
#.........#
#.......#.#
#.........#
#.........#
l..........
#.........#
#.........#
#.#.....#.#
#.........#
#####.#####
locked : 0

4
3
#####.#####
#e.......e#
#.....#...#
#....#....#
#.......#.#
..........d
#.........#
#.........#
#.......#.#
#e.......s#
#####.#####
enemies 3
switch 0 : 0 1

3
0
###########
#.........#
#.........#
#.........#
#.......#.#
#..........
#.....#...#
#.....#...#
#......##.#
#.........#
#####.#####

6
1
#####.#####
#.........#
#......#..#
#......#..#
#.........#
#..#......#
#..#......#
##.#......#
#.........#
#.........#
###########

4
4
#####.#####
#.........#
#..##.....#
#..##.....#
#.###.....#
d.....##..#
#.....#...#
#......#..#
#.........#
#.........#
###########

3
3
#####l#####
#.........#
##.#...#..#
#.........#
#....#.#..#
#..........
#..#.#....#
#.........#
##.#...#.##
#.........#
#####.#####

3
4
#####.#####
#e........#
#.........#
#..##.#...#
#.........#
...#.....e#
#..e##....#
#..###....#
#.........#
#.........#
#####.#####
enemies 3

2
1
###########
#.........#
#.#.#.#.#.#
#.........#
#..#......#
#..........
#.....#...#
#.........#
#..#...#..#
#.........#
#####d#####

4
1
#####.#####
#k........#
##........#
#.###.....#
#..###....#
..........l
#.........#
#.........#
#.........#
#.........#
#####d#####
key : 0

1
3
#####.#####
#.........#
#.........#
#.......#.#
#.........#
#.........#
#e#.....#.#
#.........#
#.........#
#?#.....#.#
#####.#####
enemies 1
door 0 : 0 1
sign Turn back; you are not yet ready.

0
3
###########
#.........#
#.........#
#...#.....#
#.........#
#.........#
#.........#
#.#.#.....#
#..#......#
#.........#
#####.#####

3
1
#####d#####
#......#..#
#.........#
#.........#
#....#....#
..........#
#.........#
##..#..#..#
#.........#
#.........#
#####.#####

5
3
#####.#####
#.........#
#.........#
#.........#
#.........#
....###...#
#...##..#.#
#...##....#
#...#.#...#
#.....k#..#
###########
key : 2

4
0
#####.#####
#.........#
###.......#
#####.....#
#.#.#.....#
#....@.....
#.#.#.....#
#.........#
#.........#
#?........#
###########
sign A useful tool lies just ahead.

2
3
#####.#####
#.........#
#.........#
#.........#
#.........#
.....e.....
#.........#
#.........#
#.........#
#.........#
#####l#####
locked : 1
boss
enemies 1

5
1
#####d#####
#.........#
#.........#
#.........#
#.........#
#..#.......
#.........#
##........#
#.........#
#.........#
#####.#####

2
4
###########
#......#.k#
#.........#
#.........#
#.........#
..........#
#.........#
#.........#
#......#..#
#.........#
#####.#####
key : 5

