5
2
#####.#####
#.........#
#.##......#
#.........#
#.#.###...#
.....##...#
#..#.#....#
#.........#
#.........#
#.........#
###########

5
1
#####l#####
#.........#
#.........#
#.........#
#.........#
...........
#.........#
#.......#.#
#......#..#
#.........#
###########
locked : 2

3
0
#####.#####
#.........#
#.........#
#.........#
#.........#
#....@.....
#.........#
#.........#
#.........#
#.........#
#####.#####

2
2
#####.#####
#.........#
#...#..#..#
#....###..#
#...e#....#
.....#.....
#...##.#..#
#.........#
#.........#
#.........#
#####d#####
boss
enemies 1

2
3
###########
#.......ee#
#........e#
#.........#
#.........#
..........#
#.........#
#.........#
#.........#
#.........#
#####.#####
enemies 3

0
2
###########
#X........#
#.........#
#.........#
#.........#
#.........#
#.........#
#.........#
#.........#
#.........#
#####.#####

5
0
#####.#####
#.........#
#.........#
#.#..#....#
#.##......#
#...#......
#k####....#
##..#.....#
#..#......#
#.........#
###########
key : 1

1
2
#####.#####
#.........#
#.........#
#.........#
#.........#
..........#
#.........#
#.......#k#
#......#..#
#.........#
#####.#####
key : 3

3
2
#####d#####
#.........#
#.........#
#.........#
#.........#
d.........l
#.........#
#.........#
#.........#
#.........#
#####.#####

3
3
#####.#####
#.........#
#.........#
##..#..#..#
#.........#
l.........#
#.#..#..#.#
#.........#
#.........#
##........#
#####.#####
locked : 0

1
1
###########
#.........#
#.........#
#.........#
#...#..#..#
d..........
#.........#
#.#.......#
#..#......#
#.........#
#####.#####

2
0
#####.#####
#k........#
##.#...#.##
#.........#
#..#.#.#..#
#..........
#..#.#....#
#.........#
#..#.....##
#.........#
#####.#####
key : 0

4
3
#####.#####
#.........#
#.##......#
#.#.#.....#
#.#..#....#
..........#
#..#......#
#.........#
#.........#
#.........#
###########

2
1
#####.#####
##.#...#.##
#k........#
##.#.#...##
#.........#
...#.#.#...
#.........#
##.#.#.#.##
#.........#
##.#.....##
#####.#####
key : 2

4
0
#####.#####
#.........#
#..#..#..##
#.........#
#.........#
#..#..#...d
#.........#
#.........#
#..#......#
#.........#
#####.#####

4
2
#####.#####
#.........#
#.........#
#.........#
#.........#
l..........
#.........#
#.........#
#.........#
#.........#
#####.#####
locked : 1

4
1
#####.#####
#.........#
#.........#
##........#
#.........#
d.........l
#.........#
#.........#
#.........#
#......#..#
#####l#####

3
1
#####.#####
#.........#
#...#.#...#
#.........#
#.#.#.#.#.#
..........d
#.#.#.#.#.#
#.........#
#.#...#.#.#
#.........#
#####.#####

1
0
###########
#e........#
#e........#
#.........#
#.........#
#..###....d
#e####....#
######....#
#####.....#
####......#
#####.#####
enemies 3

