2
2
#####d#####
#.........#
#.........#
#.........#
#.........#
d.....##..D
#....#.#..#
#.........#
#.........#
#.........#
#####D#####

3
0
###########
#.........#
#...#.....#
#.........#
#.##......#
#..#.@....D
#.##......#
#.........#
#.........#
#.........#
#####D#####

1
1
###########
#k#.....#.#
#.........#
#.........#
#....#..#.#
#.........D
#.........#
#.#.....#.#
#.........#
#.........#
#####D#####
key : 2

3
2
#####D#####
#.........#
#..#...#.##
#.........#
#..#...#..#
D.........D
#..#.#.#..#
#.........#
##.#.....##
#.........#
#####D#####

6
1
#####D#####
#.........#
#.........#
#..###.#..#
#..####...#
#....##...#
#..#......#
#..##.#...#
#.........#
#e.......s#
###########
enemies 1
switch 0 : 0

5
1
#####D#####
#.......#.#
#.........#
#...#.#.#.#
#.........#
D...#.....#
#.........#
#.#.#.....#
#.........#
#.#.......#
#####D#####

3
3
#####d#####
#.........#
#.#.......#
#.........#
#.........#
D....e....#
#...#.....#
#.........#
#.........#
#.........#
#####D#####
boss
enemies 1

4
2
#####D#####
#.........#
#.........#
#.........#
#.........#
d.........D
#.........#
#.......#.#
#......#..#
#.........#
###########

1
4
###########
#.........#
#.........#
#.........#
#.........#
D...#..#..#
#.....#...#
#.#...##..#
#...#.##..#
#.#...e#..#
###########
enemies 1
door 0 : 0

3
1
#####D#####
#.........#
#..#......#
#.#.......#
#.........#
D.........D
#.........#
#.#.....#.#
#..#...#..#
#.........#
#####D#####

1
3
#####D#####
#.........#
#.........#
#.........#
#.........#
D.........D
#.........#
#.#.......#
#..#......#
#.........#
#####D#####

2
3
#####D#####
#.........#
#.........#
###..#....#
#.#.##....#
D........k#
#....#....#
##..#.....#
#.........#
#.........#
#####d#####
key : 3

2
1
#####D#####
#.........#
#..#......#
#.#.......#
#.........#
#.........d
#.........#
#.......#.#
#......#..#
#.........#
#####D#####

5
0
#####D#####
#.#.....#.#
#.........#
#.........#
#..#..#...#
#.........D
#.........#
#.#..#..#.#
#.........#
#k........#
###########
key : 1

4
3
#####D#####
#.........#
#...#.#...#
#...##....#
#.........#
D.........#
#.....#.#.#
#......#..#
#.....#X#.#
#.........#
###########

1
2
###########
#..#...#.##
#.........#
##.#.#.#.##
#.........#
D..#......D
#.........#
#..#.#.#.##
#.........#
##.#.....##
#####d#####

4
0
#####D#####
#.........#
#k#.....#.#
#.........#
#.........#
#..#..#...l
#.........#
#.........#
#.#.....#.#
#.........#
#####D#####
key : 0

4
1
#####D#####
#.........#
#.........#
#.........#
#.........#
l.........d
#.........#
#.........#
#.........#
#.........#
#####D#####
locked : 1

0
3
###########
#e........#
#..p......#
#.........#
#.........#
#.........#
#.........#
#.........#
#.........#
#.........#
#####D#####
enemies 1

