2
0
###########
#.........#
#.........#
#.........#
#.........#
#..........
#.........#
#.#.......#
#..##.....#
#.........#
#####.#####

4
2
#####.#####
#k........#
#..#......#
#.#.......#
#.........#
...........
#.........#
#.......#.#
#......#..#
#.........#
#####l#####
key : 2

2
3
###########
#.#.....#.#
#.........#
#.#.#.....#
#.........#
....#.#...#
#.........#
#.#.#.....#
#.........#
#.#.....#.#
#####.#####

4
1
#####.#####
#.........#
#......#..#
#.......#.#
#.........#
...........
#.........#
#.......#.#
#......#..#
#.........#
###########

4
3
#####.#####
##.#.....##
#.........#
##.#.#...##
#.........#
.....#.#..#
#.........#
##.#.#.#.##
#........?#
##.#...#e##
###########
enemies 1
door 0 : 0 1
sign A useful tool lies just ahead.

1
1
#####d#####
#.........#
#.........#
#....#....#
#.........#
#..........
#.........#
#...#.....#
#.........#
#.........#
#####l#####
locked : 1

2
1
#####l#####
#k.......##
#.........#
#.........#
#...#..#..#
...........
#.........#
#..#..#..##
#.........#
#.........#
#####.#####
key : 0

6
2
#####d#####
#.........#
#.........#
#.........#
#.........#
#....e....#
#.........#
#.........#
#.........#
#.........#
#####.#####
boss
enemies 1

7
2
#####.#####
#.........#
#.........#
#.........#
#.........#
#..#.#....#
#.##......#
#X#.##....#
##..#.....#
##........#
###########

5
0
#####d#####
#.........#
#.........#
#.........#
#.........#
#.........#
#.........#
#.......#.#
#......#..#
#.........#
###########

0
1
###########
#.........#
#..#......#
#.#.......#
#.........#
#.........#
#.........#
#.........#
#.........#
#.........#
#####d#####

1
2
###########
#.#.....#.#
#.........#
#.#.#.#.#.#
#.........#
....#.....#
#.........#
#...#.#.#.#
#.........#
#.#.......#
#####d#####

3
2
#####.#####
#.......#k#
#...#.....#
#....##.#.#
#...#...#.#
....##.#...
#.........#
#...##....#
#.........#
#.........#
#####.#####
key : 1

5
2
#####l#####
#.........#
##..#.....#
#.###.....#
#.........#
#..##.....#
#.#.......#
#.........#
#.........#
#.........#
#####d#####
locked : 3

2
2
#####d#####
#s.......e#
#..#..#..##
#.........#
#.........#
...#..#....
#.........#
#.........#
#..#.....##
#........e#
#####.#####
enemies 2
switch 0 : 0 1

3
3
#####.#####
#.........#
#.........#
##........#
#.........#
.........k#
#.........#
#.........#
#.........#
#.........#
#####.#####
key : 3

3
0
#####.#####
####......#
#?##......#
#.###.....#
#..#......#
#..##@.....
#.........#
#..#......#
#.........#
#.........#
#####.#####
sign Many have walked this path.

4
0
#####.#####
#?........#
#.........#
#.........#
#.........#
#e....##...
#......#..#
#.........#
#.........#
#.........#
#####d#####
enemies 1
sign Many have walked this path.

3
1
#####.#####
#.........#
#...#.....#
#.........#
#.........#
...........
#.........#
#.........#
##..#.....#
#.........#
#####.#####

