1
2
#####.#####
#.........#
#..#..#.#.#
#.#.......#
#.........#
#..........
#.........#
#.......###
#......#..#
#.........#
#####d#####

2
3
#####.#####
#.........#
#.........#
#..#......#
#.........#
..........#
#......#..#
#.........#
#.........#
#..#......#
#####.#####

3
3
#####.#####
#.........#
#.........#
#.........#
#.........#
d..........
#.........#
#.#.....#.#
#..#...#..#
#.........#
#####.#####

3
4
###########
#........e#
#.........#
#..#......#
#.........#
..........#
#.#.#.....#
#.#.......#
###.#.....#
##........#
###########
enemies 1

3
2
#####.#####
#.........#
#..#..#..##
#.........#
#.........#
...#..#...d
#.........#
#.........#
#..#.....##
#.........#
###########

1
4
###########
#.....X#..#
#...#.##..#
#...###..##
#....#..#.#
.....##...#
#.........#
#.........#
#.........#
#.........#
###########

0
3
###########
#.........#
#.........#
#.........#
#.........#
l.........#
#.........#
#.........#
#.........#
#.........#
#####d#####
locked : 4

3
0
#####l#####
#.........#
#...#.#.#.#
#.........#
#...#.#.#.#
#.........l
#.......#.#
#.........#
#.#.#.#.#.#
#.........#
#####d#####

2
1
###########
#?...e....#
#.........#
#..##e#...#
#.####e#..#
...........
#....##.#.#
#....#....#
#.........#
#.........#
#####.#####
enemies 3
sign Only the prepared may pass.

2
2
#####d#####
#k........#
#......#..#
#.......#.#
#.........#
...........
#.........#
#.........#
#.........#
#.........#
#####.#####
key : 2

3
1
#####.#####
#.........#
#.........#
#.........#
#.........#
l..........
#.........#
#.........#
#.........#
#.........#
#####.#####
locked : 1

4
3
#####.#####
#.........#
#..#......#
#.#.......#
#.........#
#.........#
#.........#
#.#.......#
#..#......#
#k........#
###########
key : 4

4
0
#####d#####
#.........#
#...#.#...#
#..#......#
#..#..#...#
#...#@#....
#.#...#...#
#.........#
#.........#
#.........#
#####.#####

0
2
###########
#..#.....##
#.........#
#.....#.#.#
#.........#
#....#....l
#.........#
#.#.#.#...#
#.........#
##.#.....##
#####.#####

2
0
###########
#.........#
#.....#...#
#.........#
#.........#
#.....#....
#.........#
#.........#
#........##
#.........#
#####l#####
locked : 0

5
1
#####.#####
#........##
#......#..#
#.......#.#
#.........#
......#...#
#.........#
#.........#
#.........#
#.......#k#
###########
key : 1

4
1
#####.#####
#.........#
#.#.#...#.#
#.........#
#..#.#.#..#
..........#
#.#.#.#.#k#
#.........#
#..#...#.##
#.........#
#####.#####
key : 0

5
0
#####.#####
#.........#
#.........#
#.........#
#.........#
#..........
#.........#
#.........#
#.........#
#.........#
###########

1
3
#####d#####
#.........#
#..##.....#
#...#.....#
#.#.......#
.....e.....
#.........#
#.........#
#.........#
#.........#
#####.#####
boss
enemies 1

