2
3
#####d#####
#.........#
#.........#
#.........#
#.........#
l..........
#.........#
#.#.......#
#..##.....#
#.........#
#####d#####
locked : 1

3
3
#####d#####
#.........#
#.....#.#.#
#.........#
#..#.#....#
..........d
#.#.#.#.#.#
#.........#
#..#...#.##
#.........#
###########

1
3
###########
#.........#
#.........#
#.........#
#.........#
#.........#
#.........#
#.........#
#.........#
#.........#
#####d#####

0
1
###########
#.##.....k#
#.##..#...#
#.##..#...#
#.#..#....#
..........#
#.........#
#.........#
#.........#
#.........#
#####.#####
key : 2

3
0
#####.#####
#.........#
#..#......#
#.#.......#
#.........#
#..........
#.........#
#.#.......#
#..#......#
#.........#
###########

3
5
###########
#.........#
#..#......#
#.#.......#
#.........#
..........#
#.........#
#.........#
#.........#
#.........#
###########

5
4
#####.#####
#.........#
#.........#
#.........#
#.........#
#.........#
#.........#
#.........#
#.........#
#X.......##
###########

0
0
###########
#k........#
#.........#
#.........#
#.........#
#..........
#.........#
#.........#
#.........#
#.........#
#####.#####
key : 4

3
4
#####.#####
#.........#
#.#.#.....#
#####.....#
#.#.#.....#
d...#......
#.##......#
#.........#
#.........#
#.........#
#####d#####

3
1
#####l#####
#......#..#
#.........#
#.........#
#.........#
.......#...
#.....##..#
#..####...#
#.....##..#
#.........#
#####.#####
locked : 0

4
4
#####d#####
#.........#
#.........#
#.........#
#..##.....#
#...##....#
#..#e.....#
#.........#
#.........#
#.........#
#####.#####
boss
enemies 1

2
1
#####.#####
#k........#
#..#......#
#.#.......#
#.......#.#
...........
#.........#
#.......#.#
#......#..#
#.........#
#####l#####
key : 0

3
2
#####.#####
#.........#
#.#.....#.#
#.........#
#.........#
...........
#.........#
#.........#
#.......#.#
#.........#
###########

2
4
###########
#........e#
#...#.#...#
#...##....#
#.........#
....###...#
#...#.....#
#.........#
#.........#
#.........#
#####.#####
enemies 1

1
1
#####.#####
#.........#
#...#.....#
#...##....#
#..####...#
...###k#..#
#.#.##....#
#......#..#
#.........#
#......#..#
#####.#####
key : 1

4
1
#####.#####
#.........#
#.........#
#.........#
#.........#
#.........#
#.........#
#.........#
#e........#
#e.......e#
###########
enemies 3

2
2
###########
#?...e....#
#.........#
#.....#...#
#.........#
..........l
#..#......#
#.........#
#.........#
#.........#
#####.#####
enemies 1
sign Only the prepared may pass.

2
0
#####.#####
#.........#
#.......#.#
#.........#
#.....##..#
#.....##...
#....##...#
#....##..##
#......#.##
#.........#
#####.#####

1
0
#####.#####
#.........#
#.........#
#.........#
#...@.....#
#..###.....
#..###....#
##.#.#....#
###.......#
#.........#
#####.#####

