3
0
#####d#####
#.........#
#..#......#
#.#.......#
#.........#
#...#.....D
#.........#
#.#.....#.#
#..#...#..#
#.........#
#####d#####

7
0
#####d#####
#..#.....##
#.........#
#.........#
#.........#
#.........D
#.........#
#.....#..##
#.........#
#.........#
###########

5
1
#####D#####
#.........#
#......#..#
#.......#.#
#.........#
D.........D
#.........#
#.........#
#.........#
#.........#
#####D#####

7
1
#####D#####
#.........#
#.........#
#.........#
#.........#
D....###..D
#.........#
#....##...#
#.........#
#.........#
###########

7
2
#####D#####
#.........#
#..#......#
#.#.......#
#.........#
D.........#
#.........#
#.#.....#.#
#..#...#..#
#........k#
###########
key : 4

4
0
#####d#####
#.........#
#.........#
#.........#
#.........#
#.........D
#.........#
#.#.......#
#..#......#
#.........#
#####D#####

6
2
#####D#####
#.........#
#.........#
#.........#
#.........#
D........k#
#.#.......#
#.##......#
#.#.......#
#.........#
#####D#####
key : 0

5
2
#####D#####
#.........#
#...p.....#
#.........#
#....#.#..#
D.....#k..#
#....#p##.#
#......##.#
#......##.#
#.........#
#####D#####
key : 3

0
1
###########
#X........#
#.........#
#.........#
#.........#
#.........#
#.........#
#.........#
#.........#
#.........#
#####D#####

5
0
#####D#####
#.........#
#.........#
##.....#..#
#.........#
#.........D
#...#..#..#
#.........#
#.........#
##.....#..#
#####D#####

4
2
#####d#####
#.........#
#......#..#
#.......#.#
#.........#
l.........#
#.........#
#.........#
#.........#
#.......#.#
#####D#####
locked : 3

1
1
#####D#####
#.........#
#...#.#...#
#.....##..#
#...#e#.#.#
#...##....#
#...#####.#
#.....##..#
#...#.#...#
#.........#
#####l#####
locked : 4
boss
enemies 1

2
0
###########
#.#.....#.#
#.........#
#.#.....#.#
#.........#
#...#.#...D
#.........#
#.#...#.#.#
#.........#
#.#.......#
#####d#####

4
1
#####D#####
#.........#
#.........#
#....#..#.#
#.........#
D.........l
#..#..#...#
#.........#
#.........#
#k#.....#.#
#####D#####
key : 2

2
1
#####l#####
#e........#
#.........#
#.........#
#.........#
D........e#
#.........#
#.........#
#.........#
#e........#
#####D#####
enemies 3

3
2
###########
#.........#
##..#..#..#
#.........#
#.........#
D.........#
#.........#
#.........#
#...#..#..#
#.........#
#####d#####

3
1
#####D#####
#.........#
#..#...#..#
#..##..#..#
#..#e.##..#
D..###.#..D
#..#?#.#..#
#.........#
#.........#
#.........#
#####D#####
enemies 1
sign Those who search shall find.

6
0
#####D#####
#.........#
#.........#
#.........#
#.........#
#....@....D
#.........#
#.........#
#.........#
#.........#
#####d#####

6
1
#####D#####
#e........#
##.#...#.##
#.........#
#.#.#.#...#
D.........D
#..#.#.#..#
#.........#
#.#.#.#.#.#
#.........#
#####D#####
enemies 1

