2
1
#####.#####
#......#..#
#..#....#.#
#.#.......#
#.........#
...........
#.........#
#.......#.#
#......#..#
#.........#
#####.#####

2
2
#####.#####
#.........#
#..#......#
#.#.......#
#.........#
...........
#.........#
#.........#
#.........#
#....k....#
###########
key : 2

2
0
###########
#.........#
##.#......#
#.........#
#....#.#..#
#..........
#..#.#.#..#
#.........#
#..#...#.##
#.........#
#####.#####

1
4
#####l#####
#.........#
#.........#
#.........#
#....##?#.#
.....###..l
#....e#...#
#....#....#
#.......#.#
#..#......#
#####d#####
enemies 1
sign A locked path — look elsewhere first.

3
1
#####.#####
#..#...#..#
#.....#...#
#..#.#....#
#..#...#..#
...##.....#
#.........#
#.........#
#........e#
#......?ee#
###########
enemies 3
sign Beware what lurks ahead.

1
2
#####d#####
#.........#
#......#..#
#.......#.#
#.........#
..........d
#.........#
#.#.....#.#
#..#...#..#
#.........#
#####.#####

1
1
#####l#####
#.........#
#.........#
#.........#
#.........#
#k.........
#.........#
#.........#
#.........#
#.........#
#####.#####
key : 1

1
5
###########
#.........#
#.........#
#.........#
#.........#
l....e....#
#.........#
#.........#
#.........#
#.........#
#####.#####
locked : 1
boss
enemies 1

4
0
#####.#####
#.........#
#.........#
#.........#
#.........#
#..#.#....#
#..#.##...#
#.........#
#.........#
#.........#
#####.#####

5
0
#####.#####
#.........#
#.........#
#.........#
#.........#
#.........#
#.........#
#.#.....#.#
#..#...#..#
#k........#
###########
key : 0

0
1
###########
#.......#.#
#.....#.#.#
#.....###.#
#....###..#
#..........
#.........#
#.........#
#.........#
#.........#
#####l#####
locked : 0

0
2
###########
#.#.....#.#
#.........#
#.........#
#....#..#.#
...........
#.........#
#....#..#.#
#.........#
#.........#
#####d#####

3
0
#####.#####
#.........#
#.........#
#.........#
#.#.#.....#
#..#.@.....
#?#.#.....#
##........#
#####.....#
#.........#
#####.#####
sign Many have walked this path.

0
4
###########
#..#......#
#..##.....#
##...#....#
#..#.#....#
..........#
#.........#
#.........#
#.........#
#.........#
#####l#####
locked : 2

1
3
#####d#####
#.........#
#.........#
##..#..#..#
#.........#
d..........
#...#..#..#
#.........#
#.........#
##.....#..#
#####.#####

2
5
#####.#####
#..#......#
#...#.....#
#..#......#
#.........#
..........#
#....#....#
#........##
#.........#
#........X#
###########

2
4
#####d#####
#.........#
#......#..#
#.......#.#
#.........#
...........
#.........#
#.........#
#.........#
#.........#
###########

2
3
#####.#####
#.........#
#.........#
#.........#
#.........#
...##......
#..##.....#
#.##......#
#.##......#
#..k......#
###########
key : 4

0
3
###########
#.#.....#.#
#.........#
#.........#
#..#......#
...........
#.........#
#.#..#..#.#
#.........#
#.........#
#####d#####

