3
2
#####d#####
#.........#
#......#..#
#.......#.#
#.........#
#.........D
#.......#.#
#.........#
#.........#
#.........#
###########

3
4
#####l#####
#.........#
#.#.......#
#.#.......#
#..#......#
D....e....D
#.........#
#.........#
#.........#
#.........#
#####D#####
locked : 1
boss
enemies 1

5
3
#####d#####
#.........#
#......#..#
#.......#.#
#.........#
#.........#
#.........#
#.#.....#.#
#..#...#..#
#.........#
###########

1
3
###########
#.........#
#.#.#.#.#.#
#.........#
#.#...#.#.#
D.........D
#.#.#.#.#.#
#.........#
#.#.#.#...#
#.........#
#####d#####

1
0
#####D#####
#.........#
#.........#
#..##.....#
#.#.#.....#
#....@....D
#.........#
#.........#
#.........#
#?........#
###########
sign The dungeon remembers all who enter.

1
1
#####D#####
#.........#
#.........#
#..#......#
#.........#
D.........D
#.....#...#
#.........#
#.........#
#..#.....##
#####d#####

1
2
###########
#.........#
#..#......#
#.#.......#
#.........#
D.........D
#.........#
#.#.......#
#..#......#
##.......##
#####D#####

0
1
###########
#........k#
##..#.....#
#.........#
#..#.#....#
D.........#
#.....##..#
#.#...##..#
#.........#
#.........#
#####D#####
key : 0

2
3
#####d#####
#......#..#
#.....#...#
#....#k#..#
#..###....#
D...##....l
#..#......#
#.........#
#.........#
#.........#
#####D#####
key : 6

3
3
#####D#####
#k........#
#..#......#
#.#.......#
#.........#
D.........D
#.........#
#.#.....#.#
#..#...#..#
#.........#
#####D#####
key : 5

4
3
#####D#####
#.........#
#.........#
#.........#
#....#..#.#
#.........l
#.........#
##..#..#..#
#.........#
#.........#
#####d#####

1
4
###########
#.........#
#......#..#
#.......#.#
#.........#
D.........#
#.........#
#.........#
#.........#
#.........#
#####D#####

2
4
#####D#####
#.........#
#...#.....#
#.........#
#.........#
l...#..#..D
#.........#
#.........#
##..#..#..#
#.........#
#####l#####
locked : 6

2
5
###########
#..#....ee#
#........e#
#.........#
#.........#
D.........#
#.........#
#..#..#..##
#.........#
#.........#
#####D#####
enemies 3

0
0
###########
#.#.....#.#
#.........#
#...#.#.#.#
#.........#
#...#.....D
#.........#
#...#.#.#.#
#.........#
#.#.....#.#
#####D#####

2
1
#####d#####
##.#...#.##
#.........#
#.#.#.#.#.#
#.........#
#..#.#.#..D
#.........#
#.#.#.#...#
#.........#
##........#
###########

2
2
#####D#####
#k........#
#.........#
#.........#
#.........#
D.........D
#.........#
#.........#
#.........#
#.........#
#####d#####
key : 1

4
4
#####D#####
#.........#
#..#..#..##
#.........#
#.........#
l.........#
#.........#
#.........#
#..#.....##
#.........#
###########
locked : 5

3
5
#####D#####
#.........#
#.........#
#.........#
#.........#
D.........#
#.........#
#.........#
#.........#
#........X#
###########

