6
3
#####.#####
#.........#
#.........#
#.........#
#.........#
#.........#
#.........#
#.........#
#.........#
#X........#
###########

0
4
###########
#k........#
#.........#
#.#..#....#
#.........#
#.........#
#..#..#...#
#.........#
#.........#
#.......#.#
#####.#####
key : 3

5
3
#####l#####
#.........#
#..#......#
#...##....#
#....##...#
#....e....#
#.....#...#
#.........#
#.........#
#.........#
#####.#####
locked : 3
boss
enemies 1

4
3
#####d#####
#.........#
#.........#
#..#..#..##
#.........#
#..........
#...#..#..#
#.........#
#.........#
#..#......#
#####l#####

2
1
###########
#k........#
#.........#
#.........#
#.........#
#.........d
#..#......#
#.##......#
#.###.....#
#.........#
#####.#####
key : 2

3
0
###########
#..#......#
#...#.###.#
#..#..###.#
#.........#
#..........
#.........#
#.........#
#.........#
#.........#
#####.#####

2
2
#####.#####
#.........#
#.........#
##........#
#.........#
d.........l
#...#.....#
#....#..#.#
#......#..#
#.........#
#####.#####

1
2
###########
#.........#
#...#.....#
#.###.....#
#..#......#
#...#......
#.##......#
###.....#.#
#.###.....#
#.........#
#####.#####

4
0
#####.#####
#.......###
#.....#.###
#....######
#....#?##.#
#....@.....
#.........#
#.........#
#.........#
#.........#
#####.#####
sign The brave are rewarded.

1
3
###########
#.........#
#.........#
#..#......#
#.........#
...........
#.........#
#.........#
#.........#
#.........#
#####l#####
locked : 1

4
1
#####.#####
#.........#
#......#..#
#.......#.#
#.........#
..........#
#.........#
#.........#
#.........#
#........k#
###########
key : 0

2
3
#####l#####
#.........#
#........##
#.........#
#.........#
l...#.....#
#.........#
#.........#
#.....#...#
#.........#
#####d#####
locked : 2

4
4
#####.#####
#.........#
#.........#
#....#.#..#
#....#.#..#
..........#
#..#.###..#
#..#.###..#
#.....#?..#
#.....e..e#
###########
enemies 2
door 0 : 0 1
sign Many have walked this path.

3
4
###########
#.........#
#......#..#
#.......#.#
#.........#
d.........#
#.........#
#.........#
#.........#
#.........#
#####.#####

3
1
#####.#####
#k........#
#.........#
#.........#
#.........#
...........
#.........#
#.#.....#.#
#..#...#..#
#.........#
#####.#####
key : 1

3
3
#####d#####
#.........#
#.........#
#.........#
#.........#
....#.....d
#......#..#
#.........#
#.........#
#.........#
#####d#####

1
4
#####.#####
#.........#
#.........#
#.........#
#.........#
..........#
#.........#
#.........#
#.........#
#.........#
###########

3
2
#####.#####
#.......#.#
#..#......#
#.#.......#
#......#..#
...........
#.........#
#.........#
#.........#
##........#
###########

5
0
#####.#####
#.........#
#.........#
##......#.#
#.....#...#
#.........#
#...#.#...#
#...###...#
#...#.#...#
#e.......s#
###########
enemies 1
switch 0 : 0 1

