1
0
#####.#####
#.........#
#......#..#
#.......#.#
#.........#
#..........
#.........#
#?#.....#.#
#..#...#..#
#.........#
#####.#####
door 0 : 0
sign The dungeon remembers all who enter.

5
2
#####.#####
#.........#
#.........#
#....###..#
#....#e##.#
.....#.#...
#....e.#..#
#....###..#
#.........#
#....e....#
###########
enemies 3

1
1
#####.#####
#?........#
#.........#
#.........#
#.........#
...#.......
#.#s......#
#.e#......#
####......#
#e........#
#####.#####
enemies 2
switch 1 : 1
sign Turn back; you are not yet ready.

5
1
#####.#####
#.........#
#.#.#.#...#
#.........#
#.#...#.#.#
...........
#.#.#.#.#.#
#.........#
#...#.#.#.#
#...k.....#
###########
key : 1

3
2
#####.#####
#.........#
#.#.#.....#
#.........#
#.#.#.#.#.#
d.........#
#.#.#...#.#
#.........#
#.#.#.#.#.#
#.........#
#####.#####

1
2
###########
#........k#
#.....#...#
#.........#
#.........#
..........#
#.........#
#.......#.#
#......#..#
##......#.#
#####.#####
key : 7

2
0
#####.#####
#.........#
#.#.....#.#
#.........#
#.........#
#....#.....
#.........#
#.........#
#.#.....#.#
#.........#
#####.#####

0
0
###########
#.........#
#..#...#..#
#.#.....#.#
#.........#
#..........
#.........#
#.........#
#.........#
#.........#
#####.#####
door 1 : 1

5
0
#####.#####
#.#.....#.#
#.........#
#...#.#.#.#
#.........#
#...#.#....
#.........#
#.#...#...#
#.........#
#.........#
###########

5
3
#####.#####
#.........#
#.........#
#.........#
#.........#
..........#
#.........#
#.........#
#.........#
#........k#
###########
key : 6

3
0
#####.#####
#e.#.....##
#.........#
#.........#
#......#..#
#e........l
#.........#
#........##
#.........#
#.........#
#####.#####
enemies 2

0
1
###########
#........?#
#.........#
#.........#
#.........#
..........#
#.........#
##........#
#.........#
#.........#
#####.#####
sign Strange symbols cover the floor.

2
2
#####.#####
#.........#
#.........#
#.........#
#.........#
.........X#
#.........#
#.........#
#.........#
#.........#
#####.#####

4
0
#####.#####
#.........#
#.........#
#.........#
#...#.....#
#..##@.....
#.###.....#
#.........#
#.........#
#.........#
#####.#####

3
1
#####l#####
#.........#
#.#.#...#.#
#.........#
#..#.#.#..#
l.........d
#...#.#.#.#
#.........#
#......#.##
#.........#
#####.#####
locked : 0

2
1
#####.#####
#.##......#
#.........#
#.#.#.#...#
#...e.....#
...###.....
#.........#
#....##...#
#...#..#..#
#.........#
#####l#####
locked : 1
boss
enemies 1

4
1
#####.#####
#k........#
#.........#
#.........#
#.........#
...........
#.........#
#.........#
#.........#
#.........#
#####.#####
key : 0

4
2
#####.#####
##e.......#
###.......#
##e##.#...#
#....##...#
.....#.....
#.........#
#.........#
#.........#
#.........#
#####.#####
enemies 2

4
3
###########
#......?.s#
#......#..#
#.......#.#
#.........#
..........#
#.........#
#.......#.#
#......#..#
#.........#
#####.#####
switch 0 : 0
sign A useful tool lies just ahead.

