2
1
#####l#####
#.........#
#..#......#
#.#.......#
#.........#
..........#
#..#......#
#.#.....#k#
#.........#
#.........#
#####.#####
key : 0

1
3
#####.#####
#..#.....##
#.........#
#.........#
#..#..#...#
...........
#.........#
#..#..#..##
#.........#
#.........#
#####l#####

3
2
###########
#.........#
#.........#
#.........#
#.........#
d..........
#.........#
#.........#
#.........#
#.........#
#####.#####

4
2
#####.#####
#.........#
#..#......#
#.#.......#
#.........#
d.........#
#.........#
#.........#
#.........#
#.........#
###########

0
3
###########
#........?#
#..#......#
#.#.......#
#.........#
..........#
#.........#
#.#.......#
#..#......#
#.........#
#####.#####
door 1 : 2 3
sign Beware what lurks ahead.

1
2
#####.#####
#.........#
#.........#
#.........#
#.........#
l..........
#.........#
#.........#
#.........#
#.........#
###########
locked : 1

4
1
#####.#####
#s.......e#
#..#.....##
#.........#
#.........#
...#..#...d
#.........#
#.........#
#..#..#..##
#........e#
#####.#####
enemies 2
switch 1 : 2 3

5
0
#####l#####
#.........#
#..#...#..#
#.#.....#.#
#.........#
#..........
#.........#
#.........#
#.........#
#.........#
###########
locked : 2

3
3
#####.#####
#.........#
#.........#
#.........#
#.........#
...#......#
#...##....#
#..#.#....#
#.........#
#........X#
###########

0
1
###########
#ee.......#
#e........#
#s........#
#.........#
#..........
#.........#
#.........#
#.........#
#.........#
#####.#####
enemies 3
switch 0 : 0 1

2
0
###########
#......#..#
#.#.#.##..#
#.##.##...#
#.#...#...#
#....@#....
#....##...#
#.........#
#.........#
#.........#
#####.#####

0
2
###########
#.##e.....#
#..##.....#
##.###....#
#...##....#
...........
#.........#
#.........#
#.........#
#.........#
#####.#####
enemies 1
door 0 : 0 1

2
3
#####l#####
#.........#
#...#.#...#
#...#.#...#
#...##....#
#....e....#
#....#.#..#
#.........#
#......#..#
#.........#
#####.#####
locked : 3
boss
enemies 1

3
0
#####.#####
#.........#
#..#..##..#
#.#...#k#.#
#.........#
#..........
#.........#
#.........#
#.........#
#.........#
#####.#####
key : 1

1
1
#####.#####
#.........#
#.......#.#
#.........#
#.........#
#..#..#...l
#.........#
#.........#
#.......#.#
#.........#
#####l#####
locked : 0

4
0
#####.#####
#.........#
#.....###.#
#......####
#....###..#
#....###...
#k#.##....#
#...#.....#
#.#.......#
#.........#
#####l#####
key : 2

3
1
#####.#####
#.........#
#.........#
#.........#
#.........#
..........d
#.........#
#.........#
#.........#
#.........#
#####.#####

5
1
#####.#####
#.........#
#.........#
#.........#
#.........#
...#......#
#..##.....#
##.#.....##
#.........#
#........k#
###########
key : 3

1
4
###########
##.......e#
#.#.......#
#.##......#
#.###.....#
...#......#
#.........#
#...#.....#
##..#.....#
####?....e#
###########
enemies 2
sign Many have walked this path.

