0
3
###########
#.........#
#.........#
#.........#
#...e.....#
l....##...#
#...#.#...#
#..#..#...#
#..#..#...#
#.#.......#
#####D#####
locked : 1
boss
enemies 1

3
1
#####D#####
#.........#
#.........#
#.........#
#....####.#
D....#....D
#......#..#
#....#.##.#
#......#..#
#.........#
#####D#####

5
1
#####D#####
#.........#
#......####
#....#.k#.#
#....###..#
D.........d
#....#....#
#.........#
#.........#
#.........#
###########
key : 1

4
1
#####D#####
#?........#
#.........#
#...p.....#
#.........#
D........e#
#.........#
#.........#
#.........#
#.........#
#####D#####
enemies 1
door 0 : 0 1
sign Something glints behind that door…

1
2
#####D#####
#.........#
#.........#
#.........#
#.........#
d.........D
#.........#
#.........#
#.........#
#.........#
#####D#####

1
3
#####D#####
#.........#
#.###.#...#
#.##..#...#
#.#..#....#
D..##X....#
#.#..##...#
#.........#
#.........#
#.........#
#####D#####

4
0
#####D#####
#.........#
#.........#
#.........#
#.........#
#.........D
#.........#
#.........#
#.........#
#.........#
#####D#####

2
1
#####D#####
#.........#
#..#...#..#
#.#.....#.#
#.........#
d.........D
#.........#
#.#.......#
#..#......#
#.........#
#####D#####

0
2
###########
#..k......#
#..#......#
#.#.......#
#.........#
D..#......l
#.........#
#.#.......#
#..#......#
#.........#
#####D#####
key : 4

2
3
#####D#####
#.........#
#...#.....#
#..#####..#
#..######.#
d...###...#
#..##.#...#
#..##.#...#
#.........#
#.........#
###########

2
0
#####D#####
#.........#
#.........#
#.........#
#.........#
#.........d
#.........#
#.........#
#.........#
#.........#
#####D#####

1
0
###########
#k........#
#.#.#.#.#.#
#.........#
#..#......#
#.........D
#.#.#.#...#
#.........#
#..#...#.##
#.........#
#####D#####
key : 0

3
0
#####D#####
#.........#
#.....#..##
#.....#..##
#...@#?##.#
#....#.#..D
#....#....#
#....#....#
#.........#
#.........#
#####D#####
sign Many have walked this path.

5
0
#####D#####
##.#.....##
#s........#
##.#.#.#.##
#.........#
#..#.#.#..D
#.........#
#....#...##
#?........#
#ee#e..#.##
###########
enemies 3
switch 0 : 0 1
sign Those who search shall find.

2
2
#####D#####
#.........#
#.........#
#.......#.#
#.....#.#.#
D.....##..d
#.........#
#.........#
#.........#
#.........#
#####D#####

1
1
#####D#####
#.........#
#......#..#
#.......#.#
#.........#
D.........d
#.........#
#.........#
#.........#
#.........#
#####D#####

0
1
###########
#k........#
#.......#.#
#...#.....#
#...##..#.#
#......#..D
#.....#.#.#
#.........#
#.........#
#.........#
#####D#####
key : 3

3
2
#####D#####
#.........#
#...#.#...#
#.........#
#...#.....#
D.........#
#.#.#.#.#.#
#.........#
#...#.#.#e#
#.......ee#
###########
enemies 3

5
2
###########
##.#...#.##
#.........#
##...#.#.##
#.........#
d..#.#.#..#
#.........#
##.#.#.#.##
#.........#
#..#......#
###########

