4
1
#####D#####
#.........#
#.........#
#.........#
#.........#
D.........#
#.........#
#.........#
#.........#
#.........#
#####D#####

3
0
###########
#k#.....#.#
#.........#
#...#.#.#.#
#.........#
#...#.....D
#.........#
#.#.#.#.#.#
#.........#
#.#.....#.#
#####D#####
key : 1

3
1
#####l#####
#.........#
#.........#
#....#..#.#
#.........#
D.........D
#.....#...#
#.........#
#.........#
#.#.....#.#
#####D#####

7
0
#####D#####
#.........#
#...#.#.#.#
#.........#
#..#......#
#.........d
#.....#...#
#.........#
#..#...#.##
#.........#
#####d#####

4
0
#####D#####
#.........#
#k#.....#.#
#.........#
#.........#
#.........D
#.........#
#.........#
#.#.......#
#.........#
#####D#####
key : 0

1
2
###########
#.........#
#.........#
#.........#
#.........#
l....e....#
#.........#
#.........#
#.........#
#.........#
#####D#####
locked : 0
boss
enemies 1

2
2
#####D#####
#......##.#
#.....#.#.#
#....##...#
#....####.#
D....###X.#
#.p.......#
#.........#
#.........#
#.........#
#####D#####

6
1
#####l#####
#.........#
#.........#
#.........#
#.........#
D.........d
#.........#
#.......#.#
#......#..#
#.........#
#####D#####
locked : 2

5
0
#####D#####
#.........#
#.#.......#
#.##......#
#.#.#.....#
#...#@....D
#.#.......#
#...#.....#
#.........#
#.........#
#####D#####

0
1
###########
#.........#
#......#..#
#.......#.#
#.........#
#.........#
#.........#
#.#.......#
#..#......#
#.........#
#####d#####

1
1
#####d#####
#.........#
#..#...#..#
#.#.....#.#
#.........#
#.........l
#.........#
#.#.......#
#..#......#
#.........#
#####l#####
locked : 1

3
2
#####D#####
#.........#
#.........#
#.........#
#.........#
D.........#
#.....##..#
#....#....#
#.....##..#
#........k#
###########
key : 3

8
0
#####d#####
#.........#
#.........#
#.........#
#.........#
#.........#
#.........#
#.#.......#
#..#......#
#.........#
###########

6
0
#####D#####
#.........#
#..#......#
#.#.......#
#.........#
#.........D
#.........#
#.#.....#.#
#..#...#..#
#.........#
#####D#####

5
1
#####D#####
#.........#
#.........#
#.........#
#.........#
D.........D
#.........#
#.#.......#
#..#......#
#.........#
#####l#####

5
2
###########
#........k#
#.........#
#.........#
#....#.#..#
D....##...#
#...##..#.#
#.....#.#.#
#......##.#
#.........#
#####D#####
key : 2

7
1
#####D#####
#.........#
#.........#
#.........#
#.........#
d.........#
#.........#
#.#.....#.#
#..#...#..#
#.........#
###########

2
1
#####l#####
##.#...#.##
#.........#
#.#.#.#.#.#
#.........#
#..#.#.#..D
#.........#
#.#.#.#.#.#
#.........#
#..#...#.##
#####l#####
locked : 3

6
2
#####D#####
#.........#
#.....#..##
#.........#
#.........#
d......#..#
#.........#
#.........#
#..#..#..##
#.........#
###########

