4
0
#####.#####
#.........#
#.........#
#.........#
#...##.##.#
#...##....l
#...#...#.#
#...####..#
#.....###.#
#k........#
###########
key : 0

1
2
###########
#e...e....#
#.........#
#.........#
#.........#
...........
#...#..#..#
#.........#
#.........#
##.....#..#
#####.#####
enemies 2

4
3
#####.#####
#.........#
#.........#
#.........#
#......#..#
d.........#
#......#..#
#.#.......#
#..#......#
#.........#
###########

3
3
#####l#####
#.........#
#......#..#
#.......#.#
#.........#
..........d
#.........#
#.#.......#
#..#......#
#.........#
#####.#####

4
1
#####.#####
#.........#
#.........#
#.........#
#.....#...#
l..........
#.........#
#..#..#..##
#.........#
#.........#
###########
locked : 0

2
4
#####.#####
#.........#
#.........#
##..#..#..#
#.........#
..........#
#.#..#..#k#
#.........#
#.........#
##........#
#####.#####
key : 4

2
3
#####d#####
#.........#
#..#......#
#.#.......#
#.........#
...........
#.........#
#.#.......#
#..#......#
#.........#
#####l#####
locked : 1

2
2
#####.#####
#.........#
#.........#
#.........#
#.........#
...........
#.........#
#.......#.#
#......#..#
#.........#
#####d#####

3
2
#####d#####
####......#
##e.......#
###e#.....#
#.##?.....#
...##......
#..#..###.#
#......####
#.....##..#
#.........#
#####.#####
enemies 2
sign The dungeon remembers all who enter.

1
4
###########
#......ee##
#........e#
#.........#
#...#..#..#
..........#
#.........#
#..#..#..##
#.........#
#.........#
#####.#####
enemies 3

2
1
#####.#####
#.........#
#.........#
#.........#
#.........#
#..........
#k#.......#
#.#.......#
#..#......#
#.........#
#####.#####
key : 1

4
2
#####.#####
#.........#
##.#...#..#
#.........#
#.#...#.#.#
..........d
#....#.#..#
#.........#
#...#.#.#.#
#.........#
###########

1
1
###########
#.........#
#.........#
#.........#
#.........#
#..........
#.........#
#.......#.#
#......#..#
#.........#
#####.#####

0
3
###########
#X........#
#.##......#
#..#......#
#..#......#
#..#.#....#
#..##...#.#
##.##.....#
#.........#
#.........#
#####.#####

1
3
#####.#####
#..#...#..#
#..##..#..#
#.........#
#.....#...#
.....e.....
#.........#
#.........#
#.........#
#.........#
#####d#####
boss
enemies 1

3
0
###########
#.........#
#.........#
#.........#
#..#@#.#..#
#..###.#...
#..#.###..#
#....#....#
#......#..#
#.........#
#####.#####

3
5
###########
#..#.....##
#.........#
#.........#
#..#..#...#
..........#
#.........#
#..#..#..##
#.........#
#........k#
###########
key : 5

3
1
#####.#####
#.........#
#.........#
#....#....#
#.........#
...........
#.#..#....#
#.........#
#.........#
#.#.....#.#
#####.#####

3
4
#####.#####
#.#.......#
#.........#
#.........#
#....#..#.#
d..........
#.........#
#.......#.#
#.........#
#.........#
###########

