1
1
###########
#........##
#.........#
#.........#
#......#..#
D.........#
#.........#
#..#.....##
#.........#
#.........#
#####d#####

3
0
#####D#####
#.........#
#.........#
#.........#
#.........#
#?...@....D
#....#....#
#...#.#...#
#.........#
#.........#
#####D#####
sign The brave are rewarded.

5
2
#####D#####
#.........#
#.........#
##.....#..#
#.........#
D.........#
#.#..#....#
#.........#
#.........#
##.......e#
###########
enemies 1

6
1
#####d#####
#.........#
#.........#
#.........#
#.........#
D....e....#
#.........#
#.........#
#.........#
#.........#
#####D#####
boss
enemies 1

5
1
#####l#####
#.........#
#...#.#...#
#.....#...#
#.........#
D.........D
#.........#
#.........#
#.........#
#.........#
#####d#####
locked : 1

1
0
#####d#####
#.........#
#......#..#
#.......#.#
#.........#
#.........D
#.........#
#k#.......#
#..#......#
#.........#
#####D#####
key : 1

3
3
###########
#.........#
##.......##
#.........#
#....#....#
d.........#
#..#.#.#..#
#.........#
##.#.....##
#.........#
###########

4
0
#####D#####
#......#..#
#.....#...#
#....#.#..#
#.........#
#.........D
#k........#
#p........#
#.........#
#.........#
#####D#####
key : 0

2
2
###########
#.........#
#..#......#
#.#.......#
#.........#
D.........#
#.........#
#.......#.#
#......#..#
#.........#
#####D#####

3
2
#####D#####
#k........#
#..#...#..#
#.#.....#.#
#.........#
D.........d
#.........#
#.........#
#.........#
#.........#
#####D#####
key : 2

0
0
###########
#.........#
#..#...#..#
#.#.....#.#
#.........#
#.........#
#.........#
#.........#
#.........#
#.........#
#####d#####

6
0
#####l#####
#..#.....##
#.........#
#.........#
#..#..#...#
#.........D
#.........#
#..#.....##
#.........#
#.........#
###########
locked : 3

4
2
#####D#####
#.........#
#..#......#
#.#.......#
#.........#
D.........#
#.........#
#.#.......#
#..#......#
#.........#
#####D#####

3
1
#####D#####
#e#.......#
#.........#
#.#.......#
#.........#
D...#.....D
#.........#
#.#.#.#.#.#
#.........#
#?#.....#.#
#####D#####
enemies 1
sign Those who search shall find.

2
0
#####D#####
#.......#.#
#......#..#
#..###.#..#
#..#.#.#..#
#..#.##...D
#.........#
#.........#
#.........#
#.........#
#####D#####

2
1
#####d#####
#.........#
#.........#
#.........#
#.........#
D.........D
#.........#
#.........#
#.........#
#.........#
#####D#####

4
1
#####D#####
#.........#
#.........#
#.........#
#.........#
D.........D
#.........#
#.......#.#
#......#..#
#.........#
#####l#####

7
1
#####D#####
#.........#
#.....##..#
#.........#
#.........#
#.........#
#.....##..#
#....#.##.#
#.........#
#X........#
###########

5
0
#####D#####
#.........#
#..#......#
#k#.......#
#.........#
#.........D
#.........#
#.#.......#
#..#......#
#.........#
#####l#####
key : 3

