0
1
###########
#k........#
#......#..#
#.......#.#
#.........#
#.........D
#.........#
#.........#
#.........#
#.........#
#####D#####
key : 5

1
3
###########
#..#......#
#..##.#...#
#.####....#
#....##...#
l....e....#
#.........#
#.........#
#.........#
#.........#
#####D#####
locked : 5
boss
enemies 1

4
1
#####D#####
#.........#
#.#.#...#.#
#.........#
#.#.......#
l.........l
#.#.#.#.#.#
#.........#
#.#.#.#.#.#
#.........#
#####D#####
locked : 0

1
2
#####d#####
#.........#
#.........#
#....#....#
#...#.....#
D.........l
#.........#
#.........#
#.........#
#.........#
#####l#####
locked : 2

5
0
#####D#####
#.........#
#.........#
#.........#
#.........#
#.........D
#.........#
#.......#.#
#......#..#
#k........#
###########
key : 0

5
2
#####d#####
#.#.....#.#
#.........#
#.........#
#..#......#
D.........#
#.........#
#.#..#....#
#.........#
#.........#
###########

3
2
#####D#####
#.........#
#.........#
##........#
#.........#
d.........#
#....#....#
#.#.....#.#
#..#...#..#
#.........#
#####D#####

3
0
#####D#####
#.........#
#.........#
#....#....#
#...#k....#
#..###.#..D
#..#####..#
#...#.##..#
#...#..#..#
#.........#
#####D#####
key : 1

3
1
#####D#####
#.........#
#......#..#
#.......#.#
#.........#
D.........d
#.........#
#.........#
#.........#
#.........#
#####D#####

4
3
###########
#.........#
#......#..#
#.......#.#
#.........#
D.........#
#.........#
#.......#.#
#......#..#
#.........#
###########

0
2
###########
#.........#
#.........#
#.........#
#.........#
D.........#
#.........#
#.........#
#.........#
#.........#
#####d#####

1
1
#####D#####
#.........#
#.........#
#.........#
#.........#
#.....##..D
#......##.#
#.....#...#
#.........#
#p........#
#####D#####

2
0
###########
#.........#
#.........#
#...##.##.#
#..#..#.#.#
#.....#...D
#.....##..#
#...###...#
#.........#
##........#
#####D#####

2
3
#####D#####
#.........#
##.#......#
#.........#
#....###..#
D..#.###..#
#..##..#..#
#..###....#
#..#......#
#........X#
###########

2
1
#####D#####
#.........#
#.........#
#.........#
#.........#
D.........d
#.........#
#.........#
#.........#
#.........#
#####D#####

4
0
#####D#####
#.........#
#...#..#..#
#..#...#..#
#....#....#
#....@#...l
#...#.....#
#.........#
#.........#
#.........#
#####D#####

5
1
#####D#####
#k#.......#
#.........#
#.........#
#.#..#..#.#
D.........D
#.........#
#.#.....#.#
#.........#
#.........#
###########
key : 2

2
2
#####l#####
#.........#
#......#..#
#.......#.#
#.........#
d.........D
#.........#
#.#.......#
#..#......#
#.........#
#####D#####

4
2
#####D#####
#.........#
#..#...#..#
#.#.....#.#
#.........#
l.........D
#.........#
#.#.......#
#..#......#
#.........#
#####d#####
locked : 1

