0
2
###########
#e........#
#.#.....#.#
#.........#
#.........#
#..#..#...#
#.........#
#.........#
#.#.....#.#
#.........#
#####.#####
enemies 1
door 0 : 0 1

6
3
###########
#k........#
##.#...#..#
#.........#
#.#.#.#...#
..........d
#..#.#.#..#
#.........#
#.#...#...#
#.........#
#####.#####
key : 3

4
0
#####d#####
#.........#
#.........#
#.........#
#.........#
#.........d
#.........#
#.#.....#.#
#..#...#..#
#.........#
###########

3
1
#####.#####
##.....#..#
#.........#
#.........#
#.#..#..#.#
...........
#.........#
##..#..#..#
#.........#
#.........#
#####.#####

2
3
#####.#####
#.........#
#.........#
#........##
#....##.#.#
l...####..#
#.....##..#
#.###..##.#
###.#.....#
###.......#
###########
locked : 0

2
2
#####.#####
#.........#
#.....#...#
#.........#
#....#e#..#
......#s..l
#.....##..#
#.........#
#.........#
#.........#
#####d#####
enemies 1
switch 0 : 0 1

3
2
#####d#####
#.........#
#.........#
#.........#
#.........#
..........#
#.........#
#.......#.#
#......#..#
#.........#
###########

1
3
###########
#......?ee#
#........e#
#.........#
#.........#
..........#
#.........#
#.........#
#.........#
#.........#
#####.#####
enemies 3
sign Seek the matching key before you proceed.

7
2
#####.#####
#.........#
#..#..#..##
#.........#
#.........#
#......#...
#.........#
#.........#
#........##
#.........#
###########

7
3
#####.#####
#.........#
#.........#
#.........#
#.........#
...........
#.........#
#.........#
#.........#
#....k....#
###########
key : 4

6
2
#####.#####
#e#.......#
#.........#
#.........#
#.........#
#?.........
#.........#
#.........#
#.........#
#.........#
#####.#####
enemies 1
sign What you seek is close.

7
4
#####.#####
#......#..#
#......#..#
#....###..#
#....#.#..#
.....#.#..#
#.........#
#.........#
#.........#
#........X#
###########

5
1
#####.#####
#.........#
#.........#
#......##.#
#.....###.#
#......#...
#..#.#....#
#..###....#
#..##.....#
#k........#
###########
key : 0

2
1
###########
#.........#
#.........#
##..#..#..#
#.........#
#..........
#.#..#..#.#
#.........#
#.........#
##.....#..#
#####.#####

3
0
###########
#?........#
#.........#
#.##...#..#
#...####..#
#..###.....
#...@#.#..#
#...##....#
#.........#
#.........#
#####d#####
sign The dungeon remembers all who enter.

5
2
###########
#........k#
#.#...##..#
#.##.###..#
#.####....#
....##....#
#.........#
#.........#
#.........#
#.........#
#####.#####
key : 1

6
4
###########
#.........#
#.........#
#.........#
#.#...#...#
d..##e....#
#.#.###...#
#....##...#
#.#.#.#...#
#.........#
#####.#####
boss
enemies 1

1
2
#####.#####
#.........#
#...#.....#
#.##......#
#.........#
#..........
#......#..#
#.....#...#
#.....#...#
#.........#
#####.#####

4
1
#####.#####
#.........#
##..#..#..#
#.........#
#.........#
d.........#
#.........#
#.........#
##..#..#..#
#.........#
#####.#####

