1
4
###########
#........k#
#.........#
#.........#
#.........#
..........#
#.........#
#.........#
#.........#
#.........#
#####.#####
key : 3

3
3
#####d#####
#.........#
#.........#
#.........#
#.........#
..........d
#.........#
#.........#
#.........#
#.........#
#####.#####

2
3
#####.#####
#.........#
#.........#
#.........#
#.........#
...........
#.........#
#.........#
#.........#
#.........#
#####d#####

1
3
#####.#####
#.........#
#......#..#
#.......#.#
#.........#
#..........
#.........#
#.......#.#
#......#..#
#.........#
#####.#####

2
5
###########
#.........#
##........#
#.........#
#.........#
d.........#
#.........#
#.........#
#...#..#..#
#.........#
#####.#####

0
3
###########
#e.......s#
#.........#
#.........#
#.........#
#.........#
#.........#
#........##
#.........#
#.........#
#####.#####
enemies 1
switch 0 : 0

3
5
#####.#####
#.........#
#.........#
#....###..#
#.....##..#
...###.#..#
#..###....#
#...#.##..#
#.........#
#........e#
###########
enemies 1
door 0 : 0

2
4
#####.#####
#?........#
#.........#
#....#..#.#
#.........#
..........d
#....#..#.#
#.........#
#.........#
#e#.....#e#
#####.#####
enemies 2
sign Those who search shall find.

4
4
#####l#####
#..#...#..#
#..#...#..#
#..#.###..#
#...###...#
...###e...#
#..###....#
#...#.....#
#.........#
#.........#
#####.#####
locked : 0
boss
enemies 1

1
1
###########
##.......k#
#.........#
#.........#
#..#......#
#.........#
#.........#
#.........#
#.........#
#.........#
#####.#####
key : 1

3
0
#####.#####
##.#.....##
#.........#
#...#.#.#.#
#.........#
#..#...#..#
#.........#
#.#.....#.#
#.........#
##.....#..#
###########

4
3
#####.#####
#..#......#
#.....#...#
#...#.....#
#k####....#
#...##.....
#.........#
#.........#
#.........#
#.........#
#####.#####
key : 4

5
3
#####.#####
#.........#
#.........#
#.........#
#.........#
#..........
#.........#
#.......#.#
#......#..#
#..#......#
###########

2
2
###########
#.........#
#.........#
#.........#
#.........#
...........
#.........#
#.#.....#.#
#..#...#..#
#.........#
#####d#####

5
4
#####.#####
#.........#
#.........#
#.........#
#.........#
..........#
#.........#
#.........#
#.........#
#........X#
###########

2
0
###########
#?........#
#.....#...#
#.....#...#
#.........#
#..#.@.....
#..#......#
#..##.....#
#.........#
#.........#
#####.#####
sign What you seek is close.

2
1
#####.#####
#.........#
#.#.......#
#.#k#.....#
#..##.....#
...#.......
#.........#
#.........#
#.........#
#.........#
###########
key : 0

3
2
#####d#####
#.........#
#........##
#.........#
#.........#
#..........
#.#.......#
#.......#.#
#..#...#..#
#.........#
###########

3
4
#####.#####
#.........#
#.........#
#.........#
#.........#
d..........
#.........#
#.........#
#.........#
#.........#
#####l#####

