2
0
#####D#####
#.........#
#.........#
#.........#
#.........#
#.........D
#.........#
#.#.......#
#..#......#
#.........#
#####D#####

2
1
#####D#####
#e........#
#.........#
#.........#
#.........#
D........e#
#.........#
#.........#
#.........#
#e........#
#####D#####
enemies 3

4
0
#####l#####
#.........#
#.......#.#
#.........#
#.........#
#.....#...D
#.........#
#.........#
#.........#
#.........#
#####D#####
locked : 1

5
0
#####D#####
#.........#
#...#.....#
#....#....#
#..###....#
#.........D
#.........#
#.........#
#.........#
#.........#
#####d#####

3
0
#####D#####
#.........#
#.#.#.#...#
#.........#
#...#.#.#.#
#.........D
#k#.#...#.#
#.........#
#.#.#.#.#.#
#.........#
#####l#####
key : 1

3
1
#####D#####
#.........#
#.........#
#....#..#.#
#.........#
D.........#
#.........#
#.#.......#
#.........#
#.........#
#####D#####

6
0
#####d#####
#.........#
#..#...#..#
#.#.....#.#
#.........#
#.........D
#.........#
#.#.......#
#..#......#
#.........#
###########

6
3
#####D#####
#.........#
#.#.......#
#.........#
#...##....#
D.........#
#....####.#
#.....#.#.#
#.....#.#.#
#........X#
###########

6
2
#####D#####
#.........#
#.........#
#...#.....#
#..##.#.#.#
D....###..D
#....#k...#
#.....##..#
#.........#
#.........#
###########
key : 5

0
0
###########
#.........#
#.........#
#..#..#..##
#.........#
#.........D
#...#..#..#
#.........#
#.........#
#..#......#
#####l#####
locked : 0

1
0
#####l#####
#.........#
#.#.#.#...#
#..#..#...#
#.#.#.....#
#....@....D
#...#.....#
#...##....#
#...#.#...#
#.........#
#####D#####

6
1
#####D#####
#.........#
#.........#
####......#
#.##......#
D..#......D
#.........#
#.........#
#.........#
#.........#
###########

4
2
###########
#.........#
#.........#
#.#.......#
#.........#
D.........#
#..#..#...#
#.........#
#.........#
#.......#.#
#####D#####

5
2
#####D#####
#.........#
#..#......#
#..#.#....#
#....#..#.#
d.........d
#.........#
#.........#
#.........#
#.........#
#####D#####

5
3
###########
#..p......#
#.........#
#...##....#
#...###...#
d....e....#
#.........#
#.........#
#.........#
#........p#
#####D#####
boss
enemies 1

0
1
###########
#......#..#
#......#..#
#.......#.#
#.........#
D..#......#
#.........#
#.#.....#.#
#..#...#..#
#.........#
#####d#####

1
1
#####d#####
#k........#
##..#..#..#
#.........#
#.........#
D...#..#..#
#.........#
#.........#
##.....#..#
#.........#
#####D#####
key : 0

4
1
#####D#####
#.........#
##.....#..#
#.........#
#.........#
D...#..#..D
#.........#
#.........#
##..#.....#
#.........#
#####D#####

5
1
#####D#####
##.......##
#.........#
#...#...#.#
#.........#
D....#.#..d
#.........#
#.#k#.#...#
#.........#
##........#
#####D#####
key : 2

