2
3
#####.#####
#e?#.....##
#.........#
#.........#
#..#..#...#
...........
#.........#
#..#..#..##
#.........#
#e.......e#
#####.#####
enemies 3
sign A useful tool lies just ahead.

2
4
###########
#........k#
#.........#
#.........#
#.........#
..........#
#.........#
#.#.......#
#..#......#
#.........#
#####.#####
key : 4

2
1
#####l#####
#.........#
#.........#
#.#..#..#.#
#.........#
d..........
#..#..#...#
#.........#
#.........#
#.......#.#
#####.#####

3
2
#####.#####
#.........#
#.........#
#.........#
#.........#
......##...
#...#s#...#
#...####..#
#.....##..#
#.......#e#
#####.#####
enemies 1
switch 0 : 0 1

3
3
#####.#####
#.........#
#.#.#.#...#
#.........#
#.#.#.#.#.#
...........
#...#.#.#.#
#.........#
#.#.#.#.#.#
#.........#
###########

2
0
#####.#####
#.........#
#..#...#..#
#.#.....#.#
#.........#
#.........d
#.........#
#.#.......#
#..#......#
#.........#
#####.#####

5
0
#####.#####
#.........#
##.#...#.##
#.........#
#.#.#.....#
#..........
#..#.#.#..#
#.........#
#.#.#.#.#.#
#k........#
###########
key : 5

2
2
###########
#e..?e....#
#.........#
#...#..#..#
#.........#
...........
#.#.......#
#.........#
#.........#
##.....#..#
#####.#####
enemies 2
door 0 : 0 1
sign Beware what lurks ahead.

3
4
#####.#####
#.........#
#..#...#.##
#.........#
#....#.#..#
..........#
#....#.#..#
#.........#
#......#.##
#........e#
###########
enemies 1
door 1 : 2 3

0
1
###########
#X........#
#..##.....#
#..#..#...#
#.........#
#.........#
#...##....#
#..###....#
#..##.....#
#.........#
#####.#####

4
1
#####l#####
#.........#
#...#..#..#
#.........#
#.........#
.......#..d
#.........#
#.........#
##.....#..#
#k........#
#####.#####
key : 1

1
3
###########
#.........#
#..#......#
#.##......#
#.........#
#.........#
#.........#
#.......#.#
#......#..#
#.........#
#####.#####

3
1
#####.#####
#.........#
#......#..#
#.......#.#
#.........#
...........
#.........#
#.#.......#
#..#......#
#.........#
#####l#####
locked : 0

1
0
###########
#.........#
#.........#
#.........#
#.........#
#..........
#.........#
#.........#
#.........#
#.........#
#####.#####

4
2
#####.#####
#.........#
#.........#
#.........#
#.........#
d.........#
#.........#
#.........#
#.........#
#.........#
###########

4
0
#####.#####
#.........#
#.........#
#.........#
#.........#
#....@.....
#.........#
#.........#
#.........#
#.........#
#####.#####

3
0
#####.#####
#k#.......#
#.........#
#.#.#.#...#
#.........#
#..........
#.........#
#.#.#.#.#.#
#.........#
#.........#
#####.#####
key : 0

5
1
#####.#####
#.........#
#.........#
#.........#
#.........#
..........#
#.........#
#.........#
#.........#
#.......?s#
###########
switch 1 : 2 3
sign Those who search shall find.

1
1
#####.#####
#.........#
#.........#
#####.....#
#.###.....#
...#.e....#
#.#.......#
#.........#
#.........#
#.........#
#####l#####
locked : 1
boss
enemies 1

