6
0
#####D#####
#.........#
#.........#
#.........#
#.........#
#.........D
#.........#
#.#.....#.#
#..#...#..#
#.........#
#####D#####

3
0
###########
#ee.......#
#e........#
#?........#
#.....#...#
#.....#...D
#....#....#
#.........#
#.........#
#.........#
#####D#####
enemies 3
sign Many have walked this path.

7
1
#####D#####
#.........#
#.........#
#.........#
#.........#
D.........#
#.........#
#.........#
#........e#
#.......ee#
###########
enemies 3

3
2
#####D#####
#.........#
#.........#
#.........#
#.##......#
D..#......#
#.....#.#.#
#......#k.#
#.....###.#
#.........#
###########
key : 4

2
1
#####d#####
#.........#
#..#......#
#.#.......#
#.........#
#.........D
#.........#
#.#.....#.#
#..#...#..#
#.........#
#####d#####

5
1
#####D#####
#k........#
#..#......#
#.#.......#
#.........#
D.........D
#.........#
#.........#
#.........#
#.........#
#####D#####
key : 1

2
2
###########
#.........#
#..#......#
#.#.......#
#.........#
D.........#
#.........#
#.#.......#
#..#......#
#.........#
#####D#####

4
0
#####D#####
#.........#
#.........#
#.........#
#.........#
#.........D
#.........#
#.........#
#.........#
#.........#
#####d#####

4
1
#####D#####
#.........#
#.........#
#.........#
#.........#
D.........#
#.........#
#.........#
#.........#
#.........#
#####D#####

3
1
#####d#####
#.........#
#..#......#
#.#.......#
#.........#
D.........D
#.........#
#.#.......#
#..#......#
#.........#
#####D#####

5
0
#####d#####
#..#......#
#..#...#..#
#.....##..#
#..#@.....#
#..#.#.#..D
#.........#
#.........#
#.........#
#.........#
#####D#####

6
2
#####D#####
#.........#
#..#......#
#.#.......#
#.........#
l.........d
#.........#
#.........#
#.........#
#.........#
###########
locked : 0

6
1
#####D#####
#.........#
#.........#
#.........#
#.........#
D.........l
#.....###.#
#.....#k#.#
#.....#...#
#.........#
#####D#####
key : 0

0
1
###########
#X........#
#.........#
#.........#
#.........#
#.........#
#.........#
#.........#
#.........#
#.........#
#####D#####

7
0
#####D#####
#......#..#
#.........#
#.........#
#......#..#
#.........D
#.........#
##.....#..#
#.........#
#.........#
###########

6
3
#####D#####
#..#......#
#.........#
#....#....#
#...##....#
d...#.....#
#....##.#.#
#....####.#
#.....#.#.#
#.......#.#
###########

5
3
###########
#.........#
#.........#
#.........#
#.........#
l...###...#
#...#.#...#
#...#.#...#
#.........#
#.........#
#####D#####
locked : 4

1
1
#####D#####
#.......p.#
#.........#
#...##.p..#
#..###....#
#....e....#
#.........#
#.........#
#.........#
#.........#
#####d#####
boss
enemies 1

5
2
###########
#....k....#
#.........#
#..#..#..##
#.........#
D.........l
#..#..#...#
#.........#
#.........#
#..#.....##
#####D#####
key : 2

