3
0
#####D#####
#.......#e#
#.........#
#..#.#.#.##
#?........#
#s..#.#...D
#.........#
#..#.#.#.##
#.........#
#e#.....#e#
#####D#####
enemies 3
switch 0 : 0
sign The brave are rewarded.

0
1
###########
#k........#
#.........#
#.........#
#.........#
#...#.....#
#.........#
#.........#
#.........#
#.........#
#####D#####
key : 2

5
1
#####l#####
##.....#..#
#.........#
#.........#
#...#..#..#
D.........#
#.........#
##.....#..#
#.........#
#.........#
###########
locked : 0

4
1
#####D#####
#......p..#
#.........#
#.....#...#
#...###...#
D...#.....D
#...###...#
#....p....#
#.........#
#.........#
#####l#####

4
2
#####D#####
#.........#
#.........#
#.........#
#.......p.#
D..###....d
#..p##....#
#.###.#...#
#..#......#
#.##......#
###########

3
2
###########
#.........#
#..#......#
#.#.......#
#.........#
l.........d
#.........#
#.........#
#.........#
#.........#
#####D#####
locked : 1

3
3
#####d#####
#.........#
#......#..#
#.......#.#
#.........#
d.........#
#.........#
#.#.......#
#..#......#
#.........#
#####D#####

3
1
#####d#####
##.#...#..#
#k........#
##...#.#..#
#.........#
D..#.#.#..l
#.........#
##.#.#.#.##
#.........#
##.#...#.##
#####D#####
key : 0

2
1
#####D#####
#.........#
#.........#
#.........#
#.........#
D.........#
#...#.....#
#.##......#
#.#.#.....#
#.........#
#####d#####

4
0
#####D#####
#.........#
##.....#.##
#.........#
#....#....#
#.........D
#..#.#....#
#.........#
##.#.....##
#.........#
#####D#####

1
2
###########
##.....#k##
#.........#
#.#...#...#
#.........#
D..#.#.#..D
#.........#
#...#...#.#
#.........#
##.....#.##
###########
key : 3

2
0
###########
#......#..#
#.....#...#
#.....#.#.#
#.........#
#....@....D
#.........#
#.........#
#.........#
#.........#
#####D#####

2
3
#####D#####
#.........#
#.........#
#.........#
#.........#
#....e##..D
#.....##..#
#.....###.#
#.....#####
#.........#
#####d#####
boss
enemies 1

5
0
#####D#####
#.........#
##.....#..#
#.........#
#.........#
#.........D
#.........#
#.........#
##..#..#..#
#k........#
###########
key : 1

1
1
#####D#####
#......#..#
#.........#
#..###....#
#..#.##...#
#....#.#..D
#...##.#..#
#..#.#.#..#
#.........#
#.........#
#####D#####

4
3
#####D#####
##.....#.##
#.........#
##.#.#.#.##
#.........#
d..#...#..#
#.........#
##...#.#.##
#.........#
##.....#..#
###########

2
4
###########
#........e#
#.#.......#
#.........#
#.........#
D..#..#...#
#.........#
#.........#
#.#.....#.#
#.......?e#
###########
enemies 2
door 0 : 0
sign The dungeon remembers all who enter.

1
3
###########
#........X#
#.........#
#..p......#
#.........#
D.........#
#.........#
#.........#
#.........#
#.........#
#####D#####

