3
0
#####D#####
#..#...#..#
#..##.#...#
#..###.#..#
#......#..#
#....@....D
#......##.#
#......#..#
#.....#.#.#
#.........#
#####D#####

1
5
###########
#........X#
#.........#
#.........#
#...#p.#..#
D...###...#
#....##...#
#..##.##..#
#...#..#p.#
#.........#
###########

1
1
#####D#####
#.........#
#..#..#...#
#.........#
#.........#
D...#..#..D
#.........#
#.........#
#.....#..##
#.........#
###########

4
0
#####D#####
#..#......#
##.##.....#
##.#......#
#...#.....#
#.....#...#
#.......#.#
#.....##..#
#.........#
#e........#
###########
enemies 1
door 0 : 0 1

2
2
#####D#####
#........##
#.........#
#.#.#.#.#.#
#.........#
#..#.#....D
#.........#
#s#.....#.#
#e........#
##e....#.##
###########
enemies 2
switch 1 : 2 3

3
1
###########
#.#.....#.#
#.........#
#.........#
#..#..#...#
D.........#
#.........#
#.#..#..#.#
#.........#
#.........#
###########

0
0
###########
#.........#
##.....#.##
#.........#
#...#.#.#.#
#.........D
#.........#
#.........#
#.#.#.#.#.#
#.........#
#####d#####

3
4
#####D#####
#.........#
#..#......#
#.#.......#
#.........#
#.........#
#.........#
#.........#
#.........#
#k........#
###########
key : 11

1
3
#####d#####
#k........#
#.........#
#.........#
#.........#
D.........D
#.........#
#...p.p...#
#.........#
#.........#
#####D#####
key : 4

2
3
#####D#####
#.......#.#
#.....#.#.#
#...#.###.#
#...##..#.#
D....##...D
#.........#
#.........#
#.........#
#.........#
###########

2
4
#####d#####
#.........#
#..#...#..#
#.#.....#k#
#.........#
D.........#
#.........#
#.........#
#.........#
#.........#
#####D#####
key : 8

1
0
#####d#####
#.........#
##........#
##.#......#
#.........#
#.........D
#.........#
#.........#
#.........#
#.........#
#####d#####

0
1
###########
#e.?se....#
#.........#
#.........#
#.........#
D.........D
#.........#
#.........#
#.........#
#e........#
#####D#####
enemies 3
switch 0 : 0 1
sign The dungeon remembers all who enter.

1
2
#####D#####
#?........#
#..#......#
#.#.....#.#
#....#....#
D.........D
#.........#
#.#.....#.#
#..#...#..#
#.........#
#####D#####
sign Something glints behind that door…

2
0
#####d#####
#.........#
#.........#
#....#....#
#.........#
#......#..#
#.........#
#.......#.#
#......#..#
#.........#
#####D#####

0
2
###########
#..ee.....#
#..##e.#..#
#...####..#
#...####..#
D..#?.##..D
#..##..#..#
#.........#
#.........#
#.........#
#####D#####
enemies 3
door 1 : 2 3
sign Many have walked this path.

1
4
#####D#####
#.........#
#...#.....#
#..#.#....#
#..#e.....#
D....#....D
#.#.##....#
#.........#
#.........#
#.........#
#####d#####
boss
enemies 1

0
4
###########
#.......#k#
#...#..##.#
#.......#.#
#...####..#
D...####..#
#.........#
#.........#
#.........#
#.........#
#####D#####
key : 9

0
3
###########
#.#.......#
#..#......#
#.#.......#
#.........#
D.........D
#.........#
#.......#.#
#.#....#..#
#.........#
#####d#####

