2
0
#####D#####
#.........#
#......#.##
#.......#.#
#.#..#....#
#.........D
#.........#
#.......#.#
#......#..#
#.........#
###########

0
3
###########
#.........#
#.........#
##..#.....#
#.........#
d.........#
#...#..#..#
#.........#
#.........#
#......#..#
###########

2
4
#####D#####
#.........#
#..#....#.#
#.##......#
#...e.....#
l....#.#..#
#....##.#.#
##........#
#......##.#
#.......###
#####D#####
locked : 5
boss
enemies 1

0
2
###########
##........#
###.......#
#.##......#
#..##.....#
d.........d
#..##.....#
####.#....#
##.#......#
#.........#
#####D#####

1
1
#####D#####
#.........#
#...#.#...#
#.........#
#..#.#.#..#
D.........D
#.#...#.#.#
#.........#
#......#.##
#........k#
#####D#####
key : 0

2
2
#####D#####
#.........#
#.........#
#.........#
#.........#
D.........D
#.........#
#.........#
#.........#
#.........#
#####D#####

3
5
###########
#..#.....##
#.........#
#.........#
#.........#
D.........#
#.........#
#..#..#..##
#.........#
#........e#
###########
enemies 1

3
1
#####D#####
#.........#
#.........#
#.........#
#.........#
#..#......D
#..#....p.#
#....p....#
#.........#
#k........#
###########
key : 2

4
4
#####D#####
#.........#
#.........#
#.........#
#.........#
#.........#
#.........#
#.........#
#e........#
#e.......e#
###########
enemies 3
door 0 : 0

0
1
###########
#.........#
#.........#
#...##....#
#.#.#.#...#
#..##.....d
#..#.#....#
#....#.#..#
#.........#
#.........#
#####D#####

1
4
###########
#X........#
#.........#
#.........#
#.........#
#.........#
#.........#
#.........#
#.........#
#.........#
#####D#####

3
4
#####D#####
#e.......s#
#.#.#.....#
#.........#
#...#.#.#.#
D.........D
#.#.#.#...#
#.........#
#.#.#.#.#.#
#e.......?#
#####D#####
enemies 2
switch 0 : 0
sign Turn back; you are not yet ready.

4
2
#####d#####
#.........#
#......#..#
#.......#.#
#.....#...#
#.........#
#.........#
#.........#
#.........#
#........##
###########

3
3
#####D#####
#.......#.#
#.....##..#
#....####.#
#..##.###.#
d.........D
#.###.....#
#####.....#
##..#.....#
#.........#
###########

1
2
#####D#####
##.#...#.##
#.........#
##.#...#.##
#.........#
D..#.#.#..#
#.........#
##.#...#.##
#.........#
##.#...#.##
#####D#####

3
2
#####D#####
#.........#
#.........#
##........#
#..##.....#
D...#.....d
#..##.....#
#...#.....#
#.........#
#.........#
#####d#####

2
3
###########
#....k....#
#.........#
##..#..#..#
#.........#
D.........l
#.........#
#.........#
#.........#
##.....#..#
#####D#####
key : 5

2
1
#####D#####
#k........#
#..#......#
#.#.......#
#.........#
D.........D
#.........#
#.#.....#.#
#.##...#..#
#.........#
#####D#####
key : 1

1
0
###########
#?........#
#.....###.#
#....##.###
#.#.@#....#
#..#.#....D
#.##.#....#
#.........#
#.........#
#.........#
#####D#####
sign What you seek is close.

