7
0
#####D#####
#.........#
#.........#
#..#..#..##
#.........#
#k........D
#...#..#..#
#.........#
#.........#
#..#.....##
#####D#####
key : 0

2
1
#####d#####
#.........#
#......#..#
#.......#.#
#.........#
D.........D
#.........#
#.......#.#
#......#..#
#.........#
#####l#####
locked : 0

2
3
###########
#........k#
#.........#
#.........#
#.........#
D.........#
#.........#
#.#.......#
#..#......#
#.........#
###########
key : 5

6
0
#####D#####
#.........#
#.........#
#.........#
#.........#
#?...@....#
#.........#
#.........#
#.........#
#.........#
#####D#####
sign The brave are rewarded.

8
0
#####D#####
#.........#
#.........#
#.........#
#.........#
#.........#
#....###..#
#....##...#
#......#..#
#.........#
###########

5
0
#####D#####
#.........#
#...#.#...#
#...#####.#
#...#.....#
#...#..#..D
#.....###.#
#.........#
#.........#
#.........#
#####D#####

4
1
#####D#####
#.........#
#.........#
#.........#
#.........#
D.........#
#.......#.#
#.......#.#
#......#..#
#.........#
#####D#####

1
0
###########
#.........#
#.........#
#...#.....#
#....#....#
#...#.....D
#..#.#....#
#..#......#
#..##.....#
#.........#
#####d#####

1
2
###########
##.......X#
#####.....#
##.#......#
#..#.#....#
D.........#
#.#.......#
#.........#
#.........#
#.........#
#####D#####

7
1
###########
#........k#
#.........#
#.........#
#.........#
D.........#
#.........#
#.........#
#.........#
#.........#
###########
key : 1

4
0
#####d#####
#.........#
#.........#
#.........#
#.........#
#.........D
#.........#
#.........#
#.........#
#.........#
#####D#####

3
1
#####l#####
#..#......#
#..#...#..#
#.#.....#.#
#.#.......#
d.........D
#.........#
#.#..#....#
#..#......#
#.........#
#####D#####

3
2
#####D#####
#.........#
#.........#
##.##.....#
#.###.....#
D..#......#
#.#.###...#
###.#...#.#
#.....#.#.#
#........k#
###########
key : 3

0
1
###########
#e##.....e#
#.##......#
#..#..#...#
#...#.#...#
#.........#
#..#......#
##........#
#.........#
#.........#
#####D#####
enemies 2

3
0
#####D#####
#.........#
#..#......#
#.#.......#
#.........#
#.........d
#.........#
#.......#.#
#......#..#
#.........#
#####d#####

2
0
#####d#####
#.........#
#..#......#
#.#.......#
#.........#
#.........D
#.........#
#.......#.#
#......#..#
#.........#
#####D#####

2
2
#####D#####
#e.......e#
##..#..#..#
#.........#
#.........#
D....#....D
#.........#
#.........#
##..#..#..#
#e.......?#
#####D#####
enemies 3
sign Only the prepared may pass.

5
1
#####D#####
#.........#
#..#......#
#.#.......#
#.........#
D.........#
#.........#
#.........#
#.........#
#.........#
###########

1
1
#####D#####
#.........#
#.........#
#.........#
#.........#
D....e....D
#.........#
#.........#
#.........#
#.........#
#####d#####
boss
enemies 1

