2
3
###########
#........k#
#.........#
#..#......#
#.#.......#
..........#
#.........#
#.........#
#.........#
#.........#
#####.#####
key : 2

2
1
#####.#####
#e........#
#.........#
#.........#
#?........#
#e.........
#.........#
#.........#
#.........#
#.........#
#####.#####
enemies 2
sign A useful tool lies just ahead.

2
2
#####l#####
#.........#
#.........#
#.........#
#.........#
...........
#.........#
#.#.....#.#
#..#...#..#
#.........#
#####.#####

4
3
#####d#####
#.#.......#
#.##...#..#
#.#.....#.#
#.........#
d.........d
#.........#
#.........#
#.........#
#.........#
#####.#####

4
2
#####.#####
#..#.....##
#.........#
#.........#
#..#..#...#
l.........d
#.........#
#..#.....##
#.........#
#.........#
#####l#####
locked : 1

4
0
#####.#####
##.#...#.##
#.........#
#..#.....##
#.........#
#..#.#.....
#.........#
##.#.#.#.##
#k........#
##.#...#..#
###########
key : 1

3
2
#####.#####
###.......#
#.##......#
#.###.....#
#.###.....#
...........
#..#......#
#.#.......#
###.......#
#e........#
#####.#####
enemies 1

5
3
#####.#####
#.........#
#.........#
#.........#
#.........#
...#......#
#.........#
#.#.....#.#
#..#...#..#
#.........#
###########

4
5
###########
#.........#
#......#..#
#...#.....#
#.....#...#
d....e....#
#.....#...#
#.#....#..#
#.....##..#
#.........#
#####.#####
boss
enemies 1

4
1
#####.#####
#.........#
#..#...#..#
#.#.....#.#
#.........#
..........l
#.........#
#.........#
#.........#
#.........#
###########

3
0
###########
#.........#
#.........#
#.........#
#.........#
#....@.....
#.........#
#.........#
#.........#
#.........#
#####.#####

5
5
#####.#####
#.........#
#.........#
#.........#
#.........#
#.........#
#.........#
#.........#
#.........#
#X........#
###########

1
1
#####.#####
#.#.....#.#
#.........#
#..#.#.#..#
#.........#
#...#.#....
#.........#
#..#.#.#.##
#.........#
#.#.....#.#
#####.#####

3
3
#####.#####
#.........#
#..#.....##
#.........#
#.........#
...#..#...#
#.........#
#.........#
#..#..#..##
#.........#
#####d#####

1
2
###########
#.........#
#.........#
#....#..#.#
#.........#
..........#
#.#..#..#.#
#.........#
#.........#
#.#.......#
#####l#####
locked : 2

3
1
#####.#####
#........k#
#.....##.##
#......#..#
#....#..#.#
.....##....
#....##...#
#.........#
#.........#
#.........#
#####.#####
key : 0

0
1
###########
#k........#
#.#.#.....#
#.##......#
#...##....#
#..#......#
#.##.#....#
#.........#
#.........#
#.........#
#####.#####
key : 3

4
4
###########
#.........#
#........##
#.........#
#.........#
d...#..#..d
#.........#
#.........#
#..#..#..##
#.........#
###########

5
2
#####l#####
#.........#
#..#......#
#.#.......#
#.........#
#..........
#.........#
#.#.......#
#..#......#
#.........#
###########
locked : 0

