2
3
#####D#####
#.##......#
#.##......#
#.#.......#
#.........#
D.........#
#....##...#
#....#.#..#
#......#..#
#........X#
###########

3
0
#####D#####
#.........#
#.........#
##.....#..#
#.........#
#.........D
#...#..#..#
#.........#
#.........#
#......#..#
#####D#####

4
1
#####D#####
#.#.......#
#.........#
#.#.#.#.#.#
#.........#
D...#.#...D
#.........#
#.#.#...#.#
#.........#
#.#.....#.#
#####D#####

5
0
#####D#####
#e........#
#.........#
#.........#
#e........#
#e........D
#?........#
#.........#
#.........#
#.........#
#####d#####
enemies 3
sign The dungeon remembers all who enter.

4
2
#####d#####
#.........#
#.........#
#.........#
#.........#
D.........d
#.........#
#.......#.#
#...#..#..#
#.........#
#####D#####

2
0
###########
#k........#
#.........#
#.#..#..#.#
#.........#
#.........D
#....#..#.#
#.........#
#.........#
#.#.....#.#
#####D#####
key : 1

0
2
###########
#.........#
#..#......#
#.#.......#
#.........#
#.........#
#.........#
#.........#
#.........#
#.........#
#####D#####

4
3
###########
#.......#.#
#.....###.#
#.....###.#
#....##...#
d....###..#
#.........#
#.........#
#.........#
#.........#
###########

1
1
###########
#k........#
#.........#
#.........#
#.........#
#.....##..D
#...##.##.#
#......#..#
#......#..#
#.......#.#
#####D#####
key : 9

6
0
#####d#####
#.........#
#..#...#..#
#.#.....#.#
#.........#
#.........#
#.........#
#.#.......#
#..#......#
#.........#
###########

3
1
#####D#####
#.........#
#......####
#....#.#.##
#....#k#..#
D....##...D
#.........#
##.#......#
#.........#
#.........#
#####D#####
key : 0

4
0
#####D#####
#..#......#
#.###.##..#
#.#####...#
#..##.....#
#..#@###..D
#.........#
#.........#
#.........#
#.........#
#####D#####

5
2
#####D#####
#.........#
##..#..#..#
#.........#
#.........#
d.........#
#.........#
#.........#
#...#..#..#
#.........#
###########

2
2
#####l#####
#.........#
#.#.....#.#
#.........#
#.........#
D..#......D
#.........#
#.........#
#.#.......#
#.........#
#####D#####

1
3
###########
#.........#
#.........#
#...#..#..#
#.........#
D.........#
#...#..#..#
#.........#
#.........#
#......#..#
#####D#####

3
2
#####D#####
#........##
#......#..#
#.......#.#
#.........#
D.........#
#.........#
#.......#.#
#......#..#
#.........#
#####d#####

5
1
#####D#####
#.........#
#.........#
#.........#
#.........#
D.........d
#.........#
#.........#
#.........#
#.........#
###########

1
2
#####D#####
####......#
####......#
###...#.#.#
#.....#.#.#
D....e#...D
#.........#
#.........#
#.........#
#.........#
#####l#####
locked : 3
boss
enemies 1

2
1
#####D#####
#..#...#.##
#.........#
##.#.#.#..#
#.........#
D..#.#.#..D
#.........#
##.#...#.##
#k........#
##.#...#.##
#####D#####
key : 3

