1
0
#####D#####
##.#...#.##
#.........#
##.....#.##
#.........#
#..#.#.#..D
#.........#
##.#.#.#.##
#.........#
#..#...#..#
#####l#####
locked : 0

3
0
#####D#####
#.........#
#.........#
#.........#
#.##..#...#
#..###....D
#.####....#
#...#.#.#.#
#.#.#.....#
#.........#
#####D#####

4
2
#####D#####
#.........#
#.#.....#.#
#.........#
#.........#
D.........#
#.........#
#.........#
#.#.....#.#
#.........#
#####D#####

3
1
#####D#####
##.#...#.##
#.........#
#..#.....##
#.........#
D..#...#..D
#.........#
##.#.....##
#k........#
##.....#.##
#####D#####
key : 0

1
1
###########
#....e....#
#.........#
#.........#
#.........#
D.........D
#......#..#
#....###..#
#p.....#..#
#e........#
#####D#####
enemies 2

3
2
#####D#####
#.#.....#.#
#.........#
#.........#
#..#......#
D.........d
#.........#
#.#..#..#.#
#.........#
#.........#
#####D#####

2
3
###########
#........e#
#.........#
#...#..#..#
#....##s#.#
D.....#...#
#...###...#
#.....#.#.#
#.........#
#.........#
#####D#####
enemies 1
switch 0 : 0 1

2
1
#####D#####
#.........#
#..#..#...#
#.........#
#.........#
d..#..#...l
#.........#
#.........#
#..#..#..##
#.........#
#####D#####

0
0
###########
#k........#
#.........#
#.........#
#.........#
#.........#
#.........#
#.........#
#.........#
#.........#
#####D#####
key : 3

2
2
#####l#####
#.........#
#...#...#.#
#.........#
#....#....#
l.........D
#.#.#.#.#.#
#.........#
#..#...#.##
#.........#
#####D#####
locked : 2

6
1
#####D#####
#.........#
#.#.......#
#.........#
#.........#
#....#....#
#.........#
#.........#
#.#.....#.#
#e.......e#
###########
enemies 2
door 0 : 0 1

5
2
#####D#####
#.#.....#.#
#.........#
#.........#
#.#..#..#.#
D.........#
#.........#
#.#..#....#
#.........#
#........e#
###########
enemies 1

5
1
#####D#####
###.......#
##..#.....#
###.......#
#k###.....#
#.........D
#.........#
#.........#
#.........#
#.........#
#####D#####
key : 4

4
0
#####D#####
#..p......#
#.........#
#.........#
#.........#
#....@....D
#.........#
#.........#
#.........#
#?........#
###########
sign What you seek is close.

2
0
#####l#####
#.........#
#.........#
#..#..#...#
#.........#
#.........d
#..#..#...#
#.........#
#.........#
#.........#
#####D#####

4
1
#####D#####
#k.#.....##
#.........#
#.........#
#...#..#..#
D.........D
#.........#
#..#..#..##
#.........#
#.........#
#####D#####
key : 2

0
2
###########
#X........#
#.........#
#.........#
#.........#
#.........#
#.........#
#.........#
#.........#
#.........#
#####D#####

1
2
#####D#####
#......#..#
#...#.....#
#...#...#.#
#.#.e##.#.#
D...##.#..#
#..#......#
#.........#
#.........#
#.........#
#####l#####
locked : 4
boss
enemies 1

3
3
#####D#####
#.........#
#.........#
#.........#
#.........#
d.........#
#.........#
#.........#
#.........#
#.........#
###########

