7
1
#####l#####
#.........#
#.........#
#.........#
#.........#
#....e....D
#.........#
#.........#
#.........#
#.........#
#####D#####
locked : 3
boss
enemies 1

2
0
#####d#####
#?p.......#
#.........#
#.........#
#.p.......#
#....@....D
#.........#
#.........#
#.........#
#.........#
#####D#####
sign Those who search shall find.

3
1
#####l#####
#.........#
#..#......#
###.......#
#.........#
D.........#
#.........#
#.........#
#.........#
#.........#
#####d#####
locked : 0

1
2
###########
#.#....s#e#
#.........#
#.........#
#..#..#...#
D.........#
#.........#
#.#.....#.#
#.........#
#........e#
###########
enemies 2
switch 0 : 0 1

6
2
#####D#####
#.........#
#..#..#...#
#.........#
#.........#
D..#..#...D
#.........#
#.........#
#..#.....##
#........e#
#####D#####
enemies 1
door 0 : 0 1

8
1
#####D#####
#.........#
#.........#
#.........#
#.........#
#.........#
#.........#
#.........#
#.........#
#X........#
###########

4
0
#####D#####
#.........#
#.........#
#.........#
#.........#
#.........D
#.........#
#.........#
#.........#
#.........#
###########

4
1
#####d#####
#.........#
#..#......#
#.#.......#
#.........#
D.........D
#.........#
#.........#
#.........#
#.........#
#####D#####

0
1
###########
#k........#
#.........#
#...#..#..#
#.........#
#.........#
#...#..#..#
#.........#
#.........#
##.....#..#
#####D#####
key : 1

6
3
###########
#........e#
##.......##
#.........#
#..#.#.#..#
D.........#
#.........#
#.........#
##.#...#.##
#......s.e#
###########
enemies 2
switch 1 : 2 3

1
0
###########
#.#.....#.#
#.........#
#.#.....#.#
#.........#
#...#.#...D
#.........#
#.....#.#.#
#.........#
#.#.....#.#
#####d#####

5
1
#####D#####
#k#.....#.#
#.........#
#...#.#.#.#
#.........#
#...#.#...l
#.........#
#...#.#.#.#
#.........#
#.#.....#.#
#####l#####
key : 2

7
2
#####D#####
#.........#
#.........#
#....#....#
#...#...#.#
D..###.#e.#
#.##...##e#
#.#.#.....#
#.........#
#........e#
###########
enemies 3
door 1 : 2 3

3
0
#####D#####
#.........#
#.........#
#.........#
#.........#
#.........D
#.........#
#.#.......#
#..#......#
#.........#
#####D#####

4
2
###########
#........k#
#...#.....#
#...#.#...#
#.........#
D.........#
#.........#
#.........#
#.p.......#
#.........#
#####D#####
key : 3

5
2
#####D#####
#..#....#.#
#..#...#..#
#.#.....#.#
#.........#
l.........#
#.........#
#.......#.#
#......#..#
#.........#
#####D#####
locked : 2

6
1
#####l#####
#.........#
#......#..#
#.........#
#.........#
#....#....D
#.........#
#.........#
##..#..#..#
#.........#
#####l#####
locked : 1

1
1
#####D#####
#.........#
#.........#
#.........#
#.........#
D.........D
#.........#
#.........#
#.........#
#.........#
#####D#####

2
1
#####D#####
#........k#
#..#...#.##
#.........#
#.#.#.#.#.#
D.........#
#..#...#..#
#.........#
#.#.#...#.#
#.........#
#####l#####
key : 0

