4
0
#####.#####
#.........#
#.........#
#.........#
#.........#
#....@.....
#.........#
#.........#
#.........#
#.........#
#####.#####

3
1
#####d#####
#.........#
#..#......#
#.#.......#
#.#.......#
...........
#.........#
#.#.....###
#..##..#..#
#.........#
#####.#####

0
2
###########
#.........#
#.........#
#.#..#..#.#
#.........#
...........
#.#.....#.#
#.........#
#.........#
#.#.......#
#####.#####

3
0
#####.#####
#.........#
#.........#
#.........#
#.......#.#
#..........
#.......#.#
#.#.....#.#
#..#...#.##
#.........#
#####.#####

2
3
#####.#####
#.........#
#.........#
#.........#
#.#....#..#
.......#X.#
#.......#.#
#.....#.#.#
#.........#
#.........#
#####.#####

2
0
###########
#k........#
#.........#
#.....#...#
#.##.#....#
#..........
#.#.......#
#.####...##
#..#......#
#.........#
#####.#####
key : 1

5
0
#####.#####
#.......#.#
#.........#
#.........#
#...#.....#
#..........
#.........#
#?........#
#e........#
#es.......#
###########
enemies 2
switch 0 : 0
sign Something glints behind that door…

2
2
#####.#####
#.........#
#..#......#
#.#.......#
#.........#
...........
#.........#
#.###.....#
#..#......#
#.........#
#####.#####

2
1
#####l#####
#.........#
#.........#
##..#..#..#
#.........#
...........
#.#.....#.#
#.........#
#.........#
##........#
#####d#####

1
2
#####.#####
#k........#
#.........#
#.........#
#.........#
..........d
#.........#
#.........#
#.........#
#.........#
#####.#####
key : 4

5
2
###########
#........##
#.........#
#.........#
#.....#...#
d.........#
#.........#
#.....#...#
#.........#
#.........#
###########

1
1
#####.#####
#.........#
#.........#
#.........#
#.........#
#..........
#.........#
#.........#
#.........#
#..#......#
#####l#####
locked : 1

0
1
###########
#e....e#..#
#e....#...#
#.........#
#.........#
#..##......
#.#.#.....#
#.........#
#.........#
#.........#
#####.#####
enemies 3

1
3
#####.#####
#.........#
#.........#
#.....#...#
#.#.#.....#
d...##....#
#.##e.....#
#.........#
#.........#
#.........#
#####.#####
boss
enemies 1

3
2
#####.#####
#.........#
#.........#
#.........#
#.........#
..........d
#.........#
#.......#.#
#......#..#
#......k..#
###########
key : 2

5
1
#####.#####
#.........#
#.........#
#.........#
#.........#
...#.#....d
#..#.k....#
#..###....#
#.........#
#.........#
###########
key : 0

3
3
#####.#####
#.........#
#.........#
#.........#
#.........#
d.........#
#.........#
#.#.......#
#..#......#
#.........#
###########

4
1
#####.#####
##.....#.##
#.........#
##.#.#.#.##
#.........#
.....#.#..#
#.........#
##.#.#.#.##
#.........#
#......#.##
#####.#####

0
3
###########
#.......ee#
#...#....e#
#...###...#
#.........#
..........#
#..#......#
#..?##....#
#..##.....#
#.........#
#####.#####
enemies 3
door 0 : 0
sign Many have walked this path.

