3
1
#####d#####
#e........#
#.........#
#.........#
#......#..#
..........l
#.#...##..#
#...#.....#
#.........#
#.........#
#####.#####
enemies 1

2
1
###########
#.........#
#...#.#...#
#....#....#
#...#.....#
#..........
#.........#
#.........#
#.........#
#.........#
#####d#####

6
0
#####.#####
#.........#
#.........#
#.........#
#.........#
#..........
#.........#
#.........#
#.........#
#.........#
#####.#####

7
0
#####.#####
#.........#
##........#
#.........#
#.........#
#.........#
#....#....#
#.........#
#.........#
#k........#
###########
key : 2

4
0
#####.#####
###.......#
##..#.....#
#.####....#
#.####....#
#..##@.....
#.#.##....#
#...##....#
#.........#
#.........#
#####.#####

6
1
###########
#........e#
#..#..#..##
#........s#
#.........#
....#..#..#
#.........#
#.........#
#.....#..##
#........e#
###########
enemies 2
switch 1 : 1 2

1
2
#####.#####
#?........#
####......#
###..#....#
#e###.....#
#..........
#.####....#
#.........#
#.....#...#
#.........#
#####.#####
enemies 1
door 1 : 1 2
sign What you seek is close.

2
3
#####.#####
##.....#..#
#.........#
#.........#
#......#..#
.........e#
#.........#
##..#..#..#
#.........#
#.........#
#####.#####
enemies 1
door 0 : 0

1
3
###########
#........k#
#..#......#
#.#.......#
#.........#
..........#
#.........#
#.......#.#
#......#..#
#.........#
#####.#####
key : 8

3
2
#####.#####
#.........#
#......#..#
#.......#.#
#.........#
l.........l
#.........#
#.........#
#.........#
#.........#
#####d#####
locked : 0

4
2
#####d#####
#.#.......#
#.........#
#.........#
#.........#
...........
#..#......#
#.........#
#.........#
#.........#
#####.#####

0
2
###########
#.........#
#.........#
###.#.....#
#.#.#.....#
#..#####..#
#.#.###...#
#...#.....#
#.........#
#.........#
#####.#####

4
1
#####.#####
#.........#
#.........#
##.#......#
#.#..#....#
.....k#....
#....##...#
#.........#
#.........#
#.........#
###########
key : 1

5
0
#####.#####
#.........#
##..#..#..#
#.........#
#.........#
#....#....#
#.........#
#.........#
##..#..#..#
#.........#
#####.#####

3
3
#####.#####
#.........#
#.........#
#.........#
#.........#
l....e....#
#.........#
#.........#
#.........#
#.........#
#####.#####
locked : 1
boss
enemies 1

4
3
#####.#####
#.##......#
#..#......#
#...#.....#
#.........#
..........#
#.........#
#.........#
#.........#
#........X#
###########

2
2
#####.#####
#s#.......#
#.........#
#.#.#...#.#
#.........#
....#.#....
#.........#
#.#...#...#
#.........#
#.......#.#
#####.#####
switch 0 : 0

3
0
###########
#k........#
#.........#
#.#.......#
#.........#
#..........
#.........#
#.#.......#
#..#......#
#.........#
#####.#####
key : 0

5
2
#####.#####
#.........#
#.........#
#.........#
#.........#
#.........#
#.........#
#.#.......#
#..#......#
#?........#
###########
sign Many have walked this path.

