2
2
#####D#####
#.........#
#.........#
#.........#
#..#......#
D.........D
#.........#
#.........#
#.........#
#.........#
#####d#####

2
3
#####D#####
#.........#
#.........#
#.........#
#.#.#.....#
D..##..#..D
#.##......#
#####.....#
#...#.....#
#.........#
#####D#####

2
1
#####D#####
#e.......e#
#.........#
#.........#
#.........#
D.........D
#.........#
#.........#
#.........#
#e........#
#####D#####
enemies 3

1
2
###########
#k#.....#.#
#.........#
#.........#
#....#....#
D.........D
#.........#
#.........#
#.........#
#.........#
#####D#####
key : 2

0
4
###########
#X........#
#.....###.#
#.#.......#
#.....#...#
#.........#
#.......#.#
#.....##..#
#.........#
#.........#
#####D#####

3
1
#####D#####
#.........#
#.........#
#.....###.#
#.........#
D.........D
#.........#
#.........#
#.........#
#.........#
###########

2
4
#####d#####
#e........#
#.........#
#.........#
#.........#
D.........D
#..#......#
###.......#
#.........#
#e........#
#####D#####
enemies 2

0
1
###########
#.........#
##.#......#
#.........#
#...#.#...#
#.........#
#..#.#.#..#
#.........#
#...#.#.#.#
#.........#
#####l#####
locked : 1

2
5
###########
#........e#
#.........#
#.........#
#.........#
D.........#
#.........#
#.........#
#.........#
#........e#
###########
enemies 2

1
4
#####D#####
#.........#
#.........#
#.........#
#.........#
D....e....#
#.........#
#.........#
#.........#
#.........#
#####d#####
boss
enemies 1

3
0
#####D#####
#.........#
#.........#
#.........#
#.........#
#....@....D
#.........#
#.........#
#.........#
#.........#
###########

3
4
#####D#####
##.....#.##
#.........#
##.#.....##
#.........#
l..#.#.#..#
#.........#
##.#.#...##
#.........#
#..#...#..#
###########
locked : 0

3
3
#####D#####
#k#.....#.#
#.........#
#...#.#...#
#.........#
D.....#...l
#.........#
#...#.#...#
#.........#
#.......#.#
#####d#####
key : 0

4
3
#####d#####
#.........#
#.........#
#.........#
#.........#
D....#....#
#.........#
#.........#
#.#.....#.#
#.........#
###########

2
0
###########
#.#.....#.#
#.........#
#..#.#.#..#
#.........#
#...#.....D
#.........#
#..#.....##
#.........#
#.......#.#
#####D#####

3
2
#####d#####
#..#...#.##
#.........#
#.#.#...#.#
#.........#
D.........D
#.........#
#.#.#...#.#
#.........#
#......#.##
#####d#####

1
1
#####l#####
#.........#
#.........#
#.........#
#.........#
#k........D
#.........#
#.........#
#.........#
#.........#
#####D#####
key : 1

4
2
#####d#####
#.........#
#.........#
#.........#
#.........#
#.........D
#.........#
#.#.......#
#..#......#
#.........#
###########

1
3
###########
#k........#
##.#...#.##
#.........#
#...#.#.#.#
D.........D
#..#.#.#..#
#.........#
#...#.#.#.#
#.........#
#####D#####
key : 3

