6
3
#####.#####
#.........#
#.........#
#.........#
#.........#
#.....#...#
#.........#
#.........#
#e........#
#e.......e#
###########
enemies 3
door 0 : 0 1

1
2
###########
#.#.....#.#
#.........#
#.........#
#.#..#..#.#
...........
#.........#
#....#..#.#
#.........#
#.........#
#####.#####

3
2
#####d#####
#........##
#.........#
#.........#
#...#..#..#
#..........
#.........#
#..#..#..##
#.........#
#.........#
#####l#####

4
2
#####l#####
#........##
#.........#
#.........#
#...#..#..#
#..........
#.........#
#.....#..##
#.........#
#.........#
###########
locked : 3

3
3
#####d#####
#.........#
#.........#
#.........#
#.........#
...........
#.........#
#.........#
#.........#
#.........#
#####.#####

2
4
###########
#.##......#
#.###.....#
#.###.....#
#.#.#.....#
l....e....#
#.........#
#.........#
#.........#
#.........#
#####.#####
locked : 1
boss
enemies 1

4
3
#####.#####
#........##
#...#.#.#.#
#...e####.#
#...##e#..#
...........
#...#..#..#
#.........#
#.........#
#......#..#
#####.#####
enemies 2

3
4
#####.#####
####......#
##X.......#
#.#.......#
#.........#
....###...#
#..#.###..#
#..#...#..#
#.....#.###
#.........#
#####.#####

1
1
#####.#####
#.........#
#..#...#..#
#.#.....#.#
#.........#
...........
#.........#
#.......#.#
#......#..#
#.........#
#####.#####

4
4
#####.#####
#.........#
#.........#
#..#..#...#
#.........#
.........e#
#..#..#...#
#.........#
#.........#
#..#.....##
#####.#####
enemies 1

2
3
#####.#####
#.........#
#.........#
#.........#
#.........#
l.........l
#.........#
#.........#
#.........#
#.........#
#####d#####
locked : 2

5
5
###########
#.........#
#.........#
#.#.......#
#..#......#
....##....#
#.........#
###.#.....#
####......#
#.........#
###########
door 1 : 2

5
3
#####.#####
#.........#
#.........#
#.........#
#.........#
#?.........
#.........#
#s#.....#.#
#..#...#..#
#.........#
#####.#####
switch 0 : 0 1
sign The walls are warm to the touch.

1
0
###########
#?........#
#.........#
#.........#
#.........#
#....@.....
#.........#
#.........#
#.........#
#.........#
###########
sign Many have walked this path.

0
1
###########
#k........#
#.........#
#.........#
#.....#.#.#
#..#..#...#
#..###..#.#
#..##..#.##
#.....#...#
#.........#
#####.#####
key : 1

1
3
###########
#..#.....k#
#.###.....#
#.###.....#
#.........#
..........#
#.........#
#.........#
#.........#
#........##
#####.#####
key : 2

2
1
#####.#####
#.........#
#.........#
#.........#
#.........#
#..........
#.........#
#.........#
#.........#
#k........#
###########
key : 0

5
4
#####.#####
#e........#
#.........#
#..#..#..##
#.........#
...........
#..#..#...#
#.........#
#.........#
#e..se....#
###########
enemies 3
switch 1 : 2

2
2
#####.#####
#......#..#
#...#..#..#
#...##.k#.#
#...#..##.#
..........l
#.........#
#.........#
#.........#
#.........#
#####d#####
key : 3

