0
2
###########
#.........#
#..#...#..#
#.#.....#.#
#.........#
#.........D
#.........#
#.........#
#.........#
#.........#
#####d#####

2
0
###########
#.........#
#..#......#
#.#.......#
#.........#
#.........D
#.........#
#.........#
#.........#
#.........#
#####D#####

2
2
#####D#####
#.........#
#.........#
#.#..#..#.#
#.........#
D.........D
#.........#
#.........#
#.........#
#.......#.#
#####D#####

1
3
#####d#####
#.........#
#...#.....#
######....#
#.##......#
d....#....l
#..###....#
#..###....#
#..##.....#
#.........#
#####d#####

4
1
#####D#####
#.........#
#.........#
#...#..#..#
#.........#
D.........#
#.#..#..#k#
#.........#
#.........#
##.....#..#
#####D#####
key : 1

3
0
#####D#####
#.........#
#.........#
#.........#
#.........#
#?...@....D
#.........#
#.........#
#.........#
#.........#
#####D#####
sign What you seek is close.

3
1
#####D#####
#k........#
##.#...#..#
#.........#
#....#.#..#
D.........l
#..#.#.#..#
#.........#
#..#...#.##
#.........#
#####D#####
key : 0

0
3
###########
#.........#
#.........#
#.........#
#.####....#
D...#.#...D
#..#......#
#..#.##...#
#..#......#
#.........#
#####d#####

3
3
#####D#####
#.##......#
#.##......#
#.#...#...#
#..##.....#
D..#.p....#
#.........#
#.........#
#.........#
#........X#
###########

0
4
###########
#........k#
#.........#
#........##
#.........#
D.........#
#...#.....#
#.........#
#.........#
#..#.....##
#####D#####
key : 7

2
3
#####d#####
#.........#
#.........#
#p........#
#...p.....#
D....e....D
#.........#
#.........#
#.........#
#.........#
#####D#####
boss
enemies 1

4
0
#####D#####
#.s#......#
#.#.......#
#e##......#
#e###.....#
#...#.#...D
#.........#
#.........#
#.........#
#.........#
#####D#####
enemies 2
switch 0 : 0

5
0
#####D#####
#.........#
#.#.#.#...#
#.........#
#....#....#
#.........D
#.#.#.#...#
#.........#
#..#.....##
#.........#
###########

3
2
#####D#####
#.........#
#.........#
#..#..#...#
#.........#
l.........D
#......#..#
#.........#
#.........#
#..#.....##
###########
locked : 0

1
4
#####D#####
#.........#
##.#...#..#
#.........#
#....#.#..#
l.........#
#..#.#.#..#
#.........#
##.#...#..#
#.........#
#####D#####
locked : 1

1
2
#####d#####
#.........#
#..#......#
###.......#
#k........#
#...#.....d
#.........#
#.#.......#
#..##.....#
#.........#
#####D#####
key : 4

5
1
#####D#####
#......#..#
#......#..#
#.....##..#
#.........#
D.........#
#.........#
#.........#
#.........#
#.........#
###########

2
4
#####D#####
#.........#
#.........#
#.........#
#.........#
D.....p...#
#.........#
#.........#
#.........#
#.......ee#
###########
enemies 2
door 0 : 0

2
1
###########
#.........#
#..#...#..#
#.#.....#.#
#.........#
D.........D
#.........#
#.........#
#.........#
#.........#
#####D#####

