3
3
#####.#####
#.........#
##..#.....#
#.........#
#.........#
.....#....#
#.........#
#.........#
#...#..#..#
#.........#
###########

0
2
###########
#........k#
#.........#
#.........#
#.........#
..........#
#.........#
#.........#
#.........#
#.........#
#####.#####
key : 3

4
0
#####.#####
#.........#
#...#.#.#.#
#.........#
#e#.#.#.#.#
#.?.......#
#s#.#.#.#.#
#.........#
#...#...#.#
#.........#
#####.#####
enemies 1
switch 0 : 0 1
sign A useful tool lies just ahead.

2
1
#####d#####
#.........#
#..#...#..#
#.#.....#.#
#.........#
...........
#.........#
#.........#
#.........#
#.........#
#####.#####

0
1
###########
#.........#
#..#......#
#.#.......#
#.........#
#..........
#.........#
#.........#
#.........#
#.........#
#####.#####

1
2
#####.#####
#.........#
#.........#
##..#..#..#
#.........#
l.........d
#...#..#..#
#.........#
#.........#
##.....#..#
#####.#####
locked : 1

1
3
###########
#.........#
#.#.#.#.#.#
#.........#
#.#.#.#.#.#
d.........l
#.#.#...#.#
#.........#
#...#.#...#
#.........#
#####d#####

5
0
#####.#####
#.........#
#.#.....#.#
#.........#
#.........#
#....#....#
#.........#
#.........#
#e........#
#e.......e#
###########
enemies 3
door 0 : 0 1

3
0
#####.#####
#.........#
#......#..#
#.......#.#
#.........#
#..........
#.........#
#k#.....#.#
#..#...#..#
#.........#
#####.#####
key : 0

1
1
#####.#####
#k........#
#..#......#
#.#.......#
#.........#
..........l
#.........#
#.........#
#.........#
#.........#
#####d#####
key : 1

1
4
###########
#.........#
##........#
#.........#
#.........#
l.........#
#.........#
#........##
#.........#
#.........#
#####.#####
locked : 3

2
3
#####d#####
#.........#
#.........#
#.........#
#.........#
.....e.....
#.........#
#.........#
#.........#
#.........#
#####.#####
boss
enemies 1

2
4
#####.#####
#......#..#
#.........#
#...#..##.#
#...#####.#
.....##...#
#..#..#...#
#...#####.#
#.......#.#
#........X#
###########

3
2
#####d#####
#......#..#
#.........#
#.........#
#...#.....#
...........
#.........#
#...#.....#
#.........#
#.........#
#####.#####

4
2
#####.#####
#.........#
#.........#
#..#..#..##
#.........#
#.........#
#.....#...#
#.........#
#.........#
#k.#.....##
###########
key : 2

2
2
#####.#####
#.........#
##.....#..#
#.........#
#.........#
.....#.....
#.........#
#.........#
#...#.....#
#.........#
#####d#####

3
1
#####.#####
#.........#
#.........#
#.........#
#.........#
...........
#.........#
#.........#
#.#.#.....#
#.........#
###########

1
0
###########
##.#...#..#
#.........#
#.....#.#.#
#.........#
#..#.#.....
#.........#
#.#.#...#.#
#.........#
##........#
#####l#####
locked : 0

2
0
#####l#####
#.........#
#.........#
#.........#
#.......#.#
#?...@.....
#.........#
#.........#
#.........#
#.........#
#####.#####
sign Turn back; you are not yet ready.

