2
0
#####D#####
#.........#
#.........#
#.#..#..#.#
#.........#
#.........D
#.....#...#
#.........#
#.........#
#k......#.#
###########
key : 0

0
3
###########
#k........#
#..#..##..#
#.#.....#.#
#.........#
#......#..#
#.........#
#.#.......#
#..##.....#
#.........#
#####D#####
key : 2

4
4
#####D#####
#.........#
#...#...#.#
#.........#
#.#.#.#...#
D.........#
#.#.#.#...#
#.........#
#.#...#...#
#........e#
###########
enemies 1
door 1 : 2

4
3
#####D#####
#s.......?#
#.........#
#....#....#
#.........#
D.........D
#..#......#
#.........#
#.........#
#e#.....#e#
#####D#####
enemies 2
switch 0 : 0 1
sign Something glints behind that door…

5
2
#####D#####
#.........#
#.........#
#.........#
#..#......#
#.........D
#.........#
#.........#
#.........#
#X........#
###########

2
1
#####D#####
#.........#
#.........#
##..#.....#
#.........#
D.........D
#......#..#
#.........#
#.........#
##k.......#
###########
key : 1

3
4
###########
#.......se#
#.........#
#.........#
#....#..#e#
D...#.....#
#...##.#..#
#......#..#
#.....#.#.#
#.........#
#####D#####
enemies 2
switch 1 : 2

1
0
#####D#####
##........#
####......#
#####.....#
#?..##....#
#....@....D
#.####....#
#.........#
#.........#
#.........#
#####D#####
sign Those who search shall find.

0
0
###########
#.........#
#.###.##..#
#........##
#....#..#.#
#......#..D
#....####.#
#......#.##
#.........#
#.........#
#####D#####

1
2
###########
#.........#
#.........#
#.........#
#.........#
d..##.....D
#.#.......#
#..#......#
#.........#
#.........#
#####l#####

3
3
#####D#####
#k.#......#
##.##.....#
#...##....#
#.###.....#
D.........D
#.........#
#.........#
#.........#
#.........#
#####D#####
key : 3

1
1
#####D#####
#.........#
#..#......#
#.#.......#
#.........#
D.........d
#.........#
#.#.......#
#..#......#
#.........#
#####D#####

5
3
#####D#####
##.....#..#
#.........#
#.........#
#.........#
D.........#
#.........#
#...#..#..#
#.........#
#........e#
###########
enemies 1
door 0 : 0 1

2
2
#####l#####
#.........#
#.........#
#..#......#
#.........#
D.....#...d
#.........#
#.#.......#
#..#......#
##........#
#####d#####
locked : 0

4
2
#####d#####
#.........#
#.###.....#
#.........#
#.##e.....#
#....#.#..D
#.....##..#
#.........#
#.........#
#.........#
#####D#####
boss
enemies 1

0
1
###########
#.........#
#.........#
#.........#
#...#..##.#
D...#.....#
#....##.#.#
#...##.#..#
#...#..##.#
#.........#
#####D#####

1
3
#####D#####
#..#...#.##
#.........#
#.#.#...#.#
#.........#
D..#.#....#
#.........#
#...#...#.#
#.........#
##.#...#.##
#####D#####

3
2
#####d#####
#......#..#
#......#..#
##........#
#..#......#
#.........D
#.........#
#.........#
#.........#
#.........#
#####d#####

2
3
#####D#####
#.........#
#.........#
#..pp.....#
#.........#
d.........#
#.........#
#.........#
#.........#
#.........#
#####D#####

