2
2
#####D#####
#.........#
#.........#
#.........#
#.........#
l.........D
#.........#
#.........#
#.........#
#.........#
#####D#####
locked : 1

1
1
###########
#e..se....#
#.........#
#.........#
#.........#
D.....p...D
#.........#
#.........#
#.........#
#e........#
#####D#####
enemies 3
switch 0 : 0

1
4
###########
#.........#
#......#..#
#.......#.#
#.........#
D.........d
#.........#
#.#.......#
#..#......#
#.........#
#####D#####

2
3
#####D#####
#.........#
#.........#
#.........#
#.........#
D.........d
#.........#
#.........#
#.........#
#....k....#
###########
key : 2

0
3
###########
#k........#
#.........#
#.........#
#.........#
#.........#
#.........#
#.......#.#
#......#..#
#.........#
#####D#####
key : 3

1
3
#####D#####
#......#..#
#.........#
#.........#
#....#..#.#
D.........D
#.........#
##..#.....#
#.........#
#.........#
#####D#####

1
5
###########
#........##
#..#...##.#
#...##..#.#
#....##...#
d......#..d
#......##.#
#.........#
#.........#
#.........#
#####D#####

2
5
#####D#####
#.........#
#.........#
#.........#
#.........#
D.....##.?#
#......e..#
#......#..#
#.........#
#.........#
#####d#####
enemies 1
sign The dungeon remembers all who enter.

2
0
#####D#####
#.........#
#.........#
#..#......#
#.........#
#..#.@....D
#.........#
#.........#
#.........#
#.........#
#####D#####

1
6
###########
#.........#
#.....##..#
#....#.##.#
#......#..#
d....##...#
#.....##..#
#.........#
#.........#
#..#......#
###########

2
1
#####D#####
#k........#
#.........#
#..#..#...#
#.........#
D.........l
#...#..#..#
#.........#
#.........#
#........##
#####l#####
key : 0

4
5
#####D#####
#.........#
#.........#
#..##.#...#
#...##.#..#
#....#....#
#..#.##...#
#..##..#..#
#.........#
#.......pX#
###########

1
2
###########
#.........#
#.........#
#.........#
#.........#
D.........D
#.........#
#.........#
#.........#
#.........#
#####D#####

3
5
#####d#####
#..#......#
#..#..##..#
#...#..##.#
#...#.#...#
#....e....#
#.........#
#.........#
#.........#
#.........#
#####D#####
boss
enemies 1

3
0
#####D#####
#.........#
#.........#
#..#..#..##
#.........#
#.........D
#.....#...#
#.........#
#.........#
#k.#.....##
###########
key : 1

3
2
#####D#####
#.........#
#.........#
#....#....#
#.........#
D.........#
#.#.....#?#
#.........#
#.........#
#.#....e#e#
###########
enemies 2
door 0 : 0
sign Turn back; you are not yet ready.

1
0
###########
#.#.....#.#
#.........#
#.#.#.#.#.#
#.........#
#...#.#...D
#.........#
#.#.....#.#
#.........#
#.#.....#.#
#####D#####

2
4
#####D#####
#.........#
#.........#
#.........#
#...###...#
d....##...D
#...##.#..#
#...##..#.#
#...#.....#
#.........#
###########

3
1
#####l#####
#.........#
#.........#
#...#.....#
#.........#
D.........D
#.#..#..#.#
#.........#
#.........#
#......#..#
###########
locked : 0

