1
2
###########
#.......###
#.....##.##
#....#....#
#....#.#..#
...........
#.........#
#.........#
#.........#
#.........#
#####.#####

0
1
###########
#........##
#..#..#...#
#.#####...#
#.#.#.....#
......#...#
#..#......#
#..#......#
#.........#
#.........#
#####.#####

1
1
#####.#####
#.........#
##.#...#.##
#.........#
#.#.#...#.#
...........
#..#.#.#..#
#.........#
#.#.#.....#
#.........#
#####d#####

4
2
#####.#####
#........k#
#..#..#..##
#.........#
#.........#
#...#......
#.........#
#.........#
#..#..#..##
#.........#
#####d#####
key : 2

1
3
###########
#?#.....ee#
#........e#
#.........#
#..#..#...#
..........#
#.........#
#.#..#....#
#.........#
#.........#
#####.#####
enemies 3
sign The brave are rewarded.

3
2
#####.#####
#.........#
#.........#
#...###...#
#..##e....#
...###.....
#.####....#
#..###....#
#...#.....#
#.........#
#####.#####
enemies 1

2
1
#####d#####
#.........#
#.....##..#
#.......#.#
#......#..#
...........
#.........#
#.#.....#.#
#..#...#..#
#.........#
#####d#####

5
3
#####d#####
#.........#
#......#..#
#...#.....#
#.........#
.....e....#
#.........#
#.........#
#.........#
#.........#
#####.#####
boss
enemies 1

3
1
#####d#####
#.........#
#...#.#.#.#
#.........#
#..#.#.#..#
#..........
#.#.#.#.#.#
#.........#
#..#...#.##
#.........#
###########

5
2
#####d#####
#.........#
#.........#
#.....#...#
#....###..#
#..##.##...
#..#...#..#
#..#..##..#
#.........#
#.........#
###########

0
0
###########
#?##......#
#...#.#...#
#.##.#....#
#.##..#...#
#..##@#....
#.........#
#.........#
#.........#
#.........#
#####.#####
sign The brave are rewarded.

2
3
#####.#####
#.........#
#.........#
#.........#
#.........#
.........k#
#.........#
#.........#
#.........#
#.........#
#####.#####
key : 1

3
3
#####.#####
#.........#
#.#.#.#.#.#
#.........#
#..#.#.#..#
..........#
#...#...#.#
#.........#
#......#.##
#.........#
#####.#####

2
0
#####.#####
#..#...#.##
#.........#
#....#.#.##
#.........#
#..#.#.#...
#.........#
##.#.#.#.##
#.........#
##.....#..#
###########

2
2
#####.#####
#e##.....##
#.#e#.....#
#.#.......#
#.........#
...........
#..#.#....#
#..?.#....#
#..##.....#
#e........#
#####.#####
enemies 3
sign The brave are rewarded.

4
3
#####.#####
#k#.......#
#.........#
#.#.#.#.#.#
#.........#
..........l
#.........#
#.#...#.#.#
#.........#
#.#.......#
#####d#####
key : 3

4
4
###########
#.........#
#......#..#
#.......#.#
#.........#
l.........#
#.........#
#.........#
#.........#
#.........#
###########
locked : 0

1
0
#####.#####
#.........#
#..#...#k##
#.#.....#.#
#.........#
#..........
#.........#
#.........#
#.........#
#.........#
#####.#####
key : 0

6
3
#####.#####
#.........#
#...#.....#
#.#.#.....#
#.#.#.....#
#.........#
#.........#
#.........#
#.........#
#X........#
###########

