4
0
#####.#####
#.........#
#.........#
#...#..#..#
#.........#
#..........
#.#..#..#.#
#.........#
#.........#
#k.....#..#
###########
key : 0

1
0
#####l#####
#.........#
#k#.#...#.#
#.........#
#..#.#....#
#..........
#...#.#.#.#
#.........#
#..#...#..#
#.........#
#####.#####
key : 3

1
1
###########
#.........#
#.........#
#.........#
#.........#
..........l
#.........#
#.........#
#.........#
#.........#
#####d#####

3
2
#####.#####
#k........#
#......#..#
#.......#.#
#.........#
...........
#.........#
#.........#
#.........#
#.........#
#####.#####
key : 1

2
0
#####.#####
#.........#
#.........#
#..#..#...#
#.........#
#..........
#.........#
#.........#
#.........#
#.........#
#####l#####
locked : 0

4
1
#####.#####
#.........#
#.#.#.#.#.#
#.........#
#..#...#..#
...........
#.#.#.#...#
#.........#
#..#...#.##
#.........#
###########

3
4
###########
#........X#
#.........#
#.........#
#.........#
..........#
#.........#
#.........#
#.........#
#.........#
###########

3
1
#####.#####
#.........#
#......#..#
#.......#.#
#.........#
...........
#.........#
#.........#
#.........#
#.........#
#####.#####

1
3
###########
#....?...e#
#........##
#.........#
#.........#
....#..#...
#.........#
#.........#
#.....#..##
#........e#
#####d#####
enemies 2
door 0 : 0
sign A locked path — look elsewhere first.

2
3
#####d#####
#.........#
#.........#
#.........#
#.........#
..........#
#.........#
#.#.......#
#..#......#
#.........#
#####d#####

3
3
#####d#####
###.......#
#.#.#.....#
#..##.....#
#.#.##....#
.....e.....
#.........#
#.........#
#.........#
#.........#
#####.#####
boss
enemies 1

2
2
#####d#####
##.#.....##
#.........#
##...#.#.##
#.........#
...#...#...
#.........#
##.#.#...##
#.........#
##.#...#..#
#####.#####

4
3
#####.#####
#.........#
#......#..#
#.........#
#.........#
..........#
#.........#
#.#.....#.#
#..#...#..#
#.........#
###########

3
0
#####l#####
#.........#
#.........#
#.....#...#
#.........#
#?...@.....
#.........#
#.........#
#.#.......#
#.........#
#####.#####
sign This room feels watched.

1
2
###########
#.........#
#.....##.##
#....#.#.##
#....#....#
l.....#....
#....#.#..#
#.........#
#.........#
#.........#
#####d#####
locked : 3

0
0
###########
#.........#
#.........#
#.........#
#.........#
#.........#
#.........#
#.........#
#.........#
#.........#
#####l#####
locked : 2

4
2
#####.#####
#.........#
#.........#
#.........#
#....####.#
.....##....
#....###..#
#....##e###
#.......###
#....s...e#
###########
enemies 2
switch 0 : 0

2
1
#####d#####
#..#......#
#.##......#
#..k##....#
#..#......#
...........
#.........#
#.........#
#.........#
#.........#
#####.#####
key : 2

1
4
###########
#.........#
##.#...#.##
#.........#
#..#.#.#..#
..........#
#....#....#
#.........#
##.#...#.##
#.........#
###########

