4
1
#####.#####
#k........#
#.#.......#
#.........#
#.........#
..........l
#.........#
#.#.....#.#
#..#...#..#
#.........#
#####.#####
key : 0

6
3
#####.#####
#.........#
#..#....#.#
#.#.......#
#.........#
..........#
#.........#
#....#..#.#
#...#..#..#
#.........#
###########

3
1
#####.#####
#..#......#
#..##.#...#
#..###....#
#..#.#.#..#
.....#.....
#.........#
#.........#
#.........#
#.........#
#####.#####

2
1
#####d#####
#.........#
#.........#
#...#..#..#
#.........#
...........
#...#.....#
#.........#
#.........#
##.....#..#
#####.#####

6
2
#####.#####
#.........#
##........#
#....#.#..#
#.#####...#
#..#.#.#...
#?#.......#
###.#.....#
##e##....##
#e........#
###########
enemies 2
door 0 : 0
sign Beware what lurks ahead.

4
2
#####l#####
#......#..#
#.........#
#....##...#
#.........#
l..##......
#..#......#
#.#.#.....#
#.........#
#.........#
#####d#####
locked : 1

1
1
#####.#####
#.........#
#.........#
#.........#
#.....###.#
...##e.#..#
#.##.#..#.#
#..#..#...#
#..##.#...#
#.#.......#
#####d#####
boss
enemies 1

5
1
#####.#####
#.........#
#.........#
#.........#
#.........#
...........
#.........#
#.........#
#.........#
#....k....#
###########
key : 2

0
1
###########
#........X#
#........##
#.........#
#.#.#.....#
#..#####..#
#.####....#
#....##...#
#...#...#.#
#.........#
#####.#####

4
3
###########
#........k#
#..##.....#
#..#.##...#
#.#..##...#
.....##...#
#.##.#....#
#.........#
#.........#
#.........#
#####.#####
key : 4

3
2
#####.#####
#.........#
#.........#
#.........#
#..#......#
..........#
#.........#
#.......#.#
#......#..#
#.........#
#####l#####
locked : 4

1
0
###########
#.........#
#.........#
###.#.#...#
#...##....#
#..####....
#.........#
#.........#
#.........#
#.........#
#####l#####
locked : 2

5
2
#####d#####
#.........#
#.........#
#.........#
#.....#.#.#
....#.##...
#......#..#
#.........#
#.........#
#.........#
#####.#####

5
3
#####.#####
#?........#
#.##......#
#..##e#...#
#...###...#
....#.e..s#
#...#.#...#
#.........#
#.........#
#.........#
#####.#####
enemies 2
switch 0 : 0
sign What you seek is close.

2
2
###########
#.........#
##..#.....#
#.........#
#.........#
..........#
#.........#
#.........#
#...#..#..#
#.........#
#####.#####

4
0
#####.#####
#.........#
#.........#
#...#.#...#
#...@###..#
#..?####...
#..#..#.#.#
#....##.#.#
#.....#..##
#........##
#####l#####
sign This door will not yield without a key.

3
0
#####.#####
#.........#
#.........#
#.........#
#.........#
#....###...
#.....#k#.#
#...#.#.#.#
#.....#...#
#.........#
#####.#####
key : 1

5
0
#####l#####
#.........#
#.........#
#.........#
#.........#
#..........
#.........#
#.........#
#.........#
#.........#
###########
locked : 0

2
0
#####l#####
#.........#
#..#..#..##
#.........#
#.........#
#......#...
#.........#
#.........#
#..#.....##
#.........#
#####.#####

