4
3
#####D#####
#.#.....#.#
#.........#
#..#.#.#.##
#.........#
l...#.#...#
#.........#
#..#.#.#..#
#.........#
#.........#
###########
locked : 0

4
0
###########
#ee.......#
#e#.#.#.#.#
#.........#
#...#.#.#.#
#.........D
#...#.#.#.#
#.........#
#.#.#...#.#
#.........#
#####D#####
enemies 3

1
3
###########
#........k#
#.........#
#.#..#....#
#.........#
D.........#
#.#..#..#.#
#.........#
#.........#
#.#.....#.#
#####D#####
key : 3

7
0
#####d#####
#.........#
#.........#
#.........#
#.........#
#.....#...#
#.........#
#.#.......#
#..#......#
#.........#
###########

3
4
###########
#........X#
#.........#
#.........#
#.........#
D.........#
#.........#
#.........#
#.........#
#.........#
###########

5
1
#####D#####
#.........#
#.........#
#.........#
#.........#
D.........D
#.........#
#.........#
#.........#
#.........#
#####D#####

0
2
###########
#e........#
#.........#
#.#..#..#.#
#.........#
#.........#
#..#......#
#.........#
#.........#
#.......#.#
#####D#####
enemies 1
door 0 : 0

3
1
###########
#.........#
#.........#
#.........#
#.........#
#.........D
#.........#
#.........#
#.........#
#.........#
#####d#####

6
1
#####D#####
#.........#
#.........#
#.........#
#.........#
D.........#
#.........#
#.........#
#.........#
#.........#
###########

1
2
#####D#####
#e........#
#...#.....#
#...##....#
#e...##...#
#e........D
#s........#
#?........#
#.........#
#.........#
#####D#####
enemies 3
switch 0 : 0
sign Something glints behind that door…

2
2
#####D#####
#k#.......#
#..#......#
#.#.......#
#.........#
#.........D
#.......#.#
#.#.......#
#..#..#...#
#.........#
#####D#####
key : 1

4
2
#####D#####
#.........#
#.........#
#.........#
#.........#
d.........l
#.........#
#.........#
#.........#
#.........#
#####d#####

4
1
#####d#####
#k........#
#..#...#..#
#.#.....#.#
#.........#
D.........d
#.........#
#.#.....#.#
#..#...#..#
#.........#
#####D#####
key : 0

6
0
#####D#####
##........#
#.........#
#.........#
#...#..#..#
#.........D
#.........#
#...#.....#
#.........#
#.........#
#####d#####

3
2
#####D#####
#.........#
#..#......#
#.#.......#
#.........#
D.........l
#.........#
#.#.......#
#..#......#
#.........#
#####D#####

5
2
#####d#####
#..#...#..#
#.#...#.#.#
#.####....#
#.###..#..#
D.........#
#.........#
#...p.....#
#.........#
#.........#
###########

3
3
#####D#####
###.......#
###.......#
##.##.....#
#..#.##...#
l..#.e#...D
#...#.....#
#.#..##...#
#.##..#...#
#.........#
#####D#####
locked : 1
boss
enemies 1

5
0
#####D#####
#.........#
##.##.....#
##.#......#
#.##@.....#
#....#....D
#.#.......#
#.........#
#.........#
#.........#
#####D#####

2
3
#####D#####
#......##.#
#.......#.#
#......#..#
#.###.#k#.#
D..###....#
#...#.....#
#.........#
#.........#
#.........#
#####D#####
key : 2

