3
0
#####.#####
#.........#
#.........#
#....####.#
#.....##..#
#.....#...d
#.......#.#
#.........#
#.........#
#.........#
#####.#####

1
2
###########
#.........#
#.........#
#.........#
#.........#
...........
#.........#
#.......#.#
#......#..#
#.........#
#####l#####
locked : 0

5
1
#####.#####
#.........#
#.#.#.#.#.#
#.........#
#..#.#....#
#.........#
#...#.#...#
#.........#
#..#...#.##
#e.e.....e#
###########
enemies 3
door 0 : 0

3
2
#####.#####
#e.......s#
#..##.....#
#..###....#
#.........#
..........l
#.........#
#.........#
#.........#
#e........#
#####.#####
enemies 2
switch 0 : 0

4
2
#####.#####
#.........#
#..##..#..#
#..#.#.#..#
#.....#...#
...###....#
#...#.##..#
#.###.....#
#..##.#...#
#.........#
###########

2
1
#####.#####
#.........#
#...#.###.#
#....####.#
#...##k#..#
....#..#...
#......##.#
#.#.......#
#.........#
#.........#
#####.#####
key : 0

2
3
#####d#####
#......##.#
#.........#
#.........#
#.........#
..........d
#.........#
#.........#
#.........#
#.........#
#####.#####

4
1
#####.#####
#.........#
#.........#
#......#..#
#.###..#..#
....#......
#..#......#
#..##.....#
###.#.....#
#k........#
#####.#####
key : 5

0
1
###########
#.........#
#......#..#
#.......#.#
#.........#
#.........#
#.........#
#.......#.#
#......#..#
#.........#
#####d#####

1
1
#####d#####
#.........#
#.........#
#.........#
#.........#
#k.........
#.......#.#
#.........#
#.........#
##.....#..#
#####.#####
key : 2

2
4
#####.#####
#.........#
#..#......#
#.........#
#.........#
d...#.....#
#.........#
#.#.......#
#..#......#
#.........#
###########

1
3
#####.#####
#.........#
#.........#
#.........#
#....###..#
.....e##...
#...#..##.#
#...###.#.#
#...#.#.#.#
#.........#
#####d#####
boss
enemies 1

4
0
#####.#####
#..#......#
#.........#
#.....#...#
#.........#
#..........
#.........#
#.#.....#.#
#..#...##.#
#.........#
###########

2
2
#####l#####
#k........#
#.........#
#.........#
#.........#
...........
#.........#
#.........#
#.........#
#.........#
#####.#####
key : 1

2
0
###########
#?........#
#.........#
#.........#
#.........#
#....@.....
#.........#
#.........#
#.........#
#.........#
#####.#####
sign A useful tool lies just ahead.

1
4
###########
#........X#
#.........#
#.........#
#.#..#....#
.....#....#
#.##.#....#
#.##......#
###.......#
#.........#
#####.#####

3
3
#####.#####
#.........#
#.........#
#.........#
#.........#
l.........#
#.........#
#.........#
#.........#
#.........#
###########
locked : 1

3
1
#####.#####
#.........#
#.........#
#.........#
#.........#
d..........
#.........#
#.........#
#.........#
#.........#
#####.#####

0
3
###########
#.........#
#..#...#.##
#.#.....#.#
#.........#
#.........#
#.........#
#....#....#
#.........#
#.........#
#####.#####

