3
1
#####D#####
##.....#.##
#.........#
#....#.#.##
#.........#
D..#.#....#
#.........#
#..#...#.##
#.........#
#......#.##
#####D#####

2
0
#####D#####
#.........#
#.........#
#.........#
#.........#
#.........D
#.........#
#.........#
#.........#
#.........#
#####d#####

6
0
#####d#####
#.#.....#.#
#.........#
#....#.#.##
#.........#
#...#.#...D
#.........#
#..#...#.##
#.........#
#.#.....#.#
###########

1
0
#####D#####
#.........#
#.........#
#.........#
#.........#
#.........#
#.........#
#.........#
#.........#
#.........#
#####D#####

2
1
###########
##.....#.##
#.........#
##...#...##
#.........#
D..#.#.#..#
#.........#
#..#.#....#
#.........#
##.#...#.##
#####D#####

4
2
###########
#.........#
#......#..#
#.......#.#
#.........#
D.........D
#.........#
#.........#
#.........#
#.#.......#
#####D#####

3
0
#####d#####
#.........#
#.#.......#
#.........#
#.........#
#....@....D
#.........#
#.........#
#.........#
#.........#
#####D#####

6
1
#####D#####
#.........#
#...#.#.#.#
#.........#
#.#.#.#.#.#
D.........D
#.#...#.#.#
#.........#
#.#.......#
#.k.......#
###########
key : 3

4
3
#####d#####
#e.......?#
##.......##
#.........#
#.#.#.#.#.#
D.........#
#..#...#..#
#.........#
#.#.#...#.#
#.........#
#####D#####
enemies 1
sign The brave are rewarded.

5
1
#####D#####
#.........#
#.........#
#.........#
#.........#
d.........D
#.........#
#.........#
#.........#
#.........#
#####D#####

6
2
#####D#####
#.........#
#...#.##..#
#.p.#.....#
#..##.....#
D.........#
#.........#
#.........#
#........?#
#.p.....ee#
###########
enemies 2
door 0 : 0
sign What you seek is close.

3
3
#####D#####
#.........#
#...#.#...#
#.........#
#..#......#
#...#e....#
#.........#
#..p......#
#.........#
#.p.......#
#####d#####
boss
enemies 1

2
3
###########
#X........#
#.........#
#.........#
#.#.......#
#..##.....#
#.####.#..#
#...##.#..#
##.##.##..#
#......#..#
#####D#####

5
0
#####D#####
#.........#
#.........#
#..#.#....#
#....#....#
#..#.#k#..d
#.....#.#.#
#.....#...#
#.........#
#.........#
#####d#####
key : 0

5
3
#####D#####
#.........#
#.........#
#.........#
#.........#
D...#.....#
#.........#
#.#.......#
#..#......#
#........k#
###########
key : 6

0
0
###########
#k........#
#.........#
#.........#
#.....#...#
#.........#
#.........#
#..#..#...#
#.........#
#.........#
#####D#####
key : 2

4
1
#####D#####
#.........#
#.........#
##.....#..#
#.........#
l.........D
#.#..#..#.#
#.........#
#.........#
##.....#..#
#####D#####
locked : 0

4
0
#####D#####
#.........#
#.........#
#.........#
#.........#
#.........l
#e##......#
#.###.....#
#.#.#.....#
#?#.......#
#####D#####
enemies 1
sign This door will not yield without a key.

5
2
#####D#####
#e........#
#...#.###.#
#..?#.....#
#.##..###.#
D..#......D
#.........#
#.........#
#.........#
#s........#
#####D#####
enemies 1
switch 0 : 0
sign A useful tool lies just ahead.

