3
1
#####.#####
#k#.....#.#
#.........#
#.........#
#.#.....#.#
..........l
#.........#
#.#..#..#.#
#.........#
#.........#
#####.#####
key : 2

1
1
#####.#####
#k.#.....##
#.........#
#.........#
#..#..#...#
..........d
#.........#
#..#..#..##
#.........#
#.........#
#####.#####
key : 3

2
2
#####.#####
#.........#
#.........#
#...#..#..#
#.........#
...........
#.#..#..#.#
#.........#
#.........#
##.....#..#
#####.#####

4
3
#####d#####
#.........#
#.........#
#.........#
#.........#
l.........d
#.........#
#.........#
#.........#
#.........#
#####.#####
locked : 2

2
3
###########
#........X#
#.....#.#.#
#.....#...#
#...##.#..#
.......#..#
#.........#
#.........#
#.........#
#.........#
#####.#####

3
0
#####.#####
#.........#
#.........#
#..#..#...#
#.........#
#..........
#..#..#...#
#.........#
#.........#
#k.#.....##
###########
key : 1

5
2
#####.#####
#.........#
#...#.....#
##..#..##.#
#...####..#
....##.#...
#...##.#..#
##........#
#.........#
#.........#
###########

5
3
#####.#####
#.........#
#.........#
#.........#
#.........#
..........#
#...#.....#
#.##......#
#........?#
#.......ee#
###########
enemies 2
door 0 : 0 1
sign A locked path — look elsewhere first.

3
3
#####.#####
#..#......#
##.##.....#
##.##.....#
#...#.....#
.....e....#
#.#.......#
#..#......#
##.#...#..#
#.........#
#####d#####
boss
enemies 1

2
1
#####.#####
#.........#
#.........#
#.........#
#.........#
...........
#.........#
#.........#
#.........#
#.........#
#####.#####

4
1
#####.#####
#.........#
#.........#
#.........#
#.........#
#.?##......
#s#e#.....#
#.#.#.....#
#.........#
#.........#
#####l#####
enemies 1
switch 0 : 0 1
sign A locked path — look elsewhere first.

2
0
#####.#####
#.........#
####......#
#.........#
#...#.....#
#....@.....
#....###..#
#....#.#..#
#.........#
#.........#
#####.#####

0
1
###########
#.........#
#.........#
#.........#
#.........#
#.........#
#.........#
#.........#
#.........#
#.........#
#####.#####

5
1
#####l#####
#.#.....#.#
#.........#
#.#...#.#.#
#.........#
#...#.#....
#.........#
#.#...#.#.#
#.........#
#.#.....#.#
###########
locked : 3

1
0
###########
#k.......##
#.........#
#.........#
#..#..#...#
#..........
#.........#
#..#..#..##
#.........#
#.........#
#####.#####
key : 0

1
2
###########
#.........#
#..#...#..#
#.#.....#.#
#....#....#
d.........#
#.#.......#
#.#.......#
#..#......#
#.........#
#####.#####

3
2
#####.#####
#.........#
#.#.....#.#
#.........#
#.........#
l.....#....
#.........#
#.........#
#.......#.#
#.........#
#####d#####
locked : 1

4
2
#####d#####
#.........#
#...#.#.#.#
#.........#
#...#.....#
..........l
#.#.#.#.#.#
#.........#
#.#.#.#.#.#
#.........#
#####.#####

4
4
###########
#.........#
#.........#
#.........#
#.........#
d.........#
#.........#
#.........#
#.........#
#.........#
###########

