4
1
#####.#####
#e#.......#
#.........#
#.........#
#e#..#..#.#
#..........
#.........#
#?#..#..#.#
#.........#
#.........#
#####.#####
enemies 2
sign Only the prepared may pass.

1
3
#####.#####
#.........#
#.#.#.#...#
#.........#
#..#...#..#
..........#
#.#.#.#...#
#.........#
#..#...#.##
#......?.e#
###########
enemies 1
sign Seek the matching key before you proceed.

3
3
###########
#.........#
#......#..#
#.......#.#
#.........#
..........#
#.........#
#.........#
#.........#
#.........#
###########

5
2
#####.#####
#.........#
#.........#
#.....#...#
#.........#
d.........#
#...#..#..#
#.........#
#.........#
#..#.....##
###########

6
1
#####d#####
##.#......#
##..#..#..#
#..##.....#
#.###.....#
#..#.e....#
#..#......#
#.##......#
#.........#
#.........#
#####.#####
boss
enemies 1

5
1
#####.#####
#.........#
#.#.#.#...#
#.#?##....#
#..####...#
#.e##.....d
#e#...#...#
#.........#
#.........#
#.........#
#####d#####
enemies 2
sign Many have walked this path.

0
3
###########
#........k#
#......#..#
#.........#
#.........#
....#..#..#
#.........#
#.........#
##.....#..#
#.........#
#####.#####
key : 3

2
0
#####.#####
#.........#
#.........#
#.........#
#.........#
#..........
#.........#
#.........#
#.........#
#.........#
###########

1
0
#####.#####
#.........#
#.........#
#....##...#
#.##......#
#...#@#....
#...#.....#
#...##....#
#.........#
#.........#
#####.#####

3
2
#####.#####
#.........#
#..#...#..#
#.#.....#.#
#.........#
d..........
#.........#
#.......#.#
#......#..#
#.........#
#####l#####

7
1
#####.#####
#.........#
#.........#
#.#.......#
#.#.......#
#..###.#..#
#...##.#..#
##.####...#
#.........#
#......##X#
###########

4
2
#####l#####
#.........#
#..#......#
#.#.......#
#.........#
..........#
#.........#
#.##....#.#
#..#...#..#
#.........#
#####.#####
locked : 3

0
0
###########
#.........#
#.........#
#.........#
#.........#
#.........#
#.........#
#.......#.#
#......#..#
#.........#
#####.#####

1
1
###########
#k........#
##.....#.##
#.........#
#..#.#....#
..........l
#..#...#..#
#.........#
##.#.....##
#.........#
#####d#####
key : 0

3
1
#####.#####
#.........#
#..#......#
#.#.......#
#.........#
#.........d
#.........#
#.......#.#
#......#..#
#.........#
#####.#####

1
2
#####.#####
#.#.......#
#......##.#
#....#...##
#......#..#
l.....#....
#....##.#.#
#.....#...#
#.....#...#
#.........#
#####.#####
locked : 0

0
2
###########
#k........#
#.........#
#.........#
#.........#
#....#.....
#.........#
#.........#
#.........#
#.........#
#####.#####
key : 2

2
1
#####d#####
#.........#
#.#.#.#.#.#
#.........#
#..#.#.#..#
...........
#.#.#.#.#.#
#.........#
#..#...#..#
#.........#
#####.#####

2
2
#####.#####
#.........#
#.........#
#.........#
#.........#
..........#
#.........#
#.#.....#k#
#..#...#..#
#.........#
#####.#####
key : 1

