2
1
#####.#####
#.........#
#.##......#
###.#.##..#
#.#..#....#
l..#.###...
#..#......#
#.........#
#.........#
#.........#
#####.#####
locked : 0

4
2
#####.#####
#.........#
#.........#
#.........#
#.........#
..........#
#.........#
#.........#
#.........#
#........k#
###########
key : 3

8
1
#####.#####
#.........#
#.........#
#.........#
#.........#
#.........#
#.........#
#.........#
#.........#
#X........#
###########

5
0
#####.#####
#.........#
#.........#
#.........#
#...#...#.#
#..####....
#..####...#
######....#
#.......#.#
#.........#
#####l#####

2
0
#####d#####
#.........#
#.........#
#.........#
#.........#
#.........l
#.........#
##..#.....#
#####.....#
####......#
#####.#####

2
2
###########
#.........#
#.........#
#.........#
#.........#
..........#
#.........#
#.........#
#.........#
#.........#
#####l#####
locked : 3

1
0
#####.#####
#.........#
#......#..#
#.......#.#
#.........#
#..........
#.........#
#.#.......#
#..#......#
#.........#
#####d#####

4
1
#####.#####
#.........#
#.........#
#.........#
#.........#
l..........
#.........#
##........#
#.....#...#
#.........#
#####.#####
locked : 1

3
0
#####.#####
#.........#
#..#......#
#..#......#
#....#....#
#?...@.....
#.........#
#.........#
#.........#
#.........#
#####.#####
sign A useful tool lies just ahead.

3
2
#####l#####
#.........#
#.........#
#.........#
#.........#
..........#
#.........#
#.......#.#
#......#..#
#.........#
#####.#####

0
0
###########
#e.....#..#
#...#...#.#
#...#.....#
#s#.......#
#..........
#.........#
#.........#
#.........#
#.........#
#####.#####
enemies 1
switch 0 : 0 1

5
1
#####.#####
#.........#
#...#..#..#
#.........#
#.........#
.....#....#
#.........#
#.........#
##..#....e#
#.......ee#
###########
enemies 3
door 0 : 0 1

7
0
#####.#####
#.........#
#......#..#
#.......#.#
#.........#
#.........d
#.........#
#.........#
#.........#
#.........#
###########

7
1
###########
#.........#
#.........#
#.........#
#.........#
d....e....#
#.##......#
#.#.......#
#.........#
#.........#
#####.#####
boss
enemies 1

6
0
#####l#####
##.....#..#
#.........#
#.........#
#...#.....#
#.........#
#.........#
##..#..#..#
#.........#
#.........#
#####.#####
locked : 2

0
1
###########
#.........#
#.........#
#.........#
#.........#
..........#
#.........#
#.#.......#
#..#......#
#.........#
#####d#####

1
1
#####d#####
#.........#
#.........#
#..#..#..##
#........k#
..........#
#...#.....#
#.........#
#.........#
#..#.....##
#####.#####
key : 2

3
1
#####.#####
#k........#
#.........#
#.........#
#.........#
...........
#.........#
#.......#.#
#......#..#
#.........#
#####.#####
key : 0

4
0
#####.#####
#.........#
#.#.#.#.#.#
#.........#
#k#...#.#.#
#.........l
#.#.#.#.#.#
#.........#
#.....#.#.#
#.........#
#####.#####
key : 1

