5
1
#####D#####
#.........#
##.#...#.##
#.........#
#....#.#..#
D.........D
#..#.#.#..#
#.........#
#..#...#.##
#.........#
#####d#####

3
4
#####D#####
#.........#
#.....#...#
#......##.#
#....#.#..#
l....###..#
#....#..#.#
#.........#
#.........#
#.........#
###########
locked : 2

4
0
#####D#####
#.........#
##.....##.#
#.......#.#
#.........#
#.........D
#.........#
#.......#.#
##.....#..#
#.........#
#####D#####

2
4
###########
#........X#
#.........#
#.#.......#
#.........#
D...#.#...#
#....##...#
#...###...#
#.........#
##........#
#####D#####

0
2
###########
#e.....#ee#
#...#..#..#
#....#.#..#
#...#.##..#
#.........#
#......#..#
#.........#
#...#.....#
#.........#
#####D#####
enemies 3
door 0 : 0

4
3
#####D#####
#.........#
#......#..#
#.......#.#
#....#....#
D.........#
#.........#
#.......#.#
#......##.#
#........k#
###########
key : 4

6
1
#####d#####
#.........#
#.........#
#.........#
#.........#
D...###...#
#...###...#
#.........#
#.........#
#.........#
###########

6
0
#####D#####
####......#
#..#......#
##........#
#.........#
#.........D
#.........#
#.........#
#.........#
#.........#
###########

3
0
###########
#.........#
#......#..#
#.......#.#
#.........#
#.........#
#.........#
#.........#
#.........#
#.........#
#####D#####

4
2
#####D#####
#.#.......#
#.#.#.....#
#.##.#....#
#.##.#....#
D..#.#....D
#..#.#....#
#.........#
#.........#
#.........#
#####d#####

2
3
#####D#####
#......#..#
#.........#
#.........#
#.........#
D....e....D
#.........#
#.........#
#.........#
#.........#
#####d#####
boss
enemies 1

5
0
#####D#####
#.........#
#.##......#
#..###....#
#.###.....#
#....@....D
#.........#
#.........#
#...p.....#
#.........#
#####D#####

3
2
#####d#####
##.....#..#
#.........#
#.........#
#k#.....#.#
#.........D
#.........#
#...#.....#
#.........#
#.........#
#####D#####
key : 2

1
3
###########
#.........#
#.........#
#.........#
#.........#
D.........#
#.........#
#.......#.#
#......#..#
#.........#
#####D#####

1
2
#####D#####
#e#.......#
#.........#
#....#.#.##
#.........#
#?..#.#...D
#.........#
#....#.#..#
#.........#
#e#.....#s#
#####D#####
enemies 2
switch 0 : 0
sign Beware what lurks ahead.

2
2
#####D#####
#..#......#
#..#......#
#..##.....#
#.........#
#.........D
#.........#
#.........#
#.........#
#.........#
#####d#####

5
2
#####d#####
#.......#.#
#.........#
#..#.#.#.##
#.........#
D...#.#...#
#.........#
#..#...#.##
#.........#
#.#.....#.#
###########

4
1
###########
#..k......#
#..#......#
#.#.......#
#.........#
D.........D
#.........#
#.......#.#
#......#..#
#.........#
#####D#####
key : 0

3
3
#####d#####
#k........#
#..#......#
#.#.......#
#.........#
D.........l
#.........#
#.#.......#
#..#......#
#.........#
#####D#####
key : 3

