3
0
#####l#####
#.........#
#..#...#..#
#.#.....#.#
#.........#
#.........#
#.........#
#.......#.#
#......#..#
#.........#
#####D#####

5
0
#####D#####
#.........#
#.........#
#.........#
#.........#
#.........D
#.........#
#.#.......#
#..#......#
#.........#
###########

2
0
#####D#####
##.#...#..#
#.........#
##.#.#.#.##
#.........#
#..#.#....l
#.........#
##.#.#.#..#
#.........#
##.#...#..#
#####l#####
locked : 0

4
2
###########
#.......#.#
#.........#
#..#.#.#.##
#.........#
D...#.#...D
#.........#
#..#.#.#.##
#.........#
#k#.......#
#####D#####
key : 0

5
2
#####D#####
#.........#
#.........#
##..#..#..#
#.........#
D.........d
#...#..#..#
#.........#
#.........#
##k.......#
###########
key : 1

1
1
###########
#...k.....#
#.#.#.#.#.#
#.........#
#..#.#.#..#
D.........d
#.#...#.#.#
#.........#
#..#.....##
#.........#
#####D#####
key : 2

4
0
#####D#####
#.........#
#.#.......#
#..##.....#
#.##......#
#...#@....D
#...#.....#
#.........#
#.........#
#.........#
#####D#####

1
0
#####d#####
#.........#
#.........#
#.........#
#.........#
#.........D
#.........#
#.#....##.#
#..#...#..#
#.........#
#####D#####

5
3
#####d#####
#.........#
#.........#
#.........#
#.........#
d..#......D
#.........#
#.......#.#
#...#..#..#
#.........#
#####D#####

5
1
#####D#####
#.........#
#.........#
##..#..#..#
#.........#
D.........D
#.#..#..#.#
#.........#
#.........#
#.........#
###########

3
3
#####D#####
#.........#
#.....#...#
#.####....#
#.##......#
#...#e....#
#.........#
#####.....#
#.......#.#
#.........#
#####l#####
locked : 2
boss
enemies 1

1
2
###########
#.........#
#.#.....#.#
#.........#
#.........#
d..#......#
#.........#
#.........#
#.......#.#
#.........#
###########

6
3
#####D#####
#.........#
#......#.##
#...#...#.#
#.........#
#.........#
#.........#
#.........#
#.........#
##.......k#
###########
key : 3

2
3
###########
#X........#
#.###.#...#
#.##.#.p..#
#.##......#
#.........#
#.........#
#.........#
#.........#
#.........#
#####D#####

0
0
###########
#.........#
#..#......#
#.#.......#
#.........#
#.........#
#.........#
#.......#.#
#......#..#
#.........#
#####d#####

4
1
###########
#......#..#
#.....#...#
#....#....#
#.....#...#
D..##.#...D
#..#.#....#
#.#.......#
#.##......#
#.........#
#####D#####

2
1
#####D#####
#.........#
##.#...#.##
#.........#
#..#.#.#..#
l.........#
#..#.#.#..#
#.........#
##.....#.##
#.........#
###########
locked : 1

4
3
#####l#####
#.........#
#..##.#...#
#.....#...#
#...##....#
D...###...#
#.#####...#
#..###.#..#
#..#......#
#......#..#
#####d#####

5
4
###########
#......#..#
#.........#
#.........#
#.#.#.....#
D...#.....#
#.#.......#
#.........#
#.........#
#.........#
###########

