3
2
#####D#####
#.........#
#..#......#
#.#.......#
#.........#
D.........D
#.........#
#.......#.#
#......#..#
#.........#
#####l#####

3
3
###########
#...k.....#
#..##.....#
#.#.......#
#.........#
D.........D
#.........#
#........##
#.......#.#
#.........#
###########
key : 1

2
0
#####D#####
#.........#
#..#...#..#
#.........#
#.........#
#....@....D
#.........#
#.........#
#.........#
#.........#
###########

5
4
#####D#####
#.........#
#...#...#.#
#.........#
#...#...#.#
#.........#
#.#.#.#...#
#.........#
#e#.#.#.#.#
#e?......e#
###########
enemies 3
sign Many have walked this path.

2
1
#####D#####
#.........#
#...#..#..#
#.......#.#
#.........#
D.........D
#..#......#
#.........#
#.........#
#........##
#####l#####

3
6
###########
#.........#
#.#.......#
#.........#
#.#.#.#.#.#
d.........#
#.#.#...#.#
#.........#
#.#.#.#...#
#.........#
###########

4
5
#####d#####
#.........#
#..#...#..#
#.#.....#.#
#.........#
D.........#
#.........#
#.........#
#.........#
#.........#
###########

2
2
###########
#..#...#.k#
#.........#
##.....#.##
#.........#
D..#......#
#.........#
##.#.#.#..#
#.........#
##.#...#..#
#####D#####
key : 0

3
1
#####l#####
#.........#
#.........#
#.........#
#.........#
#.........D
#.........#
#.#.......#
#..#......#
#.........#
###########
locked : 0

1
0
#####d#####
#..#......#
#..##.....#
#..#..#...#
#..#..#...#
#.........d
#.........#
#.........#
#.........#
#.........#
#####D#####

3
4
###########
#e..?e....#
#.........#
#.........#
#.........#
D.........D
#.........#
#.........#
#.........#
#e........#
#####D#####
enemies 3
sign A useful tool lies just ahead.

1
1
###########
#.........#
#.#...#...#
#...###...#
#.........#
d..#.##...#
#.##.#....#
#.........#
#.........#
#.........#
#####D#####

2
5
#####D#####
#.........#
#.........#
#..#..p...#
#..#......#
#..#.e....#
#.........#
#.........#
#.p.......#
#.........#
#####l#####
locked : 5
boss
enemies 1

3
5
#####l#####
#k##......#
#.....#...#
#.#.#.....#
#...#.....#
D.........d
#.........#
#.........#
#.........#
#.........#
#####d#####
key : 5

1
5
###########
#X........#
#.........#
#.........#
#.........#
#.........#
#.........#
#.........#
#.........#
#.........#
#####D#####

4
2
#####l#####
#.........#
#.........#
#.........#
#.........#
#.........#
#.........#
#.......#.#
#......#..#
#.........#
#####D#####
locked : 1

4
4
#####D#####
#.......#.#
#.........#
#..#...#.##
#.........#
#...#.#...D
#.........#
#..#.#.#.##
#.........#
#.#.....#.#
#####D#####

5
2
#####D#####
#.........#
#......#..#
#.#.....#.#
#.........#
#....#....#
#.........#
#.#......##
#..#......#
#k........#
###########
key : 3

0
0
###########
#.........#
#.........#
#.#.#.#.#.#
#.........#
#.....#...#
#.........#
#.#.#.#...#
#.........#
#.#.....#.#
#####d#####

