2
4
#####.#####
#.........#
#.........#
#.........#
#...###...#
d..###.....
#..#......#
#...#.#...#
#..#..#...#
#.........#
#####.#####

3
0
#####.#####
#.#.......#
#.........#
#.........#
#..#......#
#..#.......
#....##...#
#.###.....#
#...#.....#
#.........#
###########

3
3
#####.#####
#.........#
#......#..#
#......##.#
#......#..#
...........
#.........#
#.#.......#
#..#......#
#..k......#
###########
key : 3

1
4
###########
#..#s..?ee#
#........e#
#.........#
#.........#
..........#
#.........#
#.........#
#.........#
#.........#
#####.#####
enemies 3
switch 0 : 0
sign Seek the matching key before you proceed.

3
2
#####.#####
#.........#
#.........#
#.........#
#.##......#
d...##.....
#.#..#....#
#..#......#
##........#
#.........#
#####.#####

2
5
###########
#......##k#
#......##.#
#....####.#
#...#..#..#
...#......#
#.........#
##.##.....#
##..#.....#
#.........#
###########
key : 4

0
3
###########
#X........#
#.........#
#.........#
#.........#
#.........#
#.........#
#.........#
#.........#
#.........#
#####.#####

4
1
#####d#####
#.........#
#......#..#
#.......#.#
#.........#
#..........
#.........#
#.........#
#.........#
#.........#
###########

4
2
#####.#####
#.........#
#..#......#
#.#.......#
#.........#
..........#
#.........#
#.......#.#
#......#..#
#........k#
###########
key : 2

1
0
###########
#.........#
#..#...#..#
#.#.....#.#
#.........#
#..........
#.........#
#.........#
#.........#
#.........#
#####d#####

2
2
#####.#####
#.........#
#.........#
#.........#
#.........#
...........
#.........#
#.......#.#
#......#..#
#.........#
#####.#####

1
2
###########
#.........#
##.#...#.##
#.........#
#.#.#.#.#.#
..........l
#..#.#.#..#
#.........#
#.#.#.....#
#.........#
#####.#####

3
4
#####.#####
#.........#
#.........#
#.........#
#.........#
..........#
#.........#
#.........#
#........e#
#......?ee#
###########
enemies 3
door 0 : 0
sign A useful tool lies just ahead.

2
3
#####.#####
#e........#
#.........#
#.........#
#.#.......#
...#......d
#.#...#...#
#.......#.#
#.........#
#e........#
#####.#####
enemies 2

3
1
#####.#####
#.........#
#.....#...#
#.#.###...#
#.#k#.#...#
...##.....d
#.........#
#.........#
#.........#
#.........#
#####d#####
key : 0

2
0
#####d#####
#.........#
#?#.......#
#.........#
#.........#
#....@.....
#.........#
#.........#
#.........#
#.........#
#####.#####
sign Beware what lurks ahead.

1
1
###########
##.#.....##
#.........#
#...#.#.#.#
#.........#
.....#.#...
#.........#
#.....#...#
#.........#
#..#......#
#####.#####

1
3
#####.#####
#......#..#
#.....##..#
#.....###.#
#.....#.#.#
l....e.....
#.........#
#.........#
#.........#
#.........#
#####.#####
locked : 0
boss
enemies 1

2
1
#####.#####
#e.......?#
#.........#
#..#......#
#.........#
...........
#.........#
#.........#
#.........#
#e........#
#####.#####
enemies 2
sign Something glints behind that door…

