1
3
#####.#####
#k........#
#.........#
#.........#
#.........#
..........d
#.........#
#.........#
#.........#
#.........#
#####.#####
key : 5

1
0
###########
#?........#
#.##..#...#
#.........#
#.##@#....#
#....##....
#.##.#....#
#.........#
#.....#...#
#.........#
#####.#####
sign Beware what lurks ahead.

3
1
#####.#####
#k#.......#
#.........#
#.#...#.#.#
#.........#
....#.#....
#.........#
#.#.#.#.#.#
#.........#
#.#.....#.#
###########
key : 4

0
3
###########
#.........#
#.........#
#.........#
#.####....#
.....#.....
#.#.##....#
##e###....#
##........#
#e........#
#####.#####
enemies 2

3
2
#####.#####
#........##
####....###
##.#.###..#
#..###.##.#
..........#
#.##.#....#
#.........#
#.........#
#..#......#
#####d#####

1
4
#####.#####
#......####
#.....#...#
#.....#.###
#.....#.#.#
d....e#...#
#.........#
#.........#
#.........#
#.........#
#####.#####
boss
enemies 1

0
2
###########
#.........#
#.##......#
#..#......#
#..##.....#
...........
#..#.#....#
#..##.....#
#..##.....#
#.........#
#####.#####

2
1
#####.#####
#.........#
#.......#.#
#.........#
#.........#
...#..#....
#.........#
#.........#
#.#.....#.#
#.........#
#####.#####

2
0
#####.#####
#.........#
#.........#
#.........#
#.........#
#....#.....
#....###..#
#....##.#.#
#.....#...#
#.........#
#####.#####

1
1
#####d#####
#.........#
#.........#
#.........#
#....#....#
.....##....
#.....#...#
#.........#
#.........#
#.........#
#####.#####

0
4
###########
#........X#
#.........#
#......#..#
#.........#
..........#
#.........#
#.........#
#.........#
#.#.......#
#####.#####

0
1
###########
#.........#
#.#.#.#...#
#.........#
#..#......#
#..........
#.#.#...#.#
#.........#
#..#.....##
#.........#
#####d#####

3
0
#####.#####
#s........#
#..#..#...#
#.........#
#.........#
#e..#..#...
#.........#
#.........#
#..#..#..##
#........e#
#####d#####
enemies 2
switch 0 : 0 1

4
0
#####d#####
#.........#
#.........#
#.........#
#.........#
#.........#
#.#.......#
#.#.......#
##........#
#.........#
###########

1
2
#####.#####
#k........#
#.........#
#.........#
#..#......#
...........
#.#.......#
#..#......#
#.........#
#.........#
#####.#####
key : 0

2
3
#####.#####
#.........#
#.........#
#.........#
#.........#
..........l
#..#......#
#.........#
#.........#
#e#?....#e#
###########
enemies 2
door 0 : 0 1
sign Only the prepared may pass.

2
4
#####.#####
#.........#
#.........#
#.#.......#
#..#......#
l..#......#
#.........#
#.........#
#.........#
#.........#
###########
locked : 0

2
2
#####.#####
#k........#
#.........#
#.........#
#.........#
...........
#.........#
#.........#
#.........#
#.........#
#####.#####
key : 1

4
2
#####d#####
#.........#
#.###..#..#
#..#...##.#
#.#####.#.#
#...#.#...#
#..#......#
#.......#.#
#.........#
#.........#
###########

