2
3
###########
#........e#
#.....#..##
#........s#
#.........#
D..#......#
#.........#
#.........#
#..#..#..##
#........e#
###########
enemies 2
switch 0 : 0

6
4
###########
#.........#
#.........#
#.........#
#..###....#
d..####...#
#.###.....#
#.##..#...#
#.#...#...#
#.........#
###########

7
3
#####D#####
#.#.......#
#..##.....#
#..####...#
#...###...#
#..####...#
#.........#
#.........#
#.........#
#k........#
###########
key : 2

2
1
#####l#####
#.........#
#..#...#..#
#.#.....###
#.........#
#.........d
#.........#
#.........#
#.........#
#.........#
#####D#####

5
1
#####D#####
#.........#
#.......#.#
#.....##..#
#.....#...#
#..#.@....D
#.........#
#?#.......#
#.........#
#.........#
#####D#####
sign The brave are rewarded.

5
3
###########
#........##
#.....##..#
#.......#.#
#.........#
D.........#
#.........#
#.......#.#
#......#..#
#.........#
#####d#####

6
3
#####d#####
#.........#
#..#......#
#.#.......#
#.........#
l.........d
#.........#
#.#.......#
#..#......#
#.........#
#####D#####
locked : 1

6
2
#####D#####
#.........#
#.........#
#.........#
#.........#
D.........l
#.........#
#.........#
#.........#
#....k....#
###########
key : 1

6
1
#####D#####
#.........#
#.......###
#.........#
#.........#
#.........D
#.........#
#.#.......#
#..#......#
#.........#
###########

3
2
#####D#####
##.....#..#
#.........#
#.#...#...#
#.........#
d....#.#..#
#.........#
#.#.....#.#
#.........#
#......#.##
###########

5
2
###########
#.........#
#.........#
##..#.....#
#.........#
D.........D
#.#.......#
#.........#
#.........#
##.....#..#
#####D#####

2
2
#####D#####
##.#.....##
#.........#
#.#.....#.#
#.........#
d..#.#.#..D
#.........#
#.#.#.#.#.#
#.........#
##.#...#.##
#####D#####

0
1
###########
#k........#
#......#..#
#.......#.#
#.........#
#.........D
#.........#
#.#.......#
#..#......#
#.........#
#####D#####
key : 4

1
0
###########
#X........#
#.........#
#.........#
#.#.###...#
#....##...D
#..#.##...#
#.####....#
#..#......#
#.........#
###########

1
2
#####D#####
#e........#
#.........#
##..#.....#
#.........#
D........e#
#...#..#..#
#.........#
#.........#
#?.....#..#
#####D#####
enemies 2
door 0 : 0
sign This door will not yield without a key.

4
1
#####D#####
#.........#
#......#..#
#.......#k#
#.........#
#.........#
#.........#
#.........#
#.........#
#.........#
#####D#####
key : 0

1
1
#####D#####
#.........#
#.........#
##.#......#
#...#.....#
D...#e....D
#.........#
####.#....#
#.........#
#.........#
#####l#####
locked : 2
boss
enemies 1

0
2
###########
#..#?...e##
#........e#
#.........#
#..#..#...#
D.........#
#.........#
#.....#..##
#.........#
#.........#
#####D#####
enemies 2
sign What you seek is close.

3
1
#####D#####
#.........#
#.........#
#.....#...#
#.........#
#.........d
#...#..#..#
#.........#
#.........#
#..#.....##
#####D#####

