4
5
#####.#####
#.........#
#...#.....#
#.........#
#.###.....#
...###....#
#...##....#
###.##....#
##.##.....#
#........X#
###########

2
3
#####.#####
#.#.....#.#
#.........#
#.#.#...#.#
#.........#
....#.#....
#.........#
#.#.#.#.#.#
#.........#
#.#.....#.#
#####d#####

5
0
#####.#####
#.........#
#.........#
#....#..#.#
#.........#
#.........#
#.#..#....#
#.........#
#.........#
#.......#k#
###########
key : 1

3
2
#####l#####
#.........#
#.........#
#.........#
#.........#
..........d
#.........#
#.......#.#
#......#..#
#.........#
#####.#####

3
5
###########
#.........#
##..#...#.#
#.##.##...#
#.##e.....#
l..###....#
#.#.#.....#
#.........#
#.........#
#.........#
#####.#####
locked : 2
boss
enemies 1

2
4
#####.#####
#.........#
#.........#
#.........#
#.........#
....#.....#
#.....#...#
#.#.......#
#..#......#
#s#.......#
#####.#####
switch 0 : 0

0
3
###########
#e........#
#.........#
#.........#
#.........#
#.........#
#.........#
#.........#
#.........#
#........##
#####.#####
enemies 1
door 0 : 0

4
4
#####.#####
#.........#
#.#.#.#...#
#.........#
#.#.#.#.#.#
...........
#.#...#.#.#
#.........#
#.#.#...#.#
#.........#
###########

1
3
#####.#####
#e.....####
#........##
#........##
#.........#
#e.........
#.........#
#.........#
#.........#
#.........#
#####.#####
enemies 2

1
4
###########
#......##e#
#.....#.#.#
#.......#.#
#.....#...#
..........#
#.........#
#.........#
#.........#
#.........#
#####.#####
enemies 1
door 1 : 1

4
3
#####.#####
#k........#
#..#...#..#
#.#.....#.#
#.........#
...........
#.........#
#.#.......#
#..#......#
#.........#
#####.#####
key : 3

3
0
###########
#?........#
#.........#
#.........#
#..####...#
#..#@##....
#.........#
#...#.#...#
#..##.#...#
#.........#
#####.#####
sign Something glints behind that door…

2
2
###########
#.#.....#.#
#.........#
#..#.#.#.##
#.........#
#...#.#....
#.........#
#......#.##
#.........#
#.#.....#.#
#####l#####
locked : 0

5
3
#####.#####
#.........#
##.....#.##
#.........#
#..#...#..#
#.........#
#..#.#....#
#e........#
##s#......#
#e.......e#
###########
enemies 3
switch 1 : 1

3
1
###########
#......#..#
#.....#...#
#.........#
#.........#
...........
#.........#
#.........#
#.........#
#.........#
###########

4
2
#####.#####
#.........#
#.........#
#.........#
#.........#
#..........
#.........#
#.......#.#
#......#..#
#k........#
###########
key : 2

3
4
#####.#####
#.........#
##.....#..#
#.......#.#
#.........#
l.........l
#.........#
#.......#.#
#......#..#
#.........#
#####.#####
locked : 3

4
0
#####.#####
#......##.#
#.....#.#.#
#.....#.#.#
#...###...#
#...k##...#
#...#.....#
#.#.......#
#...#.....#
#.........#
#####.#####
key : 0

3
3
#####d#####
#.........#
#.........#
#.........#
#.........#
d....###..l
#......#..#
#.....##..#
#..##.#...#
#.........#
#####.#####

