3
0
#####l#####
#.........#
#.........#
#.........#
#.........#
#..........
#.........#
#.........#
#.........#
#.........#
#####d#####
locked : 0

3
3
###########
#.........#
#......#..#
#.......#.#
#.........#
..........d
#.........#
#.........#
#.........#
#.........#
#####d#####

4
4
#####.#####
#.........#
#..#......#
#..#.#....#
#.........#
..........#
#.........#
#.........#
#.........#
#........X#
###########

5
2
#####.#####
#.........#
#.........#
#.........#
#....##...#
l..#..#...#
#...##....#
#.####....#
#####.....#
##........#
###########
locked : 3

2
0
#####.#####
#.........#
#......#..#
#.........#
#.........#
#..........
#.........#
#...#...#.#
#......#..#
#.........#
#####l#####

6
1
#####l#####
#.......#.#
#.........#
#..#.#.#.##
#.........#
......#...#
#.........#
#......#.##
#.........#
#.#.....#.#
###########
locked : 2

3
1
#####.#####
#.........#
#.#.....#.#
#.........#
#..#...#..#
...........
#...#.#...#
#.........#
#..#...#.##
#........k#
#####.#####
key : 1

2
1
###########
#.........#
#.........#
#.........#
#.........#
..........#
#.........#
#.........#
#.........#
#.........#
#####.#####

5
0
#####.#####
#.........#
#.........#
#.........#
#.....#...#
#e.##......
#...#.#...#
#...#.#...#
#?###.....#
#.........#
#####.#####
enemies 1
sign Many have walked this path.

3
4
###########
#.........#
#.........#
#.........#
#.........#
d....e....#
#..##.#...#
##.####...#
#..##..##.#
#..#...#..#
#####.#####
boss
enemies 1

4
0
#####d#####
#.........#
#..##.#...#
#...#..#..#
#..#.###..#
#..#.#.#...
#....#.#..#
#.........#
#.........#
#.........#
#####.#####

0
0
###########
#?........#
#...#.....#
#..##.....#
#...#.....#
#....@....#
#.#.#.....#
#.........#
#.........#
#.........#
#####.#####
sign What you seek is close.

5
1
#####d#####
##.......##
#.........#
#..#...#.##
#.........#
...#.#.#..l
#.........#
##.#.#.#.##
#.........#
#..#...#.##
#####l#####

4
3
#####d#####
##.....#..#
#.........#
#.........#
#.#..#..#.#
...........
#.........#
#...#..#..#
#.........#
#.........#
###########

3
2
###########
#.........#
#......#..#
#.......#.#
#.........#
...........
#.........#
#.........#
#.........#
#.........#
#####.#####

4
2
#####.#####
#k........#
#......#..#
#.......#.#
#.........#
...........
#.........#
#.........#
#.........#
#.........#
#####.#####
key : 3

6
0
#####.#####
#.........#
#.........#
#.........#
#.........#
#...####...
#..#.###..#
#.##...#..#
#..##.#.#.#
#.......#.#
###########

1
0
#####.#####
#k#.......#
#...#.#...#
#.....#...#
#.........#
#.........#
#.........#
#.........#
#.........#
#.........#
#####.#####
key : 0

4
1
#####.#####
#k........#
#.........#
#.........#
#.........#
...........
#.........#
#.........#
#.........#
#.........#
#####d#####
key : 2

