3
2
###########
#.......#k#
#.........#
#.#...#...#
#.........#
....#.#...#
#.........#
#...#.#.#.#
#.........#
#.#.....#.#
###########
key : 5

1
1
#####.#####
#e........#
#.........#
#.#...#...#
#..###e...#
....####...
#.#.#.....#
#.#.#.#...#
#.........#
#s........#
#####.#####
enemies 2
switch 0 : 0 1

0
1
###########
#........k#
#.........#
#....#.#..#
#...###...#
...#......#
#.....#...#
#.........#
#.........#
#.......#.#
#####.#####
key : 3

5
0
#####l#####
#.........#
#.........#
#.....#...#
#.........#
#..........
#.........#
#.#.......#
#.........#
#.........#
###########
locked : 1

5
1
#####.#####
#?......e##
#.......#e#
#.........#
#.........#
......##..d
#.........#
#.........#
#.........#
#.........#
#####d#####
enemies 2
sign A locked path — look elsewhere first.

2
0
#####.#####
#.........#
##.#...#..#
#.........#
#..#...#..#
#..........
#..#.#....#
#.........#
##.....#.##
#.........#
#####d#####

4
1
#####.#####
#.........#
#.........#
#.........#
#.##...##.#
...#.##...#
#.#..#.#..#
#....#.##.#
#......#..#
#.........#
#####.#####

1
2
###########
#........e#
#.........#
##.##.....#
#..##.....#
...#.#....#
#.........#
#.####....#
#.##..#...#
#.##......#
###########
enemies 1

7
1
#####d#####
#.........#
#.........#
#.##......#
#.#.......#
#..#.e....#
#.##......#
#.#.......#
#.........#
#.........#
#####.#####
boss
enemies 1

1
0
#####.#####
#.........#
#.........#
#.#.....#.#
#.........#
#..........
#..#......#
#.........#
#.........#
#.#.....#.#
#####.#####

3
0
#####d#####
#.........#
#.........#
#.........#
#.........#
#....@.....
#.........#
#.........#
#.........#
#.........#
#####.#####

2
1
#####.#####
#.........#
#.........#
#.........#
#.........#
.........k#
#.........#
#.........#
#.........#
#.........#
#####.#####
key : 1

0
0
###########
#.........#
#.........#
#.........#
#.........#
#..........
#.........#
#.........#
#.........#
#.........#
#####.#####

4
0
#####.#####
#..#.....##
#.........#
#.........#
#......#..#
#..........
#.........#
#..#..#...#
#.........#
#.........#
#####l#####

6
2
#####.#####
#.........#
##.#.....##
#.........#
#..#......#
..........#
#..#.#.#..#
#........e#
##.......##
#.......?e#
###########
enemies 2
door 0 : 0 1
sign The dungeon remembers all who enter.

3
1
#####.#####
#......##k#
#.........#
#.......#.#
#....##...#
.....##....
#...#...#.#
#...#.#.#.#
#...#.#...#
#.........#
#####.#####
key : 0

8
1
#####.#####
#.........#
#.........#
#.........#
#.........#
#...#.#...#
#...#.#...#
#.###.#.#.#
#X##..#...#
##........#
###########

5
2
###########
#.........#
#.#.#...#.#
#.........#
#.#.#.#.#.#
d.........#
#...#.#...#
#.........#
#.#...#.#.#
#.........#
#####.#####

6
1
#####d#####
#.........#
#.#.#...#.#
#.........#
#..#.#....#
#..........
#.#.#.#.#.#
#.........#
#........##
#.........#
#####d#####

