3
8
###########
#.........#
#.........#
#...#.#...#
#..#e..#..#
d..###....#
#..#.##...#
#..#..##..#
#.........#
#.........#
#####D#####
boss
enemies 1

3
1
#####l#####
#.........#
#..#......#
#.#.......#
#.........#
D.........l
#.........#
#.#.......#
#..#......#
#.........#
###########
locked : 1

3
3
#####d#####
##........#
#.........#
#.........#
#.........#
D.........D
#.......#.#
#......##.#
#.....#.#.#
#.........#
###########

1
3
###########
#.......#.#
#......#..#
#.......#.#
#......#..#
D.........#
#.........#
#...#...#.#
#......#..#
#.........#
#####D#####

1
0
###########
#k........#
#.........#
#..#..#..##
#.........#
#.........#
#.....#...#
#.........#
#.........#
#........##
#####D#####
key : 1

3
4
#####D#####
#.........#
#.........#
#.....#...#
#.....#...#
D.........D
#...#.....#
#..##.....#
#...#.....#
#...e.....#
###########
enemies 1

2
2
#####D#####
#.........#
##.....#..#
#.........#
#.........#
l......#..D
#.........#
#.........#
##.....#..#
#.........#
#####D#####
locked : 0

2
4
###########
#.....?..e#
#..#..#..##
#........e#
#.........#
D..#......#
#.........#
#.........#
#..#..#..##
#.........#
#####D#####
enemies 2
sign Those who search shall find.

3
0
#####D#####
#.........#
#..#......#
#.#.......#
#.........#
#.........D
#.........#
#.........#
#.........#
#k........#
###########
key : 2

3
2
#####D#####
#.........#
##.......##
#.........#
#.........#
l.........D
#.........#
#.#.......#
#..##.....#
#.........#
###########
locked : 2

2
3
#####D#####
#k........#
#.........#
#.........#
#.........#
D.........D
#.........#
#.#.......#
#..#......#
#.........#
#####d#####
key : 3

0
2
###########
#.........#
#.........#
#.........#
#.....#...#
#.........#
#..#......#
#.........#
#..#......#
#.........#
#####D#####

2
0
#####D#####
#.........#
#.........#
#.........#
#.........#
#....@....D
#.........#
#.........#
#.........#
#.........#
#####D#####

1
2
#####D#####
#.........#
#.........#
#.#.#.#.#.#
#.........#
#...#.#...D
#.........#
#...#...#.#
#.........#
#.#.....#.#
#####D#####

2
1
###########
##k#...#..#
#.........#
##.#.#.#.##
#.........#
D..#.#....l
#.........#
##...#.#.##
#.........#
#..#...#..#
#####l#####
key : 0

3
5
###########
#.........#
#.........#
#.........#
#.p.......#
D....p....D
#.........#
#.........#
#.........#
#.........#
###########

3
6
###########
#.........#
#.........#
#...#...#.#
#.........#
D.........d
#.........#
#...#...#.#
#.........#
#.......#.#
###########

3
7
###########
#.........#
#..#......#
#.#.......#
#.........#
d.........d
#.........#
#.........#
#.........#
#.........#
###########

4
8
#####D#####
#.........#
#.........#
#..##.##..#
#...##.#..#
#..##.....#
#.....##..#
#..##..#..#
#.........#
#X........#
###########

