3
4
###########
#.........#
##.#...#.##
#.........#
#....#.#..#
d.........#
#..#......#
#.........#
##.#...#.##
#.........#
#####l#####

1
0
#####D#####
#.........#
#.......###
#....####.#
#....##.#.#
#....#....D
#.....##..#
#.........#
#.........#
#......#..#
#####D#####

1
2
#####D#####
#.........#
#.........#
#.........#
#.........#
D.........#
#.........#
#.......#.#
#......#..#
#.........#
#####l#####
locked : 0

2
3
###########
#.........#
#.#.....#.#
#.........#
#.........#
D....#....#
#.........#
#.........#
#.........#
#.........#
#####D#####

0
0
###########
#.........#
#......#..#
#.......#.#
#.........#
#.........#
#.........#
#.#.......#
#..#......#
#.........#
#####D#####

2
1
#####D#####
#.........#
##.#...#..#
#.........#
#..#.#....#
d.........D
#..#.#.#..#
#.........#
##.#.....##
#.........#
#####D#####

5
4
#####D#####
#.#.......#
#..##.#...#
#...##....#
#.###.#...#
#..##.....#
#.........#
#.........#
#.........#
#X........#
###########

4
1
#####D#####
#.........#
#..#......#
#k#.......#
#.........#
#.........D
#.........#
#.........#
#.........#
#.........#
#####D#####
key : 1

2
0
#####D#####
#.........#
#.........#
#.........#
#.........#
#....@....d
#.........#
#.........#
#.........#
#.........#
#####D#####

2
2
#####l#####
#e........#
#.........#
#.........#
#.........#
D.........D
#..###....#
#.........#
#..#......#
#?........#
#####d#####
enemies 1
sign Seek the matching key before you proceed.

3
3
#####D#####
#.........#
#..#......#
#.#.......#
#....#....#
d.........d
#.........#
#.#......##
#..#......#
#..#......#
###########

3
0
#####D#####
#.........#
#.........#
#.#..#..#.#
#.........#
#.........D
#.#..#....#
#.........#
#.........#
#.......#.#
###########

4
4
#####l#####
#.........#
#..#......#
#.#..#....#
#...##....#
#...e#....#
#.####.#..#
#.......#.#
#.........#
#.........#
#####D#####
locked : 5
boss
enemies 1

3
1
#####D#####
#k........#
#......#..#
#.......#.#
#.........#
D.........D
#.........#
#.#.....#.#
#..#...#..#
#.........#
#####D#####
key : 0

1
1
###########
#......#..#
#..##.#..##
#....###..#
#...##.#..#
D...##.#..D
#.........#
#.........#
#.........#
#.........#
#####D#####

3
2
#####d#####
#.........#
#.........#
#.........#
#.........#
D.........d
#.........#
#.........#
#.........#
#.........#
#####D#####

4
2
#####D#####
#.........#
#......#..#
#.......#.#
#.........#
D.........#
#.........#
#.#.......#
#..#......#
#........k#
###########
key : 4

0
2
###########
#e#?....#e#
#.........#
#..#.#.#..#
#.........#
#...#.#...#
#.........#
#..#.#.#.##
#.........#
#.#.....#.#
#####D#####
enemies 2
sign Only the prepared may pass.

5
1
#####D#####
#.........#
#..#......#
#.#.......#
#.........#
#.........#
#.........#
#.#.....#.#
#..#...#..#
#k........#
###########
key : 5

