2
2
#####d#####
#.........#
#..#...#..#
#.#.....#.#
#.........#
D.........d
#.........#
#.#.....#.#
#..#...#..#
#.........#
#####D#####

3
3
#####D#####
#e.......?#
#.........#
##..#..#..#
#.........#
D.........l
#...#..#..#
#.........#
#.........#
##.....#..#
#####d#####
enemies 1
sign This door will not yield without a key.

2
0
#####D#####
#.........#
#.........#
#.#.......#
#.........#
#.........d
#....#....#
####......#
####......#
#.........#
#####D#####

5
2
#####l#####
#.........#
#p........#
#.........#
#.........#
#....e....#
#..#......#
#.p###....#
#...#.....#
#.........#
#####D#####
locked : 0
boss
enemies 1

4
2
#####l#####
#.........#
#......#..#
#.......#.#
#.......#.#
#.........D
#.........#
#.........#
#.........#
#.........#
#####l#####
locked : 7

6
2
#####D#####
#.........#
#.....#.###
#.........#
#....#....#
#....##...#
#.......#.#
#.........#
#.........#
#X........#
###########

1
0
#####D#####
#.........#
#.........#
#.........#
#......#..#
#....@#...D
#.........#
#.........#
#.........#
#.........#
#####D#####

3
1
#####D#####
##.#...#.##
#.........#
#....#.#.##
#.........#
D....#....D
#.........#
##.#...#.##
#.........#
##.#.....##
###########

2
4
###########
#.#.....#k#
#.........#
#..#.#.#.##
#.........#
D...#.#...#
#.........#
#..#.#.#.##
#.........#
#.#.......#
#####D#####
key : 7

1
3
###########
#.......#k#
#.........#
#.#.#.#.#.#
#.........#
D...#.#...#
#.........#
#.#.#.#.#.#
#.........#
#.#.......#
#####D#####
key : 8

2
3
#####D#####
#......#..#
#...#.###.#
#...#.#.#.#
#...#.#...#
d.........D
#.........#
#.........#
#.........#
#.........#
#####D#####

1
1
###########
#.........#
#.........#
#.........#
#.........#
D.........D
#.........#
#.#.......#
#..#......#
#.........#
#####D#####

4
3
#####d#####
#.........#
#.........#
#.........#
#....#....#
D.........#
#.........#
#.#.....#.#
#..#...#..#
#.........#
###########

1
2
###########
#.........#
#..#......#
#.#.......#
#.........#
D.........D
#.........#
#.#.....#.#
#..#...#..#
#.........#
#####d#####

2
1
#####D#####
#......#..#
#.....#...#
#....###..#
#...#.....#
d..##.....D
#....#....#
#.........#
#.........#
#.........#
#####D#####

3
2
#####D#####
#.......#.#
#.........#
#..#...#.##
#.........#
D...#.....D
#.........#
#......#.##
#.........#
#.#.....#.#
#####l#####

0
0
###########
#k........#
#......#..#
#.......#.#
#.........#
#.........#
#.........#
#.#.......#
#..#..#...#
#.........#
#####D#####
key : 0

3
0
#####D#####
#..#......#
#..##.....#
#..###....#
#.........#
#.........D
#.........#
#.........#
#.........#
#k........#
###########
key : 1

3
4
#####D#####
#.........#
#.........#
#.........#
#.........#
l.........#
#.........#
#.........#
#.........#
#.........#
###########
locked : 1

