2
3
#####D#####
#.........#
#.........#
#.........#
#.........#
d.........D
#.........#
#.........#
#.........#
#.........#
#####D#####

3
3
#####D#####
#.........#
##.#...#.##
#.........#
#.#.#.#.#.#
D.........#
#....#.#..#
#.........#
#.......#.#
#.........#
#####D#####

5
4
#####D#####
#.........#
#.........#
#......#..#
#..#.##...#
#.....##..#
#.#..#....#
#.#.##....#
##..#.....#
#X........#
###########

2
1
#####D#####
#k........#
#.#.....#.#
#.........#
#.........#
D....#....D
#.........#
#.........#
#.#.....#.#
#.........#
#####l#####
key : 0

3
1
#####l#####
#.#.......#
#.........#
#..#.....##
#.........#
#...#.#...D
#.........#
#....#.#.##
#.........#
#.......#.#
###########
locked : 1

5
2
#####l#####
#.........#
#.........#
#.........#
#.........#
#.........#
#.........#
#.........#
#.........#
#.........#
#####D#####
locked : 4

2
4
#####D#####
#.........#
#.........#
#..##.#...#
#.#.##....#
D...##....#
#.#..##...#
#..##e#...#
#.........#
#.......ee#
###########
enemies 3

0
3
###########
#k........#
#.........#
##..#..#..#
#.........#
#.........#
#...#..#..#
#.........#
#.........#
##.....#..#
#####D#####
key : 3

2
2
###########
#.........#
#.......#.#
#.........#
#.........#
D....#....d
#.........#
#.........#
#.#.....#.#
#.........#
#####l#####

6
2
#####D#####
#.........#
#..#......#
#.###.....#
#..#.#....#
#....#....#
#....##.#.#
#....##...#
#......##.#
#.........#
###########

2
0
#####D#####
#.........#
#.........#
#.........#
#....#....#
#..##@....D
#.........#
#.........#
#......p..#
#.........#
###########

1
0
###########
#k........#
##.#...#..#
#.........#
#..#...#..#
#.........D
#..#.#....#
#.........#
#..#...#.##
#.........#
#####D#####
key : 1

1
1
###########
#.........#
#.........#
#.........#
#...#...#.#
D...##....#
#....####.#
#...##....#
#......#..#
#.........#
#####D#####

4
4
###########
#.........#
#.........#
#.........#
#.........#
d....e....#
#.........#
#.........#
#.........#
#.........#
#####D#####
boss
enemies 1

4
3
#####D#####
#.........#
#..#..#..##
#.........#
#.........#
d...#..#..d
#.........#
#.........#
#.....#..##
#.........#
###########

3
2
#####l#####
#.........#
##.#.....##
#.........#
#.#...#...#
D.........D
#..#.#.#..#
#.........#
#.#.#.#.#.#
#.........#
#####d#####
locked : 0

4
2
#####d#####
#.........#
#.###.....#
#.#.#.....#
#.#.###...#
#.........d
#.........#
#.........#
#.........#
#.........#
#####l#####

1
3
#####D#####
#.........#
##.#.....##
#.........#
#..#...#..#
#.........D
#..#.#.#..#
#.........#
##.#...#.##
#.........#
#####D#####

1
4
###########
#........k#
#..#......#
#.#.......#
#.........#
D.........#
#.........#
#.......#.#
#......#..#
#.........#
#####D#####
key : 4

