1
0
#####D#####
#.........#
#.........#
#.........#
#.........#
#.........D
#.........#
#.........#
#.........#
#.........#
#####D#####

2
1
#####D#####
#.........#
#..#...#..#
#.#.....#.#
#.........#
D.........d
#.........#
#.......#.#
#......#..#
#.........#
#####l#####

4
4
#####l#####
#.........#
#..#...#..#
#.#.....#.#
#.........#
D.........d
#....#....#
#.#.....#.#
#..#...#..#
#.........#
#####D#####
locked : 0

2
0
#####D#####
#?........#
##..#.....#
#..#.#....#
#.#.@#....#
#...##....D
#.#.......#
#.........#
#.........#
#.........#
#####D#####
sign The walls are warm to the touch.

1
1
###########
#........k#
##.#...#..#
#.........#
#.#...#.#.#
D.........#
#..#.#.#..#
#.........#
#.#...#.#.#
#.........#
#####D#####
key : 1

5
4
#####D#####
#.........#
#.........#
#.........#
#.........#
#....#....#
#.........#
#.........#
#.........#
#.........#
###########

2
3
###########
#......##.#
#.....##..#
#....#..#.#
#.....#...#
D.....##..D
#.........#
#.....#...#
#.........#
#.........#
#####d#####

2
4
###########
#........k#
#..#......#
#.#.......#
#.........#
D.........#
#.........#
#.........#
#.........#
#.........#
#####D#####
key : 4

3
4
#####D#####
#k........#
#......#..#
#.......#.#
#.........#
D.........d
#.........#
#.#.......#
#..#......#
#.........#
#####l#####
key : 5

3
0
#####D#####
#.........#
##.#...#.##
#.........#
#.#.#.#.#.#
#.........D
#..#.#.#..#
#.........#
#.....#...#
#k........#
###########
key : 0

3
1
#####l#####
#.#.......#
#.........#
#....#.#.##
#.........#
D...#.#...#
#.........#
#..#...#.##
#.........#
#.#.....#.#
###########
locked : 1

3
6
###########
#.........#
#.........#
#.........#
#.......#.#
l....e....#
#.........#
#.........#
#.........#
#.........#
#####D#####
locked : 5
boss
enemies 1

4
5
#####D#####
#.........#
#.....##..#
#..#..##..#
#...#.....#
d..#......D
#.........#
#.........#
#.........#
#.........#
###########

4
3
#####D#####
#.........#
#.........#
#.###.....#
#.#.#.....#
#.........D
#.........#
#.........#
#e........#
#ee.......#
###########
enemies 3

3
5
###########
#.........#
#.........#
#.........#
#.........#
d.........l
#.........#
#.........#
#.........#
#.........#
#####D#####

2
2
###########
#.........#
#.........#
#.........#
#.........#
d.........D
#.........#
#.........#
#.........#
#.........#
###########

4
6
#####D#####
#.........#
#.........#
#.........#
#...#.....#
D...#.....#
#.#.####..#
#..#...#..#
#.........#
#..#...#.X#
###########

3
3
#####d#####
#.........#
#.........#
##.....#..#
#.........#
#.........D
#...#.....#
#.........#
#.........#
#......#..#
#####D#####

0
0
###########
#.........#
#..#......#
#.#.......#
#.##......#
#.........#
#.........#
#.........#
#.........#
#.........#
#####D#####

