1
1
###########
#.........#
#.........#
#.........#
#.........#
....#.#...l
#...##....#
#..#.#....#
#.#.......#
#.........#
#####d#####

4
0
#####.#####
#.........#
#..#......#
#..#..#...#
#?#@###...#
#...###....
#..####...#
#.........#
#.........#
#.........#
#####.#####
sign A useful tool lies just ahead.

5
0
#####.#####
#......#..#
#.........#
#.........#
#.##.###..#
#..##.#....
#.#.#.#...#
#...#.#...#
#.###.#...#
#k........#
###########
key : 0

5
1
#####.#####
#.........#
#.#.#.#.#.#
#.........#
#.#.#...#.#
...........
#.#.#...#.#
#.........#
#.#.#.#.#.#
#.........#
#####.#####

2
0
#####.#####
#......#.##
#.........#
#...#.#.#.#
#.........#
#......#..d
#.........#
#.#.#.#.#.#
#.........#
##.#...#..#
#####d#####

1
2
#####.#####
#.........#
#.........#
###.......#
#..#......#
l..#.e....#
#.........#
#.........#
#.........#
#.........#
#####.#####
locked : 6
boss
enemies 1

2
2
#####.#####
#.........#
#.#.#.#.#.#
#.........#
#....#.#..#
..........#
#...#.#.#e#
#.........#
#......#.##
#........?#
#####.#####
enemies 1
sign This door will not yield without a key.

5
3
###########
#.........#
#......#..#
#.......#.#
#.........#
..........#
#.........#
#.........#
#.........#
#.........#
###########

3
0
#####d#####
#.........#
#......#..#
#.......#.#
#.........#
#..........
#.........#
#.......#.#
#......#..#
#.........#
#####.#####

0
2
###########
#X........#
#.........#
#....#....#
#.....#...#
#...####..#
#.....##..#
#.........#
#.........#
#.........#
#####.#####

6
2
#####.#####
#.........#
#.......#.#
#...#.#...#
#....##...#
d....#.#..#
#......##.#
#.........#
#.........#
#.........#
###########

4
1
#####l#####
#e........#
#.........#
#.........#
#.........#
..........l
#.........#
#.........#
#.........#
#e........#
#####.#####
enemies 2

1
0
###########
#k........#
###....#..#
#.......#.#
#.........#
#..........
#.........#
#.........#
#.........#
##........#
#####.#####
key : 3

4
2
#####.#####
#.........#
#.........#
#...###...#
#.##..#...#
l..#.##...#
#.........#
#.##..#...#
#.........#
#.........#
#####.#####
locked : 0

5
2
#####.#####
#k........#
#.........#
#.........#
#.......#.#
......#....
#.........#
#.........#
#......#..#
#.........#
#####.#####
key : 2

6
1
#####.#####
#.........#
#.........#
#.........#
#.........#
#.........d
#.........#
#.#.......#
#..#......#
#.........#
###########

2
1
#####d#####
#.........#
#.#.......#
#.........#
#.........#
d..#..#....
#.........#
#.........#
#.......#.#
#.........#
#####.#####

3
1
#####.#####
#.........#
#......#..#
#.......#.#
#.........#
...........
#.........#
#.........#
#.........#
#.........#
#####l#####
locked : 2

3
2
#####.#####
#.........#
#..#......#
#.#.......#
#.........#
..........#
#.........#
#.......#k#
#......#..#
#.........#
#####.#####
key : 6

