4
2
#####d#####
###.......#
#..#......#
#.##......#
#.###.....#
l..........
#.........#
#.........#
#.........#
#.........#
#####.#####
locked : 1

5
0
###########
#k........#
#..#...#..#
#.#.....#.#
#.........#
#..........
#.........#
#.#.......#
#..#......#
#.........#
#####.#####
key : 1

6
1
#####.#####
#k........#
#..#......#
#.#.......#
#.........#
...........
#.........#
#.......#.#
#......#..#
#.........#
#####.#####
key : 0

3
3
#####d#####
#k........#
#..#...#..#
#.#.....#.#
#.........#
..........l
#.........#
#.#.......#
#..#......#
#.........#
#####.#####
key : 4

4
1
#####.#####
#.......#.#
#.........#
#...#...#.#
#.........#
#.....#...l
#.........#
#.#.#.#.#.#
#.........#
#.........#
#####l#####
locked : 0

1
3
#####.#####
#.......#.#
#.........#
#.........#
#.........#
#....e....#
#.........#
#.........#
#.........#
#.........#
#####d#####
boss
enemies 1

2
3
#####d#####
#.........#
#.........#
#..#..#..##
#.........#
#..........
#...#.....#
#.........#
#.........#
#..#.....##
#####d#####

3
2
###########
#..#......#
#.......#.#
#.........#
#.....#...#
...........
#.........#
#.#.......#
#..#......#
#.........#
#####d#####

7
1
#####.#####
#.........#
#.........#
#.........#
#.........#
#.........l
#.........#
#.........#
#.........#
#k........#
###########
key : 2

4
3
#####.#####
#.........#
#..#...#..#
#.........#
#..#.#.#..#
..........#
#......#..#
#.........#
##.#...#.##
#.........#
###########

2
4
###########
#.......ee#
#.........#
#...#.....#
#.........#
..........#
#.#..#..#.#
#.........#
#.........#
##........#
#####.#####
enemies 2

7
2
#####.#####
#.........#
#......#..#
#.......#.#
#.........#
l.........#
#.........#
#.........#
#.........#
#.........#
###########
locked : 2

5
1
#####l#####
#e........#
#.#.#.#.#.#
#.........#
#..#?#.#..#
...........
#.....#.#.#
#.........#
#..#...#.##
#e.......e#
#####.#####
enemies 3
sign Seek the matching key before you proceed.

0
3
###########
#X........#
#.........#
###..#....#
#.###.....#
#..##.#...#
#.........#
#.........#
#.........#
#.........#
#####.#####

6
2
#####.#####
#e........#
#.........#
#.........#
#.........#
.........e#
#......#..#
#.....##..#
#.........#
#?........#
#####.#####
enemies 2
sign Seek the matching key before you proceed.

3
1
###########
#.........#
#.........#
#.....#...#
#...##..#.#
#..###.#...
#..##.##..#
#...#.#...#
#...#..#..#
#.........#
#####.#####

3
4
#####.#####
#.#.....#.#
#.........#
#.....#.#.#
#.........#
l...#.#...#
#.........#
#.#.#.....#
#.........#
#.#.....#.#
###########
locked : 4

6
0
#####.#####
#.........#
#.........#
#.........#
#.........#
#....@.....
#.........#
#.........#
#.........#
#?........#
###########
sign Something glints behind that door…

5
2
#####.#####
#.........#
#......#..#
#.......#.#
#.........#
..........#
#.........#
#.........#
#.........#
#.........#
#####.#####

