4
0
#####D#####
#.........#
#..p......#
#....p....#
#.........#
#k........d
#.........#
#.........#
#.........#
#.........#
#####D#####
key : 0

3
0
#####l#####
#.........#
#.........#
#....#....#
#..##.#...#
#....@#...D
#.........#
#..##.....#
#.........#
#......p..#
#####D#####

4
1
#####D#####
##.....#..#
#.........#
#.........#
#...#.....#
d.........D
#.........#
#...#.....#
#.........#
#.........#
###########

1
2
###########
#......#..#
#.....##..#
#......#..#
#.........#
D......#..D
#....#....#
#.....#...#
#.........#
#.........#
#####l#####
locked : 1

5
0
#####D#####
#.........#
#.........#
#.........#
#.........#
#.........#
#.........#
#.........#
#.........#
#.........#
###########

3
2
#####D#####
#e.......?#
#.........#
#.........#
#.........#
D.........D
#.........#
#.........#
#.........#
#e........#
#####l#####
enemies 2
sign Turn back; you are not yet ready.

4
2
#####l#####
#.........#
#.....###.#
#......#..#
#.....#...#
D...#e.#..#
#...#.#...#
#...####..#
#...#.....#
#.........#
#####D#####
locked : 2
boss
enemies 1

3
3
#####D#####
#.......#.#
#.....###.#
#......##.#
#.........#
D.........#
#.........#
#.........#
#.........#
#........k#
###########
key : 2

2
0
#####D#####
#.........#
#.........#
#.........#
#.........#
#.........D
#.........#
#.........#
#.........#
#.........#
#####l#####
locked : 0

3
1
#####D#####
#.........#
#.........#
#.........#
#.........#
D....#....D
#...####..#
#...##k#..#
#.........#
#.........#
#####D#####
key : 1

5
2
#####D#####
#......#..#
#...#.....#
#...#.##..#
#.........#
#.........#
#.........#
#.........#
#.........#
#X........#
###########

0
0
###########
#.........#
#.........#
#.#...#.#.#
#.........#
#...#.#...D
#.........#
#.#.#.#.#.#
#.........#
#.#.......#
#####d#####

0
1
###########
#.........#
#.....#...#
#.....#...#
#....#....#
D.........#
#.........#
#.....#...#
#.....##..#
#........##
#####d#####

2
2
#####l#####
#......#.##
#.....#..##
#....#.#..#
#......##.#
D.....##..D
#..#......#
#..###....#
#..#......#
#.........#
#####D#####

1
3
###########
#.........#
#.........#
#.........#
#.........#
D.........#
#.........#
#.........#
#.........#
#.........#
#####l#####
locked : 3

1
0
#####d#####
#.........#
#..#......#
#.#.......#
#.........#
#.........D
#.........#
#.........#
#.........#
#.........#
#####D#####

2
1
#####D#####
#.........#
#..#......#
#.#.......#
#.........#
D.........D
#.........#
#.........#
#.........#
#.........#
#####D#####

1
1
#####d#####
#.........#
#.........#
#.#.......#
#.........#
D.........D
#.........#
#.#.....#.#
#..#...#..#
#.........#
#####D#####

2
3
#####l#####
#k........#
##.#......#
#.........#
#......#..#
D.........#
#..#.#.#..#
#.........#
##.#...#..#
#.........#
#####D#####
key : 3

