2
0
###########
#k........#
#.........#
#.........#
#.........#
#..........
#.........#
#.........#
#.........#
#.........#
#####.#####
key : 0

1
1
###########
#......#.##
#.....##.##
#....#...##
#.######..#
#...###....
#..#..#...#
#..#.##...#
#.#...#...#
#.........#
#####.#####

3
3
#####.#####
#.........#
#.........#
#.........#
#...##..#.#
l...##.....
#...#.#.#.#
#...#..##.#
#...#.#...#
#.........#
#####.#####
locked : 0

2
4
#####d#####
#.........#
#.#.....#.#
#.........#
#.........#
l....#....#
#.........#
#.........#
#.#.....#.#
#.........#
#####.#####
locked : 2

3
2
#####d#####
#.........#
#..#...#..#
#.#.....#.#
#.........#
..........l
#.........#
#......#..#
#.........#
#.........#
#####.#####

3
4
#####.#####
#.........#
#.#.......#
#.........#
#.........#
......#...#
#.........#
#.........#
#.......#e#
#......?ee#
###########
enemies 3
sign Only the prepared may pass.

3
1
#####.#####
#.........#
#.........#
#.........#
#.........#
...........
#.........#
###.......#
##........#
#.........#
###########

1
3
###########
#....k....#
#.........#
#.........#
#.........#
...........
#.........#
#.#.......#
#..#......#
#.........#
#####.#####
key : 3

4
2
#####.#####
#.........#
#......#..#
#.......#.#
#.........#
#..........
#.........#
#.........#
#.........#
#.........#
#####.#####

3
0
#####.#####
#.........#
#.........#
#.........#
#.........#
#....@.....
#.........#
#.........#
#.........#
#?........#
###########
sign The walls are warm to the touch.

2
2
#####.#####
#.........#
#.........#
#...#.....#
#.###.#...#
....#.#...d
#.####....#
#.#.#.....#
#.#.......#
#.........#
#####d#####

2
3
#####.#####
#.........#
#.........#
#.........#
#.........#
d.........l
#.........#
#.........#
#.........#
#.........#
#####.#####

4
3
#####.#####
#.........#
#..#......#
#.#.......#
#.........#
..........#
#.........#
#.........#
#.........#
#........k#
###########
key : 2

1
4
#####.#####
#.........#
#.........#
#.........#
#.........#
.....e....#
#.........#
#.........#
#.........#
#.........#
#####d#####
boss
enemies 1

0
4
###########
#.........#
#.......#X#
#....#..###
#.....##..#
#....###..#
#....#..#.#
#.........#
#.........#
#.........#
#####.#####

2
1
#####.#####
#.......#.#
#.......#.#
#.......#.#
#.........#
...........
#.........#
#.........#
#.........#
#.........#
#####.#####

1
2
#####d#####
#.........#
#..#...#.##
#.........#
#..#.#.#..#
...........
#....#....#
#.........#
##.#...#.##
#k........#
#####.#####
key : 1

5
2
#####.#####
#.........#
#..#...#..#
#.#.....#.#
#....#....#
#.........#
#.........#
#.........#
#.........#
#.........#
###########

0
2
###########
#.........#
#......#..#
#.......#.#
#.........#
#.........#
#.........#
#.......#.#
#......#..#
#.........#
#####d#####

