6
2
#####D#####
#.........#
#..##.....#
#..##.....#
#..#e#....#
D.........D
#.........#
#..##.....#
#..##.....#
##.#......#
#####D#####
enemies 1

3
1
#####D#####
#.........#
#.........#
#....##...#
#...###...#
D...#....k#
#.#.......#
#..#......#
#.........#
#.........#
#####D#####
key : 0

0
1
###########
#k........#
#.........#
#.........#
#.........#
#.........#
#.........#
###.....#.#
#..#...#..#
#.........#
#####D#####
key : 4

3
0
#####D#####
#.........#
#.........#
#.........#
#.........#
#?...@....D
#.........#
#.........#
#.........#
#.........#
#####D#####
sign A useful tool lies just ahead.

4
0
#####D#####
#.........#
#.........#
#.........#
#......##.#
#.........D
#.....###.#
#....####.#
#.....#####
#.........#
#####D#####

5
3
###########
#.........#
#.#.#..p..#
#...#.#...#
#.#.#e....#
d...##....#
#.#.#.....#
#.........#
#.........#
#.........#
#####D#####
boss
enemies 1

7
2
#####D#####
#..#...#.##
#.........#
#.#.#.#.#.#
#.........#
#......#..#
#.........#
#.#.#...#.#
#.........#
#e......e##
###########
enemies 2
door 0 : 0 1

5
1
#####D#####
#k........#
#.........#
##..#..#..#
#.........#
D.........l
#.........#
#.........#
#.........#
##.....#..#
#####D#####
key : 3

6
3
#####D#####
#.........#
#.........#
#.........#
#.........#
D.........#
#.........#
#.........#
#.........#
#........X#
###########

1
2
###########
#.........#
#.........#
#..#..#..##
#.........#
d.........#
#...#..#..#
#.........#
#.........#
#..#.....##
#####D#####

5
0
#####D#####
#.......#.#
#.....#.#.#
#...##..#.#
#....####.#
#.....#...D
#.........#
#.........#
#.........#
#k........#
###########
key : 1

6
1
#####D#####
#?#.......#
#.........#
#...#.#...#
#.........#
#...#.....D
#.........#
#...#.#.#.#
#e........#
#e#e....#.#
###########
enemies 3
sign Those who search shall find.

1
1
#####D#####
#.........#
##..#..#..#
#.........#
#.........#
D...#..#..d
#.........#
#.........#
##..#..#..#
#.........#
#####d#####

1
0
###########
#.........#
#.........#
#.........#
#.....p...#
#.........D
#.........#
#.........#
#.........#
#.........#
#####d#####

2
1
#####d#####
#.........#
#..#......#
#.#.......#
#.........#
D.........D
#.........#
#.#.......#
#..#......#
#.........#
#####D#####

2
2
#####D#####
##........#
#####.....#
##..#.....#
#..##.....#
D..#.p....#
#.........#
#.........#
#.........#
#.......se#
###########
enemies 1
switch 0 : 0 1

5
2
###########
#.........#
#.........#
##..#..#..#
#.........#
l.........d
#...#.....#
#.........#
#.........#
##.....#..#
#####D#####
locked : 3

2
0
#####d#####
#.........#
#..#...#..#
#.#.....#.#
#.........#
#.........D
#.........#
#.#.......#
#..#......#
#.........#
#####D#####

4
1
#####D#####
#.........#
#......#..#
#....#..#.#
#.........#
D.........#
#.........#
##........#
#.........#
#.........#
#####D#####

