3
4
#####D#####
#.........#
##.#.....##
#.........#
#..#.#....#
D.........D
#..#.#.#..#
#.........#
##.....#.##
#.........#
#####D#####

3
3
#####D#####
#k........#
#.........#
#.........#
#.........#
D.........D
#.........#
#.........#
#.........#
#.........#
#####D#####
key : 2

2
3
#####d#####
#.........#
#...#.#...#
#.........#
#..#.#.#..#
D.........l
#.#.#.#.#.#
#.........#
#..#...#.##
#........e#
#####D#####
enemies 1

4
1
#####D#####
#.#.....#.#
#.........#
#..#...#.##
#.........#
#...#.#...#
#.........#
#..#.....##
#.........#
#.#.....#.#
###########

1
4
#####D#####
#.........#
#..#......#
#.##......#
#.#.......#
d....e....#
#.........#
#.........#
#.........#
#.........#
#####D#####
boss
enemies 1

4
4
#####D#####
#.........#
#.........#
#.........#
#.........#
d.........#
#.........#
#.........#
#.........#
#.........#
###########

1
0
###########
#.........#
#.........#
#....#..#.#
#.........#
#.........D
#.#..#..#.#
#.........#
#.........#
#.......#.#
#####d#####

2
2
###########
#e......#.#
#.....#...#
#####....##
#?#.#..##.#
#.........D
#.........#
####.#..p.#
#.........#
#p........#
#####D#####
enemies 1
sign Only the prepared may pass.

2
4
#####D#####
####......#
#####.....#
#.####....#
#.####....#
l..#.#....#
#.........#
#.........#
#.........#
#.........#
#####D#####
locked : 1

0
3
###########
#e.e......#
#e.#...#..#
#..#...#..#
#.....##..#
#..##.....D
#.........#
#.........#
#.........#
#.........#
#####D#####
enemies 3

1
1
###########
#.#.....#k#
#.........#
#.........#
#.#.....#.#
D.........#
#.........#
#.......#.#
#.........#
#.........#
###########
key : 1

0
4
###########
##....X#..#
#..#..#...#
##.##..#..#
#.###.....#
D...##....#
#.........#
#.#.......#
#.........#
#.........#
#####D#####

1
3
#####D#####
#.#.......#
#.........#
#.#.#.#.#.#
#.........#
#...#.....d
#.........#
#.#.....#.#
#.........#
#.#.....#.#
#####d#####

4
3
#####D#####
#.........#
#..#..#...#
#.........#
#.........#
#.........d
#.........#
#.........#
#........##
#.........#
###########

3
1
###########
#.........#
#.........#
##...#k####
#....##.#.#
D.....#...l
#....##...#
#........##
#.........#
#.........#
#####D#####
key : 0

3
5
###########
#........k#
#.........#
#.........#
#...##.#..#
D..#..##..#
#..#.#....#
#......#..#
#...#.....#
#.........#
###########
key : 3

2
0
#####d#####
#.........#
#......#..#
#.......#.#
#.........#
#.........#
#.........#
#.........#
#.........#
#.........#
#####D#####

3
0
#####D#####
##........#
####......#
##.###....#
#...##p...#
#....@....D
#.........#
#.........#
#...p.....#
#?........#
###########
sign Those who search shall find.

3
2
#####D#####
#.........#
#.........#
#.........#
#.........#
l.........D
#.........#
#.........#
#.........#
#.........#
###########
locked : 0

