3
0
#####.#####
#..#......#
#..##.....#
#..###.#.##
#.....#...#
#.....##...
#......#..#
#......##.#
#.........#
#.........#
###########

5
1
#####.#####
#.........#
#.........#
#.........#
#.........#
#..#......#
#e#.......#
###.......#
#.........#
#?........#
###########
enemies 1
sign The dungeon remembers all who enter.

4
3
#####.#####
#.#.......#
#.........#
#.#.#.#...#
#.........#
....#.#...#
#.........#
#.....#.#.#
#.........#
#.#......k#
###########
key : 5

1
0
#####d#####
#.........#
#.........#
###.......#
#e........#
#...#......
#..#......#
#.#.#.....#
#.........#
#.........#
#####.#####
enemies 1

4
2
#####.#####
#k........#
##.#.....##
#.........#
#.#...#.#.#
...........
#....#.#..#
#.........#
#.#.#.#.#.#
#.........#
###########
key : 1

3
1
#####.#####
#.........#
#..#...#..#
#.#.....#.#
#.........#
...........
#.........#
#.#.....#.#
#..#...#..#
#.........#
#####d#####

0
2
###########
#.........#
#.........#
#.........#
#..#.#....#
#..#.#.....
#..#.#....#
#.........#
#.........#
#.........#
#####l#####
locked : 0

2
0
#####.#####
#.........#
#.........#
#....#.#..#
#.####.#..#
#..?#@.#...
#.##.#....#
#.#.......#
#.........#
#.........#
#####.#####
sign Those who search shall find.

2
3
#####.#####
####......#
##.#......#
#..#......#
#.........#
d..#......#
#.........#
#.#.......#
#.........#
#.........#
#####.#####

3
2
#####.#####
#.........#
#.........#
#..#..#...#
#.........#
...........
#...#.....#
#.........#
#.........#
#..#.....##
#####.#####

1
2
#####l#####
#.........#
#.........#
#.........#
#.........#
..........l
#.........#
#.#.......#
#..#......#
#.........#
#####d#####

4
1
#####d#####
#.........#
#.........#
#.........#
#.........#
#..........
#......#..#
#.........#
#.........#
#.........#
#####.#####

0
3
###########
#.......###
#.....#.X##
#.....###.#
#....##...#
.....#....#
#.........#
#.........#
#.........#
#.........#
#####.#####

1
1
###########
#.........#
#...#.....#
#...#.....#
#....##...#
.......#...
#....###..#
#.........#
#.........#
#.........#
#####.#####

1
3
#####.#####
#.........#
#.........#
#.........#
#.........#
l....e....#
#.........#
#.........#
#.........#
#.........#
#####.#####
locked : 2
boss
enemies 1

2
2
#####d#####
#.........#
#.........#
#.........#
#.........#
..........d
#.........#
#.........#
#.........#
#.........#
#####.#####

2
1
#####.#####
#k........#
#.......#.#
#.........#
#.........#
.....#.....
#.........#
#.........#
#.#.......#
#.........#
#####.#####
key : 0

0
0
###########
#..#...#..#
#...#.....#
#..#...#..#
#..#...#..#
#..##..#..#
#.........#
#.........#
#.........#
#.........#
#####d#####

3
3
#####.#####
#.........#
#......#..#
#.......#k#
#.........#
..........#
#.........#
#.........#
#.........#
#.........#
#####.#####
key : 2

