3
1
#####D#####
#.........#
#.........#
#.........#
#.........#
D.........D
#.........#
#.........#
#.........#
#.........#
#####D#####

2
3
#####D#####
#.........#
#.........#
#.........#
#.........#
D..####...D
#.###.#...#
#.###.....#
#..#......#
#.#.......#
#####d#####

3
5
#####D#####
#..#......#
#p..#.....#
#..#.#....#
#.........#
l.........#
#...p.....#
#.........#
#.........#
#.........#
###########
locked : 2

3
3
#####d#####
#e........#
##..#..#..#
#.........#
#.........#
D....#....l
#.........#
#.........#
##..#.....#
#e........#
#####D#####
enemies 2

2
4
#####l#####
#e.......e#
#.........#
#.........#
#.........#
D.........d
#.........#
#p........#
#.........#
#e........#
#####D#####
enemies 3

1
4
#####D#####
#.........#
#.........#
#.........#
#.........#
D....e....#
#.........#
#.........#
#.........#
#.........#
#####l#####
locked : 3
boss
enemies 1

4
4
#####d#####
#.........#
#.#.....#.#
#.........#
#.........#
D....#....#
#.........#
#.........#
#.#.....#.#
#.........#
###########

2
0
###########
#.p.......#
#..p......#
#.........#
#...##..#.#
#...##.#..D
#...##.##.#
#...##.#..#
#...#..##.#
#.........#
#####D#####

4
1
#####D#####
#.........#
#..#......#
#.#.......#
#.........#
D.........#
#.........#
#.........#
#.........#
#.........#
###########

1
3
###########
#k........#
#..#......#
#.#.......#
#.........#
#.........D
#.........#
#.#.......#
#..#......#
#.........#
#####D#####
key : 3

5
0
#####D#####
#.........#
#..#...#..#
#.........#
#...#.#...#
#.........#
#..#.#.#..#
#.........#
#...#.#.#.#
#k........#
###########
key : 0

4
0
#####l#####
#.........#
#.........#
#.........#
#?##@#....#
#..###....D
#....##...#
#..###....#
#...#.....#
#.........#
#####D#####
sign Only the prepared may pass.

3
2
#####D#####
#.........#
#.........#
#......##.#
#....#..#.#
D...##....D
#....#....#
#.....##..#
#.........#
#.........#
###########

2
1
###########
#.....e...#
#.#...#...#
#.........#
#..#.#.#..#
D.........D
#.#.#.#.#.#
#.........#
#..#...#.##
#.........#
#####D#####
enemies 1

4
3
#####D#####
#.#.....#.#
#.........#
#..#...#.##
#.........#
#...#.#...D
#.........#
#..#.#.#.##
#.........#
#k#.......#
###########
key : 2

2
5
###########
#.#.......#
#.###.##..#
#.#.#####.#
#.#.###...#
d...###...#
#....#..#.#
#.........#
#.........#
#.........#
#####D#####

0
4
###########
#X.......p#
#.........#
#.........#
#..##.....#
#..##.....#
#.#.#..p..#
#.........#
#.#.......#
#.........#
#####D#####

3
4
#####D#####
#.........#
#.........#
#..#.....##
#.........#
l.........l
#...#..#..#
#.........#
#.........#
#..#.....##
#####d#####
locked : 1

2
2
###########
#..k......#
#..#...#..#
#.#.....#.#
#.........#
D.........D
#.........#
#.......#.#
#......#..#
#.........#
#####D#####
key : 1

3
0
#####D#####
#.........#
#.........#
##........#
#.........#
#.........D
#....#....#
#.........#
#.........#
#.........#
#####l#####
locked : 0

