3
4
#####.#####
#.........#
#.........#
#.........#
#.##......#
l..##e.....
#.#.#.....#
##........#
##........#
#.........#
#####.#####
locked : 2
boss
enemies 1

2
1
#####.#####
#.........#
#..#....#.#
#.#.......#
#.......#.#
l..........
#.........#
#.........#
#.........#
#.........#
#####.#####
locked : 0

0
1
###########
#k........#
#.........#
#.........#
#...##....#
#...#..#..d
#...#.....#
#...#...#.#
#...#.###.#
#.......#.#
#####.#####
key : 1

4
4
#####.#####
#.#.......#
#.........#
#.#.#.#...#
#.........#
#...#.#...#
#.........#
#.#.#.#.#.#
#.........#
#k#.......#
###########
key : 5

2
4
#####.#####
##e#...#e##
#.........#
#.#...#.#.#
#.........#
.....#.#..#
#.........#
#.#.#.#.#.#
#.........#
#......#.##
#####.#####
enemies 2

3
0
#####.#####
#.........#
#.........#
#.........#
#.........#
#..........
#.........#
#.........#
#.........#
#k........#
###########
key : 0

1
1
#####.#####
#.........#
#.#.#.#.#.#
#.........#
#...#.#.#.#
#..........
#...#.#.#.#
#.........#
#.#.#...#.#
#.........#
#####.#####

3
3
#####d#####
#.........#
#...#.....#
#.........#
#.........#
#.........l
#......#..#
#.#.......#
#..#......#
#.........#
###########

1
4
#####.#####
#.........#
#.........#
#....##...#
#...###...#
d..#.##...#
#....##...#
#.....#...#
#.#.#.....#
#.........#
#####.#####

1
3
#####d#####
#?........#
#.##......#
#.#e......#
#.###.....#
..........d
#.........#
#.........#
#.........#
#.........#
#####.#####
enemies 1
sign Beware what lurks ahead.

0
2
###########
#.........#
#.........#
#.........#
#.........#
d..........
#.........#
#.......#.#
#......#..#
#.........#
#####.#####

2
3
#####.#####
#.........#
#.........#
#.........#
#.........#
...........
#.........#
#.........#
#.........#
#........##
#####d#####

0
4
###########
#........k#
#.........#
#.........#
#.........#
..........#
#.........#
#.........#
#.........#
#.........#
#####.#####
key : 2

0
3
###########
#.........#
#.........#
#..#......#
#.##......#
...#...#...
#...#...#.#
#...###.#.#
#.....##..#
#......#..#
#####d#####

2
0
###########
#.........#
#.........#
#...###...#
#...#.#...#
#...#@....l
#.##......#
#...##....#
#..#......#
#.........#
#####.#####

2
2
#####.#####
#.#.....#.#
#.........#
#.........#
#.#..#..#.#
...........
#.........#
#.#..#..#.#
#.........#
#.........#
###########

1
2
#####.#####
#.........#
#.........#
#.........#
#.........#
...........
#.........#
#.#.......#
#..#......#
#.........#
#####.#####

3
1
#####.#####
#.........#
#.........#
#.........#
#.........#
..........#
#.........#
#.........#
#.........#
#.........#
###########

3
5
###########
#........X#
#.........#
#.........#
#..#.#....#
...#......#
#.........#
#.........#
#.........#
#.........#
###########

