5
1
#####D#####
#.........#
#.........#
#.........#
#.........#
D.........#
#.........#
#.....###.#
#.........#
#.........#
#####D#####

4
2
#####D#####
#.........#
#..#...#..#
#.#.....#.#
#.........#
D.........#
#.........#
#.......#.#
#......#..#
#........k#
###########
key : 5

4
0
#####d#####
#.........#
#.........#
#.........#
#.........#
#....@....D
#.........#
#.........#
#.........#
#.........#
#####D#####

1
1
###########
#.#.......#
#.........#
#.........#
#..#......#
l.........D
#.........#
#....#..#.#
#.........#
#.........#
#####D#####
locked : 4

0
2
###########
#X........#
#.........#
#.........#
#.....#...#
#.....#...#
#.#.......#
#...#.....#
#.##......#
#.........#
#####D#####

3
1
#####l#####
#k........#
#.........#
#.........#
#.........#
D.........d
#.........#
#p........#
#.........#
#.........#
#####D#####
key : 1

2
0
#####D#####
#.........#
#......#..#
#.......#.#
#.........#
#.........D
#.........#
#.#.......#
#..#......#
#.........#
#####D#####

3
2
#####D#####
#.........#
#..#......#
#.#.......#
#.........#
d.........#
#.........#
#.#.......#
#..#......#
#.........#
#####D#####

7
0
#####l#####
#.........#
#.........#
#.........#
#.........#
#.........D
#.........#
#.........#
#.........#
#.........#
###########
locked : 1

6
0
#####D#####
#.........#
#.....#k#.#
#......#..#
#...#..#..#
#.........d
#.........#
#.........#
#.........#
#.........#
#####l#####
key : 0

4
1
#####D#####
#e........#
#.........#
#.........#
#.........#
D.........D
#.#.#.....#
#.#e#.....#
#...#.....#
#e........#
#####D#####
enemies 3

1
2
#####D#####
#..#......#
#..##.p...#
#.#.##....#
#.#.e..#..#
D....##...#
#....###..#
#.p.......#
#.........#
#.........#
#####d#####
boss
enemies 1

3
0
#####D#####
#.........#
#.........#
#.....#..##
#.........#
#.........D
#...#..#..#
#.........#
#.........#
#..#.....##
#####d#####

6
1
#####D#####
#.........#
#.#.......#
#.#....#..#
#....#.##.#
d....#....#
#.....##..#
#....#.#..#
##.....####
#.........#
#####D#####

2
1
#####D#####
#.........#
#...#.....#
#...###...#
#.........#
D.........D
#...#.....#
#.........#
#.........#
#.........#
#####l#####
locked : 0

2
2
#####d#####
#.........#
#.........#
#.........#
#..#..#...#
D........k#
#.........#
#..#..#...#
#.........#
#.........#
#####D#####
key : 4

5
0
#####D#####
##.#...#.##
#.........#
##.#.#.#.##
#.........#
#.........D
#.........#
##.#...#.##
#.........#
##.#...#.##
#####D#####

1
0
###########
#.#.....#.#
#.........#
#.#...#.#.#
#.........#
#...#.#...l
#.........#
#.#...#...#
#.........#
#.#.....#.#
#####D#####

7
1
#####D#####
#.........#
#..#.....##
#.........#
#.........#
D...#..#..#
#.........#
#.........#
#..#..#..##
#........e#
###########
enemies 1

