3
0
#####.#####
#.........#
#.........#
#...##....#
#...#.....#
#..?#@.....
#..##.##..#
#..##.##..#
#.........#
#.........#
#####.#####
sign A useful tool lies just ahead.

4
2
#####.#####
#.........#
#.#.....#.#
#.........#
#.........#
.....#....l
#.........#
#.........#
#.#.....#.#
#.........#
#####.#####

3
1
#####.#####
#..#...#e##
#.........#
#.#.#.#.#.#
#.........#
...#...#...
#.........#
#.#.#.#...#
#.........#
##e#.....##
#####.#####
enemies 2

5
3
#####.#####
#e........#
#.........#
#.........#
#.........#
...##......
#.###.....#
#.........#
#.........#
#?...e....#
###########
enemies 2
sign Seek the matching key before you proceed.

2
1
#####.#####
#k........#
#..#...#..#
#.#.....#.#
#.........#
...........
#.......#.#
#.#.......#
#..#......#
#.........#
#####.#####
key : 1

0
0
###########
#.........#
#.........#
#.........#
#.........#
#.........#
#.........#
#.........#
#.........#
#.........#
#####l#####
locked : 1

5
4
#####.#####
#.........#
#.........#
#.##..#...#
#.#..#....#
...#......#
#.#.###...#
#.#.......#
#.........#
#........X#
###########

4
4
###########
#.........#
#.........#
#.........#
#.....##..#
d....e....#
#.#....#..#
#.........#
#......#..#
#.........#
#####.#####
boss
enemies 1

4
1
#####.#####
#..#.....##
#.........#
#.........#
#.....#...#
l..........
#.........#
#..#..#...#
#.........#
#.........#
#####.#####
locked : 0

4
3
#####.#####
#.........#
#.........#
#....#..#.#
#.........#
l.........d
#.#.....#.#
#.........#
#.........#
#.#.......#
#####.#####
locked : 2

5
2
#####.#####
#.........#
#.........#
#.........#
#.........#
...........
#.........#
#.........#
#.........#
#.........#
###########

2
2
###########
#.........#
#..#...#..#
#.#.....#.#
#.........#
..........#
#.........#
#.........#
#.........#
#.........#
#####d#####

2
0
#####.#####
#k#.......#
#......#..#
#.......#.#
#.........#
#..........
#.........#
#...#...#.#
#......#..#
#.........#
#####.#####
key : 0

4
0
#####.#####
#.........#
#...#.#.#.#
#...#..##.#
#...##....#
#.........l
#.........#
#.........#
#..#......#
#.........#
###########

1
0
#####l#####
#?........#
#.........#
#....#..#.#
#.........#
#e.........
#..#..#...#
#.........#
#.........#
#e#.......#
#####.#####
enemies 2
sign A locked path — look elsewhere first.

3
2
#####d#####
#.........#
#.........#
#.........#
#.........#
....##.#...
#.........#
#...#.....#
#...#..#..#
#......##.#
#####.#####

5
1
#####.#####
#.........#
#.........#
#.........#
#.........#
#..........
#.........#
#.........#
#.........#
#k........#
###########
key : 2

1
1
###########
#........k#
#.........#
#.........#
#..#......#
..........#
#.........#
#.#.......#
#..#......#
#.........#
#####.#####
key : 3

3
3
###########
#.........#
#.#.....#.#
#.........#
#.#.#.#.#.#
..........#
#.#.#.#.#.#
#.........#
#.#.#.#...#
#.........#
#####.#####

