1
0
#####d#####
#.........#
#.........#
#.........#
#.........#
#k.........
#.........#
#.........#
#.........#
#.........#
#####.#####
key : 0

1
1
###########
#.#.....#.#
#.........#
#..#.#.#.##
#.........#
....#.#...#
#.........#
#....#.#..#
#.........#
#.......#.#
#####.#####

2
0
#####.#####
#.........#
#.........#
#.........#
#.........#
#....@.....
#.........#
#.........#
#.........#
#.........#
#####l#####

3
0
#####l#####
#.........#
#.........#
#.#.......#
#.###.....#
#..#.......
#.#.......#
#.###.....#
#.........#
#.........#
#####.#####
locked : 0

0
0
###########
#.........#
#........##
#.........#
#.........#
#...#..#..#
#.........#
#.........#
#.....#...#
#.........#
#####d#####

5
0
#####d#####
#.........#
#.#.#.....#
#.........#
#....#.#..#
#..........
#.....#.#.#
#.........#
#..#...#..#
#.........#
#####.#####

5
1
#####.#####
#e........#
#.........#
#.........#
#.........#
...........
#.........#
#.........#
#.........#
#e........#
#####d#####
enemies 2

6
0
#####.#####
#.........#
#..#..#...#
#.........#
#.........#
#..#..#....
#.........#
#.........#
#..#..#..##
#.........#
###########

3
1
#####.#####
#e.....#e##
#........##
#....#.##e#
#....#....#
......##...
#.........#
#.........#
#.........#
#.........#
#####.#####
enemies 3

6
3
#####.#####
#.........#
#........##
#.........#
#..#...#..#
.....#....#
#..#####..#
#...#.#...#
#.........#
#........X#
###########

6
1
#####d#####
#.........#
#..#......#
#.#.......#
#.........#
...........
#.........#
#.#...#.#.#
#..#...#..#
#.#.......#
###########

4
2
#####.#####
#.........#
#.........#
#.........#
#.........#
..........#
#.........#
#.........#
#.........#
#.........#
#####.#####

4
0
#####.#####
#.........#
#.........#
#e##.##...#
#..#..#...#
#..####....
#...#.....#
#.#.##....#
#.........#
#.........#
#####d#####
enemies 1

2
1
#####.#####
#.........#
#.........#
#.........#
#.......#.#
......#...#
#.........#
#.........#
#.........#
#.........#
#####.#####

3
2
###########
#........k#
#..#...#..#
#.#.....#.#
#.........#
..........#
#.........#
#.#.......#
#..#......#
#.........#
#####.#####
key : 2

4
1
#####.#####
#.........#
#.....###.#
#.....k##.#
#...####..#
...........
#.........#
#.........#
#.........#
#.........#
#####.#####
key : 1

5
2
#####.#####
#k#.....#.#
#.........#
#..#.#.#.##
#.........#
....#.#...d
#.........#
#..#.#.#.##
#.........#
#.#.......#
#####.#####
key : 6

5
3
###########
#.........#
#.........#
#.........#
#...e.....#
d...##....#
#...#.#.#.#
#...#.#.#.#
#...#.#...#
#.........#
#####.#####
boss
enemies 1

6
2
#####.#####
#.........#
#...#.....#
#.........#
#.........#
...........
#....#....#
#..#.##.#.#
#..#......#
#.....e#..#
###########
enemies 1

