4
1
#####.#####
#......#..#
#.....#k..#
#.....###.#
#...###.#.#
....###....
#......#..#
#.........#
#.........#
#..#......#
#####.#####
key : 1

0
1
###########
#........X#
#.....##.##
#.....#.#.#
#....#....#
#....#....#
#.....#.#.#
#.........#
#.........#
#.........#
#####.#####

6
1
#####l#####
#.........#
##.#......#
#.........#
#..#...#..#
..........#
#..#...#..#
#.........#
##........#
#.........#
#####.#####
locked : 1

3
1
#####.#####
#e........#
#.........#
#.###.....#
#..#......#
...#.#....d
#.#e......#
#.####....#
#.........#
#e........#
#####.#####
enemies 3

4
3
#####.#####
#......#..#
#.........#
##.#.#.#.##
#........?#
..........#
#.........#
#..#...#..#
#......s.e#
##....e#e##
###########
enemies 3
switch 0 : 0 1
sign Beware what lurks ahead.

3
2
#####.#####
##.#......#
#.........#
#.......#.#
#.........#
d..#.#.....
#.........#
#.#.#.#.#.#
#.........#
##.#...#.##
#####.#####

2
0
###########
#k........#
###.......#
#.#.#.....#
#.........#
#.........l
#..#......#
#.........#
#.........#
#.........#
#####.#####
key : 2

2
1
#####d#####
#.........#
##.....#.##
#.........#
#.#.#.#.#.#
l..........
#..#.#.#..#
#.........#
#.#.#...#.#
#.........#
#####.#####
locked : 4

5
0
#####.#####
#.........#
#..#......#
#.........#
#.........#
#....@....d
#.........#
#.........#
#.........#
#..#......#
#####.#####

6
0
#####.#####
#.........#
#..#......#
#.#.......#
#.........#
#..........
#.........#
#.........#
#.....#...#
#k........#
###########
key : 0

4
0
#####l#####
#.........#
#.........#
#.........#
#.........#
#..........
#.........#
#.........#
#.........#
#.........#
#####.#####

3
0
#####.#####
#.........#
#..#......#
#.#.......#
#.........#
#..........
#.........#
#.......#.#
#......#..#
#.........#
#####l#####
locked : 0

5
2
#####.#####
#.........#
#.........#
#.........#
#.......#.#
..........#
#...##....#
##.##.....#
#..#......#
#.........#
###########

4
2
#####.#####
#.........#
#...#.....#
#...#.....#
#.........#
...........
#.........#
#.#.......#
#..#......#
#.#.......#
#####.#####

2
2
###########
#........e#
#.........#
#.....#..##
#.........#
..........#
#..#..#...#
#.........#
#.........#
#..#.....##
#####.#####
enemies 1
door 0 : 0 1

1
1
#####.#####
#.........#
#.........#
#.........#
#.........#
#..#.e....#
#.........#
#.###.....#
#..#......#
####......#
#####d#####
boss
enemies 1

7
1
#####.#####
#.........#
##.#.....##
#.........#
#.#...#.#.#
#.........#
#..#.#.#..#
#.........#
#...#.#.#.#
#k........#
###########
key : 4

3
3
###########
##......e##
#.........#
#.#...#.#.#
#.........#
...#.#.#..#
#.........#
#...#...#.#
#.........#
##.#...#.##
#####.#####
enemies 1

5
1
#####.#####
#.........#
#......#..#
#.......#.#
#.........#
d..........
#.........#
#.........#
#.........#
#.........#
#####l#####

