6
5
#####.#####
#.........#
#.#.......#
###.#.....#
#....#....#
#..##.....#
#..##.....#
#.........#
#.........#
#X........#
###########

4
3
#####.#####
#.........#
#......#..#
#.......#.#
#.........#
l.........d
#.........#
#.........#
#.........#
#.........#
#####d#####
locked : 3

2
2
#####.#####
#.........#
#.........#
#.#.##.##.#
#.###..##.#
...##.##..d
#...#...#.#
###.#.....#
#.........#
#.........#
#####.#####

5
3
#####d#####
#.........#
#.........#
#.........#
#..###.##.#
....#.##...
#...#.#.#.#
#.........#
#.........#
#.........#
###########

5
4
#####.#####
#.........#
#.........#
#.........#
#....##...#
...#......d
#..###....#
#..e###...#
#..#.e#...#
#.........#
###########
enemies 2

2
4
###########
#..#......#
##..#.....#
#.#.#.....#
#.#.......#
l.........#
#......#..#
#.........#
#.#.......#
#.........#
###########
locked : 0

2
1
###########
#k........#
#..#..#...#
#.........#
#.........#
#..#..#....
#.........#
#.........#
#..#.....##
#.........#
#####.#####
key : 0

1
3
#####.#####
#.........#
#.........#
##........#
#.#.......#
..........#
#.........#
#.........#
#.........#
#.........#
#####.#####

3
1
#####.#####
#e........#
##.##.....#
##..#.....#
#.##..#...#
...#..##...
#..##.....#
#..####...#
#..##e#...#
#.........#
###########
enemies 2

2
3
#####.#####
#.........#
#.........#
#.........#
#.........#
d.........l
#.........#
#.#.....#.#
#..#...#..#
#.........#
#####.#####

3
2
#####.#####
##.#...#.##
#.........#
##.#.#.#.##
#.........#
...#.......
#.........#
##.#.#...##
#.........#
##.#...#..#
#####.#####

3
0
###########
#?........#
#..##.....#
#..#..#...#
#.....#...#
#....@.#...
#....###..#
#.........#
#.........#
#......#..#
###########
sign The torches flicker in a sourceless wind.

3
3
#####.#####
#.........#
#.........#
#.........#
#.........#
...##.....#
#.##k#....#
#.##......#
#.##......#
###.......#
#####.#####
key : 1

0
3
###########
#k........#
#.........#
#.........#
#.........#
#.........#
#.........#
#.........#
#.........#
#.........#
#####.#####
key : 3

5
2
#####l#####
#..#......#
##........#
#.........#
#.........#
#..........
#.........#
#.........#
#.........#
#.........#
###########
locked : 2

4
4
###########
#.........#
#..#......#
#.#.......#
#.........#
d.........#
#.........#
#.#.......#
#..#......#
#.........#
#####.#####

5
5
###########
#.........#
#.........#
#.........#
#.........#
d....e....#
#.........#
#.........#
#.........#
#.........#
#####.#####
boss
enemies 1

1
2
###########
#.........#
#.........#
#.#.......#
#.###.....#
#..........
#.#.#.....#
#.#.#.#...#
#.....#...#
#.........#
#####.#####

4
2
#####.#####
#.........#
#..#......#
#k#.......#
#.........#
#.........l
#.........#
#.#.......#
#..#......#
#.........#
#####l#####
key : 2

