4
4
#####.#####
#e........#
#.........#
#.........#
#.........#
...#..#..e#
#.........#
#.........#
#.#.......#
#?........#
#####.#####
enemies 2
sign Something glints behind that door…

3
0
#####.#####
#.........#
#.........#
#.........#
#.........#
#....@.....
#.........#
#.........#
#.........#
#.........#
#####.#####

4
3
#####.#####
#.......#.#
#......#..#
#.......#.#
#.........#
#..........
#.........#
#.........#
#.........#
#k........#
###########
key : 0

1
1
###########
#.........#
#.........#
#.........#
#.........#
#.........#
#.........#
#.........#
#.........#
#.........#
#####d#####

2
3
###########
#.........#
##.#...#.##
#.........#
#.#.#.#.#.#
...........
#..#.#.#..#
#.........#
#.#...#.#.#
#.........#
#####l#####
locked : 0

2
4
#####.#####
#.........#
#.........#
#.........#
#.........#
.....e.....
#.........#
#..#......#
#..#......#
#.........#
#####d#####
boss
enemies 1

0
4
###########
#.........#
#X##......#
##.#......#
#..#......#
#.........#
#.........#
#.........#
#.........#
#.........#
#####.#####

3
5
#####.#####
#.........#
#..#......#
#.#.......#
#.........#
..........#
#.........#
#.#.......#
#..#......#
#.........#
###########

3
2
#####.#####
#e.#.....##
#.........#
#.........#
#.....#...#
..........d
#.........#
#..#..#..##
#.........#
#?...e....#
###########
enemies 2
sign The dungeon remembers all who enter.

4
0
#####.#####
#.........#
#.........#
#.........#
#.........#
#.........#
#.........#
#.........#
#.........#
#.........#
###########

2
1
#####d#####
#e......#e#
#.........#
#.........#
#.........#
...........
#.........#
#...#.....#
#.........#
#e........#
#####.#####
enemies 3

3
3
#####l#####
#.........#
#.........#
#.........#
#.........#
d.........d
#.........#
#.........#
#.........#
#.........#
#####.#####

3
4
#####d#####
#.#.....#.#
#.........#
#.#.#...#.#
#.........#
d...#.#....
#.........#
#...#.#.#.#
#.........#
#.......#.#
#####.#####

1
4
#####.#####
#.........#
#......#..#
#.........#
#.........#
#k........#
#.....#...#
#.........#
#.........#
#.........#
#####.#####
key : 2

5
4
#####.#####
#.#.....#.#
#.........#
#....#...##
#.........#
#...#.#...#
#.........#
#..#.#.#.##
#.........#
#k#.....#.#
###########
key : 4

2
2
###########
##.....#..#
#.........#
#.........#
#....#..#.#
...........
#.........#
##........#
#.........#
#.........#
#####.#####

2
5
###########
#........k#
#.........#
#.........#
#.......#.#
..........#
#.........#
#.........#
#.........#
#.........#
#####.#####
key : 1

3
1
#####.#####
#e#.....#e#
#.........#
#.........#
#..#......#
...........
#.........#
#.#..#..#.#
#.........#
#....e....#
###########
enemies 3

2
0
###########
#.........#
#......#..#
#.......#.#
#.........#
#..........
#.........#
#.......#.#
#......#..#
#.........#
#####.#####

