0
6
###########
#.........#
#.......#.#
#..#......#
#.........#
d....e....#
#.........#
#.........#
#.........#
#.........#
#####.#####
boss
enemies 1

1
5
#####.#####
#.........#
#.....###.#
#.....#...#
#......##.#
l..........
#.........#
#.........#
#.........#
#.........#
###########
locked : 2

0
5
###########
#.........#
#...#..#..#
#.........#
#.........#
d....#....d
#.........#
#.........#
#......#..#
#.........#
#####.#####

3
2
#####.#####
#.........#
#.#.....#.#
#.........#
#.........#
...........
#.........#
#.........#
#.#.....#.#
#.........#
#####.#####

1
3
###########
#.........#
#..#......#
#.#.......#
#.........#
d..........
#.........#
#.......#.#
#......#..#
#.........#
#####.#####

4
0
#####d#####
#.........#
#.........#
#.........#
#.........#
#.........#
#.....#...#
#.........#
#......#..#
#.........#
###########

1
6
#####.#####
#.........#
#.........#
#.........#
#.........#
..........#
#.....##..#
#....#.##.#
#......##.#
#.......#X#
###########

0
4
###########
#.........#
#.....#.#.#
#.........#
#....####.#
#.....#...d
#......#..#
#.........#
#.........#
#.........#
#####.#####

2
4
#####.#####
#..#.....##
#.........#
##.....#.##
#.........#
...#.#.#..#
#........?#
#....#.#e##
#........e#
##.#....e##
###########
enemies 3
sign This door will not yield without a key.

3
3
#####.#####
#k........#
##.#...#.##
#.........#
#..#.#.#..#
..........#
#....#....#
#.........#
##.#...#..#
#.........#
#####.#####
key : 2

1
4
#####.#####
#e.......e#
#.........#
##..#..#..#
#.........#
..........l
#...#..#..#
#.........#
#.........#
##.......e#
#####.#####
enemies 3

4
2
#####.#####
#.........#
####......#
####......#
#..#......#
#..........
#.........#
#.........#
#.........#
#k........#
###########
key : 0

1
2
###########
#.........#
#.........#
#.........#
#.........#
#.........d
#.........#
#.........#
#.........#
#.........#
#####l#####
locked : 1

4
3
#####.#####
#.........#
##.#...#.##
#.........#
#.#.#.#.#.#
..........#
#..#.#.#..#
#.........#
#.#.#.#.#.#
#........k#
###########
key : 4

2
0
###########
#......#..#
#.........#
#.........#
#...#..#..#
#.........#
#.........#
#......#..#
#.........#
#.........#
#####.#####

3
0
#####.#####
#.##......#
#..#......#
#.#.#.....#
#.#.##....#
#....@.....
#?##......#
##..##..#.#
##........#
#.........#
#####d#####
sign Many have walked this path.

3
1
###########
#..#......#
#..#..#...#
#.#.......#
#.........#
....#......
#.........#
#.........#
#.........#
#.........#
###########

2
3
#####.#####
#.......#.#
#.........#
#.........#
#.........#
l..........
#.........#
#.........#
#.........#
#.........#
#####.#####
locked : 0

2
2
#####l#####
#.........#
#...#.##..#
#...####..#
#.....#...#
#k........l
#.........#
#.........#
#.........#
#.........#
#####.#####
key : 1

