0
0
###########
#ee.......#
#e........#
#s....###.#
#?....###.#
#.....##..D
#.....##..#
#.........#
#.........#
#.........#
#####D#####
enemies 3
switch 0 : 0 1
sign Those who search shall find.

0
1
###########
#......e.e#
#..##..#..#
#..#####..#
#...###...#
D..##.#...#
#..#..##..#
#.........#
#.........#
#.........#
#####D#####
enemies 2
door 0 : 0 1

5
1
#####D#####
#........##
#.........#
#.........#
#..#..#...#
D.........#
#.........#
#..#.....##
#.........#
#.........#
#####D#####

3
0
#####d#####
#.........#
#.##......#
#.#.......#
#.........#
#.........D
#.........#
#.#.......#
#..#......#
#.........#
#####D#####

7
1
#####D#####
#.........#
#.#.......#
#.........#
#.........#
D.........#
#.........#
#.#.....#.#
#..#...#..#
#........k#
###########
key : 3

8
0
#####l#####
#.........#
#.....##.##
#....#..###
#...e#....#
#....##...#
#....#....#
#.........#
#.........#
#.........#
#####D#####
locked : 2
boss
enemies 1

4
0
#####D#####
#.........#
#.........#
#..#..##..#
#.##@.###.#
#..####...D
#..#.#.#..#
#.#.....###
#.........#
#.........#
#####D#####

9
0
#####D#####
#.........#
#.........#
#.......p.#
#.........#
#..#..#...#
#..#.#....#
#...####..#
#.....##p.#
#..#...#X.#
###########

4
2
###########
#.........#
#..#...#.##
#.........#
#.....#.#.#
d.........#
#..#.#.#..#
#.........#
#.#.#.#...#
#.........#
###########

3
1
#####D#####
#e.......e#
##.#.....##
#........s#
#.#.#.#?#e#
D.........#
#..#......#
#.........#
#.#.#.#.#.#
#.........#
#####D#####
enemies 3
switch 1 : 2
sign A useful tool lies just ahead.

2
1
#####D#####
#.........#
#.........#
#.........#
#......#..#
D......#..#
#..#####..#
#..#k#.#..#
#......#..#
#.........#
#####D#####
key : 1

4
1
#####D#####
#.........#
#.........#
#.#.....#.#
#.........#
D.........d
#..#......#
#.........#
#.........#
#k#.....#.#
#####D#####
key : 0

1
1
#####D#####
#e........#
#.........#
#.........#
#.....##..#
D.....e#.e#
#......#..#
#.........#
#.........#
#.........#
#####D#####
enemies 3
door 1 : 2

7
0
#####l#####
#.........#
#........##
#.........#
#.........#
#......#..D
#.........#
#.........#
#..#..#..##
#.........#
#####l#####
locked : 0

6
1
#####D#####
#.#.....#.#
#.........#
#.........#
#..#..#...#
d.........#
#.........#
#.#..#..#.#
#.........#
#.........#
#####D#####

5
0
#####D#####
#.........#
#..#...#..#
#.#.....#.#
#..#......#
#.....#...D
#.........#
#.........#
#.........#
#..#......#
#####D#####

1
0
#####D#####
#k#.....#.#
#.........#
#.....#...#
#.........#
#...#.....D
#.........#
#.#.#.#.#.#
#.........#
#.#.....#.#
#####D#####
key : 2

2
0
#####D#####
#.........#
#......#..#
#..#....#.#
#.........#
#.........D
#.........#
#.......#.#
#.........#
#.........#
#####d#####

6
0
#####D#####
#.........#
#.........#
#...p.....#
#.........#
#.........d
#.........#
#.........#
#.........#
#.........#
#####l#####

