2
1
###########
#.......ee#
#........e#
#...##....#
#..####...#
D...#s#...#
#...#.....#
#.........#
#.........#
#.........#
#####D#####
enemies 3
switch 0 : 0

7
1
#####d#####
##.#......#
#..##.....#
#..###....#
#..#......#
#....e....#
#.........#
#.........#
#.........#
#.........#
#####D#####
boss
enemies 1

6
0
#####D#####
#.........#
#.........#
#.........#
#.........#
#.........D
#...#.....#
#.........#
#..##.....#
#.........#
###########

5
0
#####D#####
#.........#
#..#......#
#.........#
#.........#
#.....#...D
#.........#
#.........#
#..#..#..##
#.........#
#####D#####

3
0
#####d#####
#.........#
#......#..#
#.......#.#
#.........#
#k..#.....D
#.........#
#....#..#.#
#......#..#
#.........#
#####D#####
key : 0

5
1
#####D#####
#.........#
#..##.....#
#.#k###...#
#.....#...#
D.........d
#.........#
#.........#
#.........#
#........##
#####D#####
key : 1

3
2
###########
#.......ee#
#........e#
#.........#
#.........#
D.........#
#.........#
#.........#
#.........#
#.........#
#####D#####
enemies 3
door 1 : 1

8
1
#####D#####
#.........#
#...#.....#
#.....#...#
#...#.....#
#...#.....#
#.....#...#
#.........#
#.........#
##.......X#
###########

6
1
#####D#####
#k........#
#.........#
#.........#
#.........#
D.........D
#.........#
#.#.......#
#..#......#
#.........#
#####d#####
key : 4

1
0
#####D#####
##.#...#..#
#.........#
#.#...#...#
#.........#
#....#.#..#
#.........#
#.....#.#.#
#.........#
#..#...#..#
#####d#####

2
0
#####d#####
##.#.....##
#.........#
##...#.#..#
#.........#
#..#.#.#..D
#.........#
#......#.##
#.........#
##.#...#.##
#####d#####

4
0
#####D#####
#.........#
#.........#
#..p...##.#
#...#..##.#
#...#@....l
#.........#
#.p.......#
#.........#
#.........#
#####D#####

5
2
#####D#####
##.#...#..#
#.........#
#.#.#...#.#
#.........#
d..#.#.#..#
#.........#
#...#.#.#.#
#.........#
##.#......#
#####D#####

4
3
###########
##.......k#
#.........#
#.........#
#.#.....#.#
D.........#
#.........#
#...#..#..#
#.........#
#.........#
###########
key : 6

4
2
#####D#####
#e........#
#.........#
#..##.....#
#..#e#....#
D..#......D
#.........#
#.........#
#.........#
#e........#
#####D#####
enemies 3
door 0 : 0

0
0
###########
#e.......?#
###s#.....#
##e###....#
#.........#
#.........#
#..##.....#
#.##......#
#...#.....#
#.........#
#####D#####
enemies 2
switch 1 : 1
sign Many have walked this path.

6
2
#####D#####
#.........#
#.#.....#.#
#.........#
#.........#
D..#..#...#
#.........#
#.........#
#.#.....#.#
#.........#
###########

3
1
#####D#####
#..#......#
#.#.......#
#.#.......#
#.........#
D.........D
#.........#
#.........#
#.........#
#.........#
#####D#####

4
1
#####D#####
#.........#
#......#..#
#.......#.#
#.........#
l.........D
#.........#
#.........#
#.........#
#.........#
#####D#####
locked : 0

