2
3
#####d#####
#.........#
#.........#
#..#......#
#.........#
d..#.#....D
#..#.#....#
#..###...p#
#.........#
#.........#
#####l#####

5
1
#####d#####
#.........#
##..#..#..#
#.........#
#.........#
D....#....D
#.........#
#.........#
##..#.....#
#.........#
###########

6
0
#####D#####
#.........#
#.........#
##..#..#..#
#.........#
#.........#
#?#..#..#.#
#.........#
#e........#
##e....#se#
###########
enemies 3
switch 0 : 0 1
sign Many have walked this path.

2
0
###########
#.........#
#.........#
#.........#
#.........#
#....@....D
#.....##..#
#.....#.#.#
#.....#.#.#
#.........#
#####D#####

4
1
#####D#####
#.........#
#.........#
#......#..#
#.........#
D.........D
#....#....#
#.#.......#
#..#......#
#.........#
#####d#####

2
2
###########
#.........#
#.........#
#..#.##...#
#..#.#.#..#
D..#...#..d
#.......#.#
#.....##..#
#.........#
#.........#
#####D#####

2
1
#####l#####
#k........#
#.#.....#.#
#.........#
#.........#
D....#....D
#.........#
#.........#
#.#.....#.#
#.........#
#####D#####
key : 1

1
3
#####D#####
#.........#
#...#.....#
#..#......#
#...#.....#
#...e#....#
#...##....#
#...#.....#
#.........#
#.........#
#####d#####
boss
enemies 1

0
3
###########
#X........#
#.........#
#.........#
#.........#
#.........#
#.........#
#.........#
#.........#
#.........#
#####D#####

3
0
#####D#####
#........##
#.........#
#.........#
#..#..#...#
#k........D
#.........#
#..#..#..##
#.........#
#.........#
#####D#####
key : 0

4
0
#####D#####
#.........#
#.........#
#........##
#.........#
#.........D
#..#..#...#
#.........#
#.........#
#........##
#####d#####

3
1
#####D#####
#.........#
#.##...#.##
#....##.#.#
#.##.##...#
D...###...D
#.#....##.#
#.........#
#......#..#
#.........#
#####D#####

3
3
#####l#####
#..#.....##
#.........#
#.........#
#......#..#
D.........#
#.........#
#..#..#...#
#.........#
#.........#
###########
locked : 3

1
1
###########
#.........#
#..#..#..##
#.........#
#.........#
#.....#...#
#.........#
#.........#
#..#..#..##
#.........#
#####l#####
locked : 1

5
0
#####d#####
#.........#
#.........#
#.........#
#.........#
#.........D
#.........#
#.........#
#.........#
#.........#
#####D#####

3
2
#####D#####
#k........#
#..#...#..#
#.#.....#.#
#.........#
D.........D
#.........#
#.#.......#
#..#......#
#.........#
#####D#####
key : 3

4
2
#####D#####
#.........#
#.........#
#.........#
#.#####...#
D..#k.#...#
#..##.....#
#..####...#
#..##.....#
#.........#
#####D#####
key : 5

5
2
#####D#####
#.........#
#.........#
#.........#
#.........#
D.........#
#.........#
#.........#
#........e#
#.......ee#
###########
enemies 3

2
4
###########
#........e#
#p........#
#.......pe#
#......#..#
D.....##..#
#......#..#
#.........#
#.........#
#........e#
###########
enemies 3
door 0 : 0 1

