2
4
#####.#####
#.........#
#..#..#..##
#.........#
#.........#
.......#...
#.........#
#.........#
#..#..#..##
#.....k...#
###########
key : 3

1
2
###########
#.......ee#
#...#...#.#
#.........#
#...#.#.#.#
..........#
#.#...#.#.#
#.........#
#.#.#.#.#.#
#.........#
#####.#####
enemies 2

2
0
#####.#####
#e........#
#.........#
#.........#
#?........#
#e........d
#.........#
#.........#
#.........#
#.........#
#####.#####
enemies 2
sign Beware what lurks ahead.

1
0
###########
#.........#
#.........#
#....#....#
#.........#
#..........
#....#..#.#
#.........#
#.........#
#.#.....#.#
#####.#####

5
0
#####l#####
#.........#
#..##.....#
#....##...#
#..#.##...#
#..##.#...#
#..#..##..#
#.....#...#
#.........#
#.........#
###########
locked : 1

3
1
#####.#####
#.........#
#.........#
#...#.#...#
#.........#
..........#
#.........#
#.........#
#.........#
#.........#
#####.#####

4
0
#####.#####
#.........#
#.........#
#.........#
#.........#
#..........
#.........#
#.........#
#.........#
#........##
#####l#####

1
1
#####d#####
#.........#
#..##.....#
#.#.......#
#.........#
...........
#.....#...#
#.........#
#.........#
#.........#
#####d#####

2
5
###########
#...e.....#
#...#.#.#.#
#.........#
#.#.#.#.#.#
..........l
#.#.#.#.#.#
#.........#
#.#.#.#.#.#
#.........#
#####.#####
enemies 1

2
1
#####d#####
#.........#
#..#...#..#
#.#.....#.#
#.........#
d..........
#.........#
#.......#.#
#......#..#
#.........#
#####.#####

2
2
#####.#####
#.........#
#......#..#
#.......#.#
#.........#
..........d
#.........#
#.#.....#.#
#..#...#..#
#.........#
###########

1
4
###########
#k........#
#..#......#
#.#.......#
#.........#
#.........#
#.........#
#.......#.#
#......#..#
#.........#
#####.#####
key : 4

3
5
#####.#####
#.........#
#...#.#.#.#
#.........#
#.#...#...#
#..........
#.#.#.....#
#.........#
#.#.#.#...#
#k........#
###########
key : 5

2
6
###########
#..#...##.#
#..##.....#
#.#####.#.#
#..##.##..#
l....e#...#
#.........#
#.........#
#.........#
#.........#
#####.#####
locked : 4
boss
enemies 1

3
0
#####.#####
#.........#
#.........#
#.........#
#.........#
#....@.....
#.........#
#.........#
#.........#
#.........#
#####.#####

4
1
#####.#####
#.........#
#..#......#
#.#.......#
#.........#
..........#
#.........#
#.#.....#.#
#..#...#..#
#........k#
###########
key : 1

0
1
###########
#.........#
#.....#...#
######....#
#..##.....#
#.........#
#..##.....#
###.#.....#
#.........#
#.........#
#####d#####

2
3
###########
#.........#
#......#..#
#.......#.#
#.........#
d..........
#.........#
#.........#
#.........#
#.........#
###########

3
6
#####.#####
#.........#
#.........#
#.........#
#.........#
....#.....#
#.........#
#.....##..#
#.........#
#........X#
###########

