5
4
#####.#####
#.........#
#.........#
#.........#
#.........#
..........#
#...#.....#
#.........#
#.........#
#........X#
###########

3
1
#####.#####
#.........#
#......#..#
##......#k#
#...#.....#
..........#
#.........#
#.......#.#
#.....##..#
#.........#
#####d#####
key : 2

4
1
#####d#####
#.........#
#......#..#
#.....##..#
#..####...#
#..........
#..###.#..#
#...#.##..#
#.........#
#.........#
#####.#####

5
2
#####d#####
##.#...#.##
#.........#
#.#.#.#.#.#
#.........#
.....#.#...
#.........#
#.#...#...#
#.........#
##.#...#..#
###########

3
0
#####.#####
#.........#
#.........#
#..###....#
#..?##....#
#..###.....
#.........#
#.........#
#e........#
#ee.......#
###########
enemies 3
sign A useful tool lies just ahead.

4
3
#####.#####
#.#.....#.#
#.........#
#.#...#.#.#
#.........#
l...#.#...l
#.........#
#.#.#.#.#.#
#.........#
#.......#.#
#####d#####
locked : 2

0
0
###########
#.........#
#.#.....#.#
#.........#
#.........#
#....#....#
#.........#
#.........#
#.........#
#.........#
#####d#####

1
2
###########
#........k#
#.....#...#
#.....###.#
#.......#.#
..........#
#.........#
#.........#
#.........#
#.........#
#####.#####
key : 1

4
2
###########
#.........#
#...#.#...#
#.........#
#....#.#..#
..........l
#.#.#.....#
#.........#
#..#.....##
#.........#
#####d#####

3
3
###########
#k........#
#..#...#..#
#.........#
#.#.#...#.#
#.........#
#..#.#.#..#
#.........#
#.#...#.#.#
#.........#
#####.#####
key : 3

1
0
#####d#####
##......#.#
####...##.#
##?##.###.#
#..#......#
#....@.....
#.........#
#.........#
#.........#
#.........#
#####.#####
sign What you seek is close.

5
1
#####.#####
#.........#
#.........#
#.........#
#.........#
#..........
#.........#
#.........#
#.........#
#.........#
#####.#####

2
0
#####.#####
#.##......#
#.#.#.....#
#.#.......#
#..#......#
#..........
#.......#.#
#...#.....#
#.........#
#.........#
#####.#####

2
1
#####.#####
#.........#
#..#......#
#.#.......#
#.........#
...........
#.........#
#.........#
#.........#
#.........#
#####.#####

4
4
###########
#.........#
#.....###.#
#....##..##
#....###..#
l....e##..#
#.....##..#
#.........#
#.........#
#.........#
#####.#####
locked : 0
boss
enemies 1

1
1
###########
####k.....#
#.###.....#
#.#.#.....#
#.#.#.....#
...........
#.......#.#
#.........#
#......##.#
#.........#
#####.#####
key : 0

2
2
#####.#####
#.#.....#.#
#.........#
#.........#
#..#..#...#
..........#
#.........#
#.#..#..#.#
#.........#
#.........#
###########

6
1
#####.#####
#.........#
#.........#
#..#..#..##
#.........#
#.........#
#...#..#..#
#.........#
#.........#
#ee#....e##
###########
enemies 3

5
3
#####d#####
#.......#.#
#.........#
#..#.#.#.##
#.........#
...........
#.........#
#..#...#.##
#.........#
#.#.....#.#
###########

