2
1
#####D#####
#.........#
##.##.....#
#.#.#.....#
#.#.#.....#
D...#.....D
#..##.....#
#.........#
#.........#
#.........#
#####D#####

6
1
#####D#####
#.........#
#......#..#
####......#
#e#.#.....#
#...#.....#
#.##......#
#.........#
#.........#
#e.......e#
###########
enemies 3

3
3
###########
##k#...#.##
#.........#
#.#.#.#.#.#
#.........#
#....#.#..#
#.........#
#.#...#...#
#.........#
##.#...#..#
#####D#####
key : 3

1
1
###########
#.........#
#.........#
#..###....#
#..k##....#
D..###....D
#.........#
#.........#
#.........#
#.........#
#####D#####
key : 0

0
0
###########
#.#.....#.#
#.........#
#.#...#.#.#
#.........#
#...#.#...#
#.........#
#.#.#.#.#.#
#.........#
#.......#.#
#####d#####

5
4
#####D#####
#.........#
#.........#
#.........#
#...#.#...#
D..#..#...#
#...##.#..#
#......#..#
#..##.#...#
#........X#
###########

1
2
###########
#........k#
#.........#
#.........#
#.........#
D.........#
#.........#
#.........#
#.........#
#.........#
#####D#####
key : 1

3
1
#####D#####
#.........#
#.........#
#.........#
#.........#
D.........#
#.........#
#.......#k#
#......#..#
#.........#
#####d#####
key : 2

5
1
#####D#####
#.........#
#......#..#
#.......#.#
#.........#
#.........D
#.........#
#.#.....#.#
#..#...#..#
#.........#
#####D#####

5
3
#####d#####
#.#.......#
#.###.....#
#.........#
#...##....#
D..##.....D
#.........#
#.........#
#.........#
#.........#
###########

5
2
#####d#####
#..#...#..#
#.........#
#.#.#...#.#
#.........#
D..#.#.#..D
#.........#
#.#.#.#.#.#
#.........#
#..#...#.##
###########

4
3
#####D#####
#.........#
#.........#
#.........#
#.........#
l.........l
#.........#
#.........#
#.........#
#.........#
#####d#####
locked : 2

1
0
#####d#####
#.........#
#..#......#
#..?##....#
#..####...#
#...@###..D
#...##.#..#
#..##.....#
#...#.....#
#.......#.#
#####D#####
sign What you seek is close.

2
0
#####D#####
#.........#
#......#..#
#.......#.#
#.........#
#.........D
#.........#
#.........#
#...#.....#
#.........#
#####D#####

3
0
#####D#####
#.........#
#.........#
#.........#
#.........#
#.........D
#.........#
#?........#
#e........#
#ee.......#
###########
enemies 3
sign A useful tool lies just ahead.

2
2
#####D#####
#.........#
#.........#
#.........#
#.........#
D.........#
#.........#
#.#.....###
#..#......#
#......##.#
###########

4
4
###########
#.........#
#####.#...#
#.#...#...#
#.##......#
l....e....#
#.........#
#.........#
#.........#
#.........#
#####D#####
locked : 0
boss
enemies 1

4
2
###########
#.#.....#.#
#.........#
#..#.#.#..#
#.........#
D.........l
#.........#
#..#.#.#.##
#.........#
#.#.....#.#
#####d#####

4
1
#####d#####
#.......#.#
#.........#
#..#.#.#.##
#.........#
#.........D
#.........#
#..#...#.##
#.........#
#.#.....#.#
#####D#####

