3
1
#####.#####
#.........#
#..#......#
#.#.......#
#.........#
...........
#.........#
#.......#.#
#......#..#
#.........#
#####.#####

3
0
###########
#.........#
#...#.#...#
#..####...#
#.....#...#
#....@.....
#..####...#
#....#....#
#..##.....#
#.........#
###########

1
4
###########
#....k....#
#.........#
#.....#...#
#.........#
...........
#...#..#..#
#.........#
#.........#
#.........#
#####d#####
key : 2

2
5
#####.#####
#.........#
#.........#
#.####....#
#..###....#
....###...#
#.###X#...#
#...#.#...#
#.........#
#.........#
#####.#####

1
2
###########
#e..e.e#..#
#s..#.###.#
#......#..#
#.....##..#
#...#......
#.........#
#.........#
#.........#
#.........#
#####.#####
enemies 3
switch 0 : 0

3
5
#####.#####
#........##
##.....#..#
#.......#.#
#.........#
d.........#
#.........#
#.#.......#
#..#......#
#.........#
###########

2
4
#####d#####
#.........#
#..##.....#
#..#..##..#
#....#..#.#
.....e.#...
#.........#
#.....#...#
#.........#
#.........#
#####.#####
boss
enemies 1

2
2
#####.#####
#k........#
#.........#
#.........#
#.........#
.....#.....
#.........#
#.........#
#.......#.#
#.........#
#####.#####
key : 1

0
5
###########
#e.......e#
#...#.....#
#.##......#
#.........#
#..###....#
#.##......#
###.#.....#
###.#.....#
#.........#
#####.#####
enemies 2
door 0 : 0

3
3
#####d#####
#.........#
#..#...#..#
#.#.....#.#
#.........#
l.........d
#.........#
#.#.....#.#
#..#...#..#
#.........#
#####l#####
locked : 0

3
4
#####.#####
#.........#
#..#......#
#.#.......#
#.........#
d.........d
#.....#...#
#.......#.#
#......#..#
#.........#
###########

3
2
#####.#####
#.........#
#.....###.#
#.....#k#.#
#.....#...#
..........l
#....#....#
#...##....#
#.........#
#.........#
###########
key : 0

1
5
#####.#####
#.........#
#...#.#k#.#
#.....###.#
#...###.#.#
......#....
#...#..##.#
#.........#
#.........#
#.........#
#####.#####
key : 3

1
3
###########
#.......#.#
#...#..#..#
#...#..#..#
#...#.###.#
......#....
#..#......#
#...#.....#
#..#......#
#.........#
#####.#####

1
6
###########
#........e#
#.........#
#.........#
#.##......#
.....#....#
#.####....#
#.##.#....#
#.##......#
#........?#
###########
enemies 1
sign A useful tool lies just ahead.

4
1
#####.#####
#.........#
#.#.....#.#
#.........#
#.#...#...#
#.........#
#.#.#.#.#.#
#.........#
#.#...#.#.#
#.........#
###########

2
3
#####.#####
#.........#
#.........#
##........#
#.##.#....#
.....#.....
#..#......#
#....#....#
#.........#
#.........#
#####d#####

2
1
###########
#.........#
#......#..#
#.......#.#
#.........#
#..........
#.........#
#.........#
#.........#
#.........#
#####.#####

4
3
#####l#####
#.......###
#......#..#
#.....#..##
#....#.#..#
#.........#
#.........#
#.........#
#.........#
#.........#
###########
locked : 1

