1
0
###########
#?........#
#..#......#
#..#......#
#....#....#
#....@.....
#.........#
#.........#
#.........#
#.........#
#####.#####
sign A useful tool lies just ahead.

1
5
#####d#####
#?.......e#
#..#...#.##
#.........#
#.#.#.....#
...........
#..#.#.#..#
#.........#
#.#...#.#.#
#.........#
#####d#####
enemies 1
sign What you seek is close.

0
5
###########
#.........#
#.........#
#.........#
#.........#
#.........#
#.........#
#.........#
#.........#
#.........#
#####d#####

3
2
#####d#####
#.........#
#.........#
#.........#
#.........#
#.........#
#.........#
#.........#
#.........#
#.........#
###########

2
1
#####.#####
#.........#
#.........#
#.........#
#.........#
l..........
#.........#
#.#.....#.#
#..#...#..#
#.........#
###########
locked : 1

1
4
###########
#.........#
#.........#
#.........#
#.........#
d..........
#.........#
#.........#
#.........#
#.........#
###########

0
2
###########
#......##.#
#......#..#
#.....#.#.#
#....#....#
...#.......
#....#.#..#
#...#.....#
#..##..#..#
#..#......#
#####.#####

1
6
###########
#........k#
#.........#
#.........#
#.........#
.....#....#
#.........#
#.........#
##.....#..#
#.........#
###########
key : 4

3
5
#####.#####
#......#..#
#..#...#..#
#..#..#...#
#....#.#..#
#...##.#..#
#.........#
#.........#
#.........#
#X........#
###########

0
3
###########
#.........#
#...#.....#
#.........#
#.........#
..........#
#.....##..#
#....###..#
#.........#
#.........#
#####l#####
locked : 2

1
2
#####.#####
#k........#
#..#......#
#.#.......#
#.........#
...........
#.........#
#.#.....#.#
#..#...#..#
#.........#
#####l#####
key : 1

2
2
#####l#####
#.........#
#..#......#
#.#.......#
#.........#
...........
#.........#
#.........#
#.........#
#.........#
#####d#####
locked : 0

1
3
#####l#####
#.........#
#.#.#.....#
#.##...#..#
#.##...##.#
.....##...d
#..#......#
#.........#
#.........#
#.........#
#####.#####

3
0
#####.#####
#.........#
#......#..#
#.......#.#
#.........#
#.........#
#.........#
#.#.....#.#
#..#...#..#
#k........#
###########
key : 2

2
5
#####d#####
#.#.......#
#.###.#...#
#.....#...#
#.#.......#
#....e....#
#.........#
#.........#
#...#.....#
#.........#
#####.#####
boss
enemies 1

2
3
#####.#####
#.........#
#.....#..##
#.........#
#.........#
...#..#...#
#.........#
#.........#
#..#.....##
#.........#
###########

0
1
###########
#.........#
#.........#
#.....#..##
#.........#
#..........
#...#..#..#
#.........#
#.........#
#........##
#####.#####

1
1
#####.#####
#.........#
#.........#
#.........#
#.##..###.#
....#.k#...
#.##..#...#
#..#......#
#..#..#...#
#.........#
#####.#####
key : 0

2
0
#####.#####
#.........#
#.#.#...#.#
#.........#
#..#...#..#
#.........l
#.#.#.#.#.#
#.........#
#..#...#.##
#.........#
#####.#####

