2
3
#####d#####
#.........#
##.....#..#
#.........#
#.........#
D.........D
#.........#
#.........#
#.........#
#.........#
#####d#####

2
2
#####D#####
#.........#
#...#.....#
#.........#
#.........#
D.........D
#.........#
#.........#
#.........#
#.....k#..#
###########
key : 3

3
1
#####D#####
#.......#.#
#.........#
#.....###.#
#.#.#..#..#
#.....#...#
#.#.#.....#
#.........#
#.........#
#e........#
###########
enemies 1

0
2
###########
#.........#
#.........#
#.........#
#.........#
D.........D
#.........#
#..#....#.#
#.....##..#
##........#
#####D#####

3
3
#####d#####
#.........#
#..#......#
#.#.......#
#.........#
#.........d
#.........#
#.#.....#.#
#..#...#..#
#.........#
###########

0
1
###########
#.........#
#.........#
#.........#
#.........#
D.........D
#.........#
#.........#
#.........#
#.........#
#####D#####

2
4
#####D#####
#e.......?#
#.........#
#.........#
#.........#
D........e#
#.........#
#.........#
#.........#
#e........#
#####D#####
enemies 3
sign The dungeon remembers all who enter.

1
3
#####d#####
#.........#
#..#..#...#
#..###.#..#
#.####.#..#
D..###....D
#.........#
#.........#
#.........#
#.........#
#####d#####

0
0
###########
#.........#
#..#......#
#.#.......#
#.........#
#.........D
#.........#
#.........#
#.........#
#.........#
#####l#####
locked : 1

1
4
#####D#####
#.........#
#.........#
#.........#
#.........#
D....#...?#
#.........#
#.........#
##..#..#..#
#e........#
#####D#####
enemies 1
sign Beware what lurks ahead.

3
4
#####D#####
#.........#
#.........#
#.........#
#...e.....#
d...##....#
#..#.##...#
##....###.#
#..#..##..#
#.##......#
#####D#####
boss
enemies 1

1
1
#####D#####
##........#
#k..#.....#
###..##...#
#....#....#
D..##.....D
#.........#
#.........#
#.........#
#.........#
#####D#####
key : 0

1
2
#####D#####
#k........#
#.........#
#.........#
#.........#
D.........D
#.........#
#.#.......#
#..#......#
#.........#
#####D#####
key : 2

2
1
#####D#####
#......#..#
#......#..#
#......#..#
#.........#
D..###....D
#...#.....#
##..#.....#
###.......#
#e........#
#####D#####
enemies 1

1
0
#####l#####
#.........#
#.........#
#.........#
#.........#
#?...@....D
#.........#
#.........#
#.........#
#.........#
#####D#####
sign This door will not yield without a key.

0
3
###########
#.........#
#......#..#
#.......#.#
#.........#
D.........D
#.........#
#.......#.#
#......#..#
#.........#
#####d#####

0
4
###########
#.........#
#p........#
#.........#
#.........#
D..##p....#
#.........#
#.........#
#.........#
#.........#
#####D#####

2
0
#####D#####
#.........#
#.........#
#...#..#..#
#.........#
#.........D
#......#..#
#.........#
#k........#
##.....#..#
###########
key : 1

4
4
#####D#####
#.........#
#.........#
#.........#
#....###..#
#.....##..#
#....####.#
#....###.##
#.....##..#
#X........#
###########

