4
1
#####d#####
#.#.....###
#.......#.#
#.....#.#.#
#.......#.#
l......#..#
#.........#
#.........#
#......#..#
#.........#
#####.#####
locked : 1

4
0
#####.#####
#.........#
#.........#
#.......#.#
#...##.#..#
#..####...l
#..######.#
#..##..##.#
#..##.#...#
#.##......#
#####d#####

0
1
###########
#.........#
#.........#
#.....#..##
#.........#
#..........
#.........#
#.........#
#.........#
#..#.....##
#####.#####

5
0
#####d#####
#.........#
#..#......#
#.#.......#
#..#..#...#
#.........l
#.........#
#.#.....#.#
#..#...#..#
#.........#
###########

0
2
###########
#.#?.....e#
#..##.#...#
#.#.......#
#..##.#...#
...###....#
#.........#
#.........#
#.........#
#.........#
#####.#####
enemies 1
sign Beware what lurks ahead.

5
2
###########
#........k#
#.........#
#.........#
#.........#
..........#
#.........#
#.......#.#
#......#..#
#.........#
###########
key : 4

6
1
#####.#####
#e#.....#?#
#.........#
#.#.#.#.#.#
#.........#
#...#.#...#
#.........#
#.#.#.#.#.#
#.........#
#e#.....#.#
#####.#####
enemies 2
sign Turn back; you are not yet ready.

2
2
#####d#####
#.........#
#.........#
#..#..#..##
#.........#
..........d
#...#.....#
#.........#
#.........#
#........##
#####.#####

7
1
#####.#####
#.........#
#.........#
#.........#
#.........#
#....#....#
#.........#
#......#..#
#.........#
#X........#
###########

3
0
#####.#####
#.........#
#.........#
#.........#
#.........#
#k.........
#.........#
#........##
#.........#
#.........#
#####.#####
key : 1

3
1
#####.#####
#.........#
#.........#
#.........#
#.........#
...........
#.........#
#.......#.#
#......#..#
#.........#
#####d#####

1
1
#####.#####
#.........#
#.........#
#.........#
#.........#
#...#......
#..##.....#
#.#.......#
#.##......#
#.........#
#####l#####
locked : 0

2
0
###########
#?........#
#.........#
#....##...#
#....##...#
#....@##...
#.........#
#.........#
#.........#
#.........#
#####.#####
sign Someone has been here recently.

1
2
#####.#####
##.#...#.##
#.........#
##.#.#.#..#
#.........#
...#.#.#...
#.........#
#..#.#...##
#.........#
##.#.....##
#####d#####

5
1
#####.#####
#.........#
#.........#
#.........#
#.........#
l....e.....
#......#..#
#.....#.#.#
#.....#...#
#.........#
#####.#####
locked : 2
boss
enemies 1

2
3
#####.#####
#.........#
#......#..#
#.......#.#
#.........#
d.........#
#.........#
#.#.......#
#..#......#
#.........#
###########

2
1
#####l#####
#k........#
#.........#
#...#.....#
#.........#
...........
#.#..#..#.#
#.........#
#.........#
##.....#..#
#####.#####
key : 0

1
3
###########
##.#...#.##
#.........#
#.#.#.#...#
#.........#
...#.#.#..#
#.........#
#.#.#.#.#.#
#.........#
##.#.....##
#####.#####

3
2
#####.#####
#.........#
#.........#
#.........#
#.........#
....#.....#
#.........#
#.##......#
###.......#
####.....k#
###########
key : 2

