1
2
#####D#####
#.........#
#.........#
#.........#
#.........#
d....e....#
#..##.....#
#.#.#.....#
##..#.....#
##........#
#####D#####
boss
enemies 1

3
3
###########
#.#.....#k#
#.........#
#..#.....##
#.........#
D...#.#...#
#.........#
#..#.#.#.##
#.........#
#.#.......#
#####D#####
key : 3

3
0
#####D#####
#.........#
#.........#
#.........#
#.........#
#.........D
#.........#
#.........#
#.........#
#.........#
#####D#####

2
1
#####d#####
#.........#
#..#...#..#
#.#.....#.#
#.........#
D.........D
#.........#
#.........#
#.........#
#.........#
#####d#####

2
2
#####D#####
#.........#
##..#..#..#
#.........#
#.........#
D......#..#
#.........#
#.........#
##..#..#..#
#.........#
#####l#####
locked : 2

2
0
###########
#k........#
#.........#
#.........#
#.........#
#.........D
#.........#
#.........#
#.........#
#.........#
#####D#####
key : 0

4
3
#####D#####
#.........#
#.........#
#..#.....##
#.........#
l.........#
#..#......#
#.........#
#.........#
#..#.....##
###########
locked : 1

4
1
#####D#####
#.........#
#.........#
#.##......#
#.#.#.....#
D...##....D
#.#.#.....#
######....#
#.###.....#
#.........#
#####d#####

3
1
#####d#####
#.........#
#.........#
#.........#
#.........#
D.........D
#.........#
#.........#
#...p.....#
#.........#
#####D#####

5
2
#####D#####
#.........#
#..#......#
#.#.......#
#.........#
D.........#
#.........#
#.#.....#.#
#..#...#..#
#........k#
###########
key : 2

5
1
#####d#####
#.........#
##.....#..#
#.........#
#.........#
D......#..D
#.........#
#.........#
##..#..#..#
#.........#
###########

6
0
#####D#####
#........##
#......#..#
#.......#.#
#.........#
#......#..#
#.........#
#.#.....#.#
#..#...#..#
#k........#
###########
key : 1

5
0
#####D#####
#.........#
#.....p...#
#.........#
#.........#
#.........D
#e##......#
###e#.....#
#...#.....#
#.........#
#####D#####
enemies 2

0
1
###########
#.e#......#
#.##......#
#.##......#
#...#.....#
#.........D
#.........#
#.........#
#.........#
#.........#
#####D#####
enemies 1

4
2
#####l#####
#........##
#.........#
#.........#
#..#......#
D.........l
#.........#
#........##
#.........#
#.........#
#####D#####

3
2
#####l#####
#.........#
#.........#
#.........#
#.........#
D.........D
#.........#
#.#.......#
#..#......#
#.........#
#####l#####
locked : 0

4
0
#####D#####
#......p..#
#.........#
#.........#
#.........#
#?...@....D
#.........#
#.........#
#.........#
#.........#
#####D#####
sign The dungeon remembers all who enter.

0
2
###########
#........X#
#.........#
#....##...#
#......#..#
D.....#...#
#......##.#
#.........#
#.........#
#.........#
#####D#####

1
1
#####D#####
#.........#
##.....#..#
#.........#
#.........#
#....#....d
#.........#
#.........#
#...#..#..#
#.........#
#####d#####

