3
6
#####.#####
#.........#
#.........#
#.........#
#.........#
..........#
#.........#
#.........#
#.........#
#........X#
###########

1
4
###########
#.........#
#.......#.#
#...##....#
#...###...#
d...###...#
#.........#
#.........#
#.........#
#.........#
#####.#####

3
5
#####.#####
#?........#
#.........#
#.........#
#.........#
...........
#.........#
#.........#
#.........#
#....e....#
###########
enemies 1
sign Turn back; you are not yet ready.

2
5
###########
#.........#
#..##.....#
#....#....#
#.#.......#
d..#......l
#.##......#
#.........#
#.........#
#.........#
#####.#####

2
3
#####.#####
#.........#
#.#.....#.#
#.........#
#.#.#.#...#
..........d
#.#.#.#.#.#
#.........#
#.#.....#.#
#.k.......#
###########
key : 2

1
1
###########
#k........#
##.....#..#
#.........#
#.........#
.....#.....
#.........#
#.........#
##........#
#.........#
#####.#####
key : 1

3
2
#####l#####
#.........#
#.....#...#
#......#..#
#.........#
#.........#
#.........#
#.........#
#.........#
#.........#
###########
locked : 1

2
0
#####.#####
#.........#
#.........#
#.........#
#.........#
#..........
#.........#
#.........#
#.........#
#.........#
#####.#####

3
0
#####.#####
#.........#
#..#......#
#.#.......#
#.........#
#.........#
#.........#
#.#.......#
#..#......#
#k........#
###########
key : 0

2
6
###########
#......#..#
#...#..#..#
#...#.#.#.#
#..##.....#
l...e###..#
#..#..##..#
#...##.#..#
#..#...#..#
#.........#
#####.#####
locked : 0
boss
enemies 1

2
1
#####.#####
#.#.....#.#
#.........#
#.#.#.#.#.#
#.........#
....#.#....
#.........#
#.#...#...#
#.........#
#.#.....#.#
###########

0
3
###########
#e#.....#?#
#.........#
#..#.#.#.##
#.........#
#...#.#...#
#.........#
#..#.#...##
#.........#
#.#.......#
#####.#####
enemies 1
sign What you seek is close.

3
4
#####l#####
#.........#
#......#..#
#.......#.#
#.........#
#..........
#.........#
#.......#.#
#......#..#
#.........#
###########
locked : 2

2
4
#####.#####
#.........#
#......##.#
#.......###
#.........#
d.........d
#......#..#
#.........#
#.........#
#.........#
#####l#####

2
2
#####d#####
#........##
#.........#
#........##
#.........#
...........
#.........#
#.##......#
#..#......#
#.........#
#####l#####

1
3
#####.#####
####......#
##k#......#
##..##....#
#.#.##....#
....#.....d
#.........#
#.........#
#.........#
#.........#
#####.#####
key : 4

0
0
###########
##.#......#
#..#......#
#.#.......#
#.........#
#.........#
#.........#
#.........#
#.........#
#.........#
#####.#####

1
2
###########
#.........#
#..#...#..#
#.#.....#.#
#.........#
...........
#.........#
#.#.......#
#..#......#
#.........#
#####d#####

1
0
#####.#####
#.........#
#.........#
#.........#
#...@.....#
#..#####...
#..###?#..#
#..#.#.#..#
#.........#
#......#..#
#####.#####
sign The brave are rewarded.

