2
2
#####d#####
#e........#
#.....#...#
#....##...#
#....#e#..#
..........l
#.........#
#.........#
#.........#
#.........#
#####.#####
enemies 2

5
2
#####.#####
#.........#
#.........#
##..#.....#
#.........#
..........#
#.#.....#s#
#.........#
#.........#
#.....e#ee#
###########
enemies 3
switch 0 : 0

3
4
#####.#####
#.........#
#.........#
#.........#
#.........#
#.........#
#.........#
#.........#
#.........#
#X........#
###########

3
2
#####.#####
#.........#
#..#......#
#.#.......#
#.....#...#
.........k#
#......#..#
#.#.......#
#..#......#
#.........#
#####d#####
key : 1

6
0
#####d#####
#.........#
#.#.......#
#.###.....#
#..###.#..#
#....##...#
#......##.#
#....#....#
#......##.#
#.........#
###########

1
2
#####.#####
#.........#
#.........#
#.........#
#.........#
...###.#...
#..#.###..#
#....##...#
#...#.#...#
#......#..#
#####d#####

3
1
#####.#####
#..#.....##
#.........#
#.........#
#..#......#
d..........
#.........#
#..#..#..##
#.........#
#.........#
#####.#####

4
2
#####d#####
#.........#
#.........#
#.........#
#.........#
......#...#
#.........#
#.....#...#
#.........#
#.........#
#####.#####

2
4
###########
#..#......#
#..##.....#
#.........#
#.........#
l....e....#
#.........#
#.........#
#.........#
#.........#
#####.#####
locked : 1
boss
enemies 1

2
3
#####.#####
#.........#
#.........#
###.......#
#.#.......#
l..##.....l
#.#.#.....#
##........#
#.........#
#.........#
###########
locked : 2

4
0
#####.#####
#.........#
#.........#
#.........#
#.........#
#....@.....
#.........#
#.........#
#.........#
#.........#
#####.#####

2
1
#####.#####
#.........#
#..#......#
#.#.......#
#...#.....#
#......#...
#.........#
#.......#.#
#......#..#
#.........#
#####.#####

5
1
#####.#####
#.......#.#
#.....#...#
#....##k###
#....###..#
...........
#.........#
#.........#
#.........#
#.........#
###########
key : 0

1
1
###########
#k........#
#..#......#
#.#.......#
#.........#
#..........
#.........#
#.........#
#.........#
#.........#
#####.#####
key : 2

5
0
#####.#####
#.........#
#.........#
##..#.....#
#.........#
#..........
#...#..#..#
#.........#
#.........#
##........#
#####d#####

3
0
###########
#.........#
#..#.....##
#.........#
#.........#
#..#......d
#.........#
#.........#
#.....#..##
#.........#
#####.#####

4
1
#####.#####
#.........#
#.........#
#.#..#..#.#
#.........#
...........
#.#..#....#
#.........#
#.........#
#.#.....#.#
#####.#####

0
2
###########
#e.......?#
#...#.....#
#.........#
#.........#
#....#....#
#.........#
#.........#
##..#..#..#
#.........#
#####.#####
enemies 1
door 0 : 0
sign Many have walked this path.

1
3
###########
##.#....k##
#.........#
#.#.#.....#
#.........#
.....#.#..#
#.........#
#...#.#...#
#.........#
#..#.....##
#####.#####
key : 3

