0
2
###########
#.........#
#.........#
#.........#
#.........#
#.........D
#.........#
#.........#
#.........#
#.........#
#####l#####
locked : 0

2
0
###########
#.........#
#...#.....#
#...##....#
#....##...#
#....@....D
#.........#
#.........#
#.........#
#.........#
###########

4
2
#####d#####
#.........#
#.........#
#.........#
#.........#
#.........D
#.........#
#.#.....#.#
#..#...#..#
#.........#
#####D#####

3
3
#####D#####
#.........#
#..#......#
#.#.......#
#.........#
D.........#
#.........#
#.#.......#
#..#......#
#.........#
#####D#####

5
3
#####D#####
#k........#
#.........#
#.........#
#.........#
D.........d
#.........#
#.......#.#
#......#..#
#.........#
#####l#####
key : 5

5
4
#####D#####
#.........#
#.........#
#.........#
#.........#
d....e....#
#.........#
#.........#
#.........#
#.........#
#####D#####
boss
enemies 1

2
3
#####D#####
#.k#......#
#.##......#
#.###.....#
#.........#
D.........#
#.........#
#.........#
#.........#
#.........#
#####D#####
key : 3

6
4
#####D#####
#.......#.#
#.....#...#
#.....###.#
#.........#
D.........#
#..#.#....#
#..####...#
#..#......#
#........X#
###########

1
4
###########
#.........#
#.........#
#.........#
#.........#
l.........#
#......p..#
#.........#
#.........#
#.........#
###########
locked : 3

3
2
#####D#####
#.........#
#.........#
#.........#
#.........#
#.........D
#.........#
#.........#
#.........#
#.........#
#####d#####

2
2
#####D#####
#.........#
#.........#
#........p#
#......p..#
D.........D
#.........#
#.........#
#.........#
#.........#
#####D#####

1
3
#####d#####
#.........#
#..#...#..#
#.........#
#.#.#...#.#
D.........l
#..#.#.#..#
#.........#
#.#.#.#...#
#.........#
#####D#####

5
2
#####D#####
#.........#
#.........#
#.........#
#.........#
#.........D
#.........#
#?........#
#e........#
#ee.......#
###########
enemies 3
sign Those who search shall find.

6
3
#####l#####
#.##......#
#..#......#
#.####....#
#.#.##....#
#.........D
#.........#
#.........#
#.........#
#.........#
###########
locked : 5

2
1
###########
#....ee#..#
#.........#
#.........#
#...#..#..#
D.........D
#.........#
##..#..#..#
#.........#
#....?....#
###########
enemies 2
sign The dungeon remembers all who enter.

1
2
#####l#####
#k#.....#.#
#.........#
#.#.#.#.#.#
#.........#
#...#.#...D
#.........#
#.#.#...#.#
#.........#
#.......#.#
#####D#####
key : 0

4
4
###########
#.........#
#..#......#
#.#.......#
#.........#
d.........#
#.........#
#.........#
#.........#
#.........#
#####D#####

0
3
###########
#.........#
#......#..#
#.........#
#.........#
D....#....#
#.........#
#.........#
##..#..#..#
#.........#
#####d#####

4
3
#####D#####
#k........#
#..#......#
#.##.#....#
#..#......#
D.........d
#.........#
#.........#
#.........#
#.........#
#####D#####
key : 4

