0
3
###########
#X........#
#.........#
#.........#
#.........#
#.........#
#.........#
#.........#
#.........#
#.........#
#####D#####

5
0
#####D#####
#......##.#
#.....##..#
#....###.##
#....#.#..#
#....#....D
#.........#
#.........#
#.........#
#.........#
###########

2
0
#####D#####
#.#.....#.#
#.........#
#.........#
#..#..#...#
#.........#
#.........#
#.#..#....#
#.........#
#.........#
#####d#####

0
0
###########
#.........#
#...#.....#
#.........#
#.#.#.#.#.#
#.........#
#.#.#.#.#.#
#.........#
#.#.#...#.#
#.........#
#####D#####

2
3
#####d#####
#.........#
#.........#
#.#..#..#.#
#.........#
d.........#
#..#..#...#
#.........#
#.........#
#.#.....#.#
#####D#####

4
0
#####D#####
#.........#
#.........#
#...###...#
#....#.#..#
#...#@....D
#.#...##..#
#.##..#...#
#.#...#...#
#.#.......#
#####D#####

1
0
#####D#####
#.........#
#.#.#.#.#.#
#.........#
#e#.#.#...#
#.........#
#.#.#.#.#.#
#.........#
#.#.#.#.#.#
#.........#
#####D#####
enemies 1

4
2
#####l#####
#.........#
#......#..#
#.......#.#
#.........#
D.........#
#.........#
#.......#.#
#......#..#
#.........#
#####D#####
locked : 4

4
1
#####D#####
#.........#
#......#..#
#.......#.#
#.........#
D.........D
#.........#
#.........#
#.........#
#.........#
#####D#####

3
2
#####D#####
#e.......e#
#.........#
#.........#
#.........#
D.........D
#.........#
#.........#
#.........#
#p.......e#
#####l#####
enemies 3

5
2
#####D#####
#.........#
#.........#
#.........#
#.........#
d.........#
#.........#
#.........#
#.........#
#.........#
###########

1
3
#####D#####
#.........#
#.........#
#.........#
#.........#
D....e....D
#.........#
#.........#
#.........#
#.........#
#####d#####
boss
enemies 1

3
1
###########
#....k....#
#.........#
#.........#
#.........#
D.........D
#.........#
#.........#
#.........#
#.........#
#####D#####
key : 0

1
4
###########
#........k#
#.........#
#.........#
#.........#
D.........#
#.........#
#..#......#
#.........#
#.........#
###########
key : 8

5
1
#####D#####
#.........#
#.........#
#.........#
#.........#
D.........d
#.........#
#.........#
#.........#
#....k....#
###########
key : 9

3
0
#####d#####
#.........#
#...#.....#
#......#..#
#..##..#..#
#..##.#...D
#...#.....#
#.........#
#...#.....#
#.........#
#####D#####

1
2
###########
#.........#
#.........#
#.........#
#.........#
#.........D
#.........#
#.p.......#
#.........#
#.........#
#####D#####

2
2
#####D#####
#.........#
#.........#
#.........#
#.........#
#k........d
#.........#
#.........#
#.........#
#.........#
#####D#####
key : 4

3
3
#####D#####
#?p....#..#
#.###.....#
#..#..#...#
#..##.##..#
D.........#
#.........#
#.........#
#........e#
#p......ee#
###########
enemies 3
sign Many have walked this path.

