4
2
###########
#..#...#k##
#.........#
#.#.#.#.#.#
#.........#
D..#.#.#..#
#.........#
#.#.#.#...#
#.........#
#........##
#####D#####
key : 3

1
1
###########
##e..ee#?.#
#.........#
#.........#
#...#.....#
D.........D
#.........#
##..#..#..#
#.........#
#.........#
#####D#####
enemies 3
sign Many have walked this path.

5
1
#####d#####
#.........#
#.........#
#.........#
#.........#
#.........l
#...#.....#
#.##......#
#.#.#.....#
#.........#
#####D#####

5
2
#####D#####
#.........#
#......#..#
#.......#.#
#.........#
l.........D
#.........#
#.#.....#.#
#..#...#..#
#.........#
#####d#####
locked : 3

6
1
#####D#####
#.........#
#.........#
#...#..#..#
#.........#
#.........D
#...#..#..#
#.........#
#.........#
#......#..#
###########

6
2
#####d#####
#.........#
#.........#
#.........#
#.........#
D...##.#..#
#....###..#
#...#####.#
#.......#.#
#......#..#
#####d#####

8
2
#####D#####
#.........#
#.........#
#.........#
#.###.....#
#...#.....#
#.........#
#.###.....#
#..##.....#
#X........#
###########

2
2
#####d#####
#.........#
#.....#...#
#.........#
#.........#
D.........#
#.........#
#.........#
#.........#
#.........#
###########

1
0
#####D#####
#.........#
#.........#
#.........#
#.........#
#....@.#..D
#......##.#
#.....##..#
#.........#
#.........#
#####D#####

7
2
#####d#####
#.........#
#.........#
#.........#
#..#..#...#
#..##e....#
#..#..#...#
#....##...#
#...#.#...#
#.........#
#####D#####
boss
enemies 1

1
2
#####D#####
##........#
#.........#
#.........#
#.........#
D.........D
#.........#
#.......#.#
#.........#
#.........#
#####d#####

2
1
#####D#####
#e........#
#..##?##..#
#..####...#
#..###....#
D..##e.#..D
#...####..#
#.........#
#.........#
#e........#
#####D#####
enemies 3
sign A useful tool lies just ahead.

0
0
###########
#k........#
#......#..#
#.........#
#.........#
#...#..#..#
#.........#
#.........#
#...#..#..#
#.........#
#####D#####
key : 0

3
1
#####D#####
#.........#
#......#..#
#.......#k#
#.........#
#.........#
#.........#
#.........#
#.........#
#.........#
#####l#####
key : 1

2
0
#####D#####
#.........#
#.........#
#.........#
#.........#
#..#......D
#..#......#
#.##......#
#.........#
#.........#
###########

0
2
###########
#.........#
#.##......#
#...#.....#
#..##.....#
#.........#
#.........#
#.........#
#.........#
#.........#
#####D#####

5
3
###########
#........e#
###.......#
#.#.......#
#.#.......#
D...##....#
#.##.#....#
#.........#
#.........#
#........e#
###########
enemies 2

1
3
###########
#........k#
#.........#
#.#.#.....#
#.###.#...#
D....##...#
#.###.#...#
#..##.....#
#.##..#...#
#.........#
###########
key : 2

4
1
#####l#####
#.........#
#.###.....#
#.##......#
#.###.....#
#..##.....D
#..##.....#
#.........#
#.........#
#.........#
#####d#####
locked : 1

