4
2
#####.#####
#.#.....#.#
#.........#
#.#.#.#.#.#
#.........#
l...#.....d
#.........#
#.#...#.#.#
#.........#
#.......#.#
#####.#####
locked : 0

3
2
#####.#####
#.........#
#..#......#
#.#.......#
#.........#
d..........
#.........#
#.........#
#.........#
#.........#
#####.#####

2
0
#####.#####
#.##......#
#...#.....#
#.###.###.#
#...#.##..#
#..##@.....
#.........#
#.........#
#.........#
#.........#
#####.#####

3
0
#####.#####
#.........#
#.........#
#.........#
#.........#
#..........
#.........#
#.........#
#.........#
#k........#
###########
key : 0

5
1
#####l#####
#.........#
#......#..#
#.......#.#
#.........#
#..........
#.........#
#.#.......#
#..#......#
#.........#
###########
locked : 3

1
3
#####.#####
#.........#
#.........#
#.......#.#
#.........#
#.........#
#.........#
#.........#
#.........#
#.........#
#####.#####

2
2
###########
#.........#
#.....#...#
#.........#
#.........#
.......#..l
#.........#
#.#k#.....#
#..#......#
#.........#
#####.#####
key : 2

3
3
#####.#####
#?........#
#e##......#
##........#
#..##.....#
.........e#
#.........#
#.........#
#.........#
#.........#
#####.#####
enemies 2
sign Seek the matching key before you proceed.

1
0
###########
#e.#......#
#..#......#
#.####....#
#.###.....#
#..#.#....#
#.........#
#.........#
##........#
#.........#
#####.#####
enemies 1

5
2
#####.#####
#.........#
#.#...#.#.#
#.........#
#.#.#...#.#
..........d
#.#.#.#.#.#
#.........#
#.#.#...#.#
#.........#
###########

2
3
#####.#####
#.........#
#.........#
#.........#
#.........#
l.........d
#.........#
#.........#
#.........#
#.........#
#####.#####
locked : 1

2
1
###########
#.........#
#.......#.#
#.........#
#.........#
...........
#.........#
#.#.....#.#
#..#...#..#
#.........#
#####.#####

4
3
#####.#####
#.........#
#.........#
#.........#
#.........#
d.........#
#.........#
#.#.....#.#
#..#...#..#
#.........#
#####.#####

4
1
#####.#####
#.........#
#..#......#
#k#.......#
#.........#
#.........l
#.........#
#.......#.#
#......#..#
#.........#
#####l#####
key : 3

0
3
###########
#.........#
#.#.....#.#
#.........#
#.........#
#..#..#...#
#.........#
#.........#
#.........#
#.........#
#####.#####

5
3
#####.#####
#.........#
#.........#
#.........#
#...e.....#
d...##....#
#.........#
#..###....#
#.........#
#.........#
#####.#####
boss
enemies 1

6
3
#####.#####
#.........#
#.........#
#.........#
#.........#
#.........#
#.........#
#.........#
#.........#
#X........#
###########

3
1
#####.#####
#.........#
#.........#
#.........#
#.........#
..........d
#.........#
#.......#.#
#......#k.#
#.......#.#
#####.#####
key : 1

2
4
###########
#.........#
#.........#
#.........#
#.........#
d.....#...#
#.....###.#
#.........#
#.........#
#.#.......#
###########

