0
4
###########
##?...e#..#
#.........#
#.........#
#.#..#..#.#
D.........D
#.........#
##.....#..#
#.........#
#.........#
#####D#####
enemies 1
door 1 : 2 3
sign The brave are rewarded.

3
0
#####D#####
#.........#
#.........#
#.........#
#.........#
#.........D
#.........#
#.........#
#.........#
#.........#
###########

2
1
#####D#####
#..#...#.##
#.........#
#..#.#.#.##
#.........#
D....#.#..d
#.........#
#....#.#.##
#.........#
##k#...#.##
#####d#####
key : 0

1
1
###########
##.#.....##
#.........#
#.#.....#.#
#.........#
#..#.#.#..D
#.........#
#...#.#.#.#
#.........#
##.#...#.##
#####D#####

0
3
###########
#k........#
#.........#
#.........#
#.........#
#.........D
#.........#
#.........#
#.........#
#.........#
#####D#####
key : 3

0
5
###########
##.#..e#e##
#........e#
#..#.#.#.##
#.........#
D..#.#.#..#
#.........#
##.#...#.##
#.........#
##.#.....##
#####D#####
enemies 3

1
2
###########
#.........#
#.........#
#.p.#.#.#.#
#....###..#
D.....##..D
#...####..#
#....####.#
#........##
#.........#
#####d#####

2
0
###########
#.........#
#.........#
#.........#
#.........#
#....@....D
#.........#
#.........#
#.........#
#.........#
#####D#####

2
2
#####d#####
#.........#
#..#..#..##
#.........#
#.........#
d...#..#..l
#.........#
#.........#
#..#..#..##
#.........#
#####D#####

1
4
#####D#####
#s........#
#..#......#
#.#.......#
#.........#
D.........D
#.........#
#.#.....#.#
#..#...#..#
#?........#
#####D#####
switch 0 : 0 1
sign Turn back; you are not yet ready.

3
2
#####D#####
#.........#
#..#......#
#.#.......#
#.........#
D.........#
#......#..#
#.......#.#
#......#..#
#.........#
###########

2
5
#####D#####
#.........#
#.#.#...#.#
#.........#
#.#.#...#.#
D.........#
#.#.#.#.#.#
#.........#
#.#.#.#...#
#.....?..e#
###########
enemies 1
door 0 : 0 1
sign Only the prepared may pass.

2
3
#####D#####
#.........#
#..#..#...#
#.........#
#.........#
l...#..#..l
#.........#
#.........#
#..#..#..##
#.........#
###########
locked : 0

1
5
#####D#####
#.........#
#.........#
#.........#
#.........#
D.........#
#.........#
#.#.....#k#
#..#...#..#
#.........#
#####D#####
key : 4

3
4
#####D#####
#........##
#.........#
#.........#
#.....#...#
#.........#
#.........#
#.........#
#.........#
#X........#
###########

2
4
#####D#####
#.........#
#.........#
#.........#
#.........#
l..#.e....D
#..###....#
#.........#
#.........#
#.........#
#####D#####
locked : 2
boss
enemies 1

4
1
#####D#####
#.........#
#.###..#..#
#...#.##..#
#..###.#..#
#.........#
#.........#
#.........#
#.........#
#k........#
###########
key : 2

3
1
#####d#####
#.#.....#.#
#.........#
#.#.#...#.#
#.........#
D...#.....D
#.........#
#.#.#.....#
#.........#
#.......#.#
#####D#####

1
3
#####D#####
#e.......e#
#.........#
#..#......#
#.........#
D.........D
#.........#
#.........#
#.........#
#e.......s#
#####D#####
enemies 3
switch 1 : 2 3

