1
1
#####.#####
#.........#
#.........#
#.........#
#.........#
#.........l
#.........#
#.........#
#.........#
#.........#
#####d#####

2
4
###########
#.........#
#.........#
#.........#
#...e##...#
d..#.##...#
#.#...#...#
#.#.#.....#
#..#..#...#
#.........#
#####.#####
boss
enemies 1

0
1
###########
#ee?......#
#e........#
#s........#
#.........#
#..........
#.........#
#.........#
#.........#
#.........#
#####.#####
enemies 3
switch 0 : 0 1
sign The dungeon remembers all who enter.

3
2
#####.#####
#.........#
#..#......#
#.#.......#
#.........#
..........#
#.........#
#.......#k#
#......#..#
#.........#
#####.#####
key : 0

0
2
###########
#.....?####
#.....##e.#
#.....###.#
#....####.#
......##..#
#.........#
#....#....#
#.........#
#.........#
#####.#####
enemies 1
door 0 : 0 1
sign Seek the matching key before you proceed.

3
0
#####d#####
##.#......#
##.##.....#
#.........#
#..##.....#
#....@.....
#.........#
#.........#
#........##
#?........#
###########
sign The dungeon remembers all who enter.

1
2
#####.#####
#.........#
#..#...#..#
#.#.....#.#
#.........#
l..........
#.........#
#.........#
#.........#
#.........#
#####.#####
locked : 0

3
1
#####.#####
#.........#
#..#......#
#.#.......#
#.........#
...........
#.........#
#.......#.#
#......#..#
#.........#
#####.#####

2
0
###########
#.........#
#.........#
##..#..#..#
#.........#
#..........
#.#.....#.#
#.........#
#.........#
##.....#..#
#####d#####

6
2
#####.#####
#.........#
#........##
#.........#
#.........#
#.....#...#
#.........#
#.........#
#.........#
#k........#
###########
key : 3

5
2
#####.#####
#.........#
#.........#
######....#
#.....#...#
#...##k#..#
#.#..#....#
#.........#
#.........#
#.........#
#####.#####
key : 2

4
1
#####.#####
#.........#
##.#.....##
#.........#
#..#.#.#..#
#..........
#..#.#....#
#.........#
##.#.....##
#.........#
###########

4
2
#####.#####
#k........#
#.#.......#
#.........#
#.........#
...........
#.........#
#.#.......#
#..#......#
#......#..#
#####.#####
key : 1

1
3
###########
##.#..e#e##
#........e#
#....#...##
#.........#
.....#.#..#
#.........#
##.#.#.#..#
#.........#
#..#...#.##
#####.#####
enemies 3

2
1
#####d#####
#e.......e#
#.........#
#.........#
#.........#
...........
#.........#
#.........#
#.........#
#e........#
#####.#####
enemies 3

3
4
#####.#####
#.........#
#.........#
#.........#
#.........#
#..##.....#
#......#..#
#..##.....#
#.........#
#X........#
###########

2
2
#####.#####
#.........#
#..#......#
#.#.......#
#.........#
..........d
#.........#
#.#.......#
#..#......#
#.........#
#####.#####

4
3
###########
##.....#..#
#.........#
#.........#
#.#..#....#
..........#
#.........#
#...#..#..#
#.........#
#.........#
###########

2
3
#####.#####
#.........#
#.........#
#.........#
#...#.....#
d.........d
#.........#
#.........#
#.........#
#.........#
###########

