6
0
#####d#####
#.........#
#.........#
#.........#
#.........#
#?...@....D
#.........#
#.........#
#.........#
#.........#
#####D#####
sign Many have walked this path.

6
2
#####D#####
##.....#..#
#.........#
#.........#
#......#..#
D.........#
#.........#
##.....#..#
#.........#
#.........#
###########

8
0
#####d#####
#.........#
#..#......#
#.#.......#
#.........#
#.........#
#.........#
#.........#
#.........#
#.........#
###########

5
0
###########
#.........#
#..#......#
#.#.......#
#.........#
#.........D
#.........#
#.........#
#.........#
#.........#
#####d#####

1
2
###########
#.........#
#.........#
#...p.....#
#.........#
#.........d
#.........#
#........p#
#.........#
#.........#
#####l#####
locked : 3

2
3
#####D#####
#.........#
#.........#
#.#..#..#.#
#.........#
D.........#
#....#..#e#
#.........#
#.........#
#e#.....#e#
#####D#####
enemies 3

1
3
#####D#####
#.........#
#...#.....#
#...#.....#
#...#.....#
d....e....#
#.....#.#.#
#......#..#
#.........#
#.........#
#####D#####
boss
enemies 1

2
2
#####l#####
#.........#
#.........#
#.........#
#..p......#
#k........D
#.........#
#.........#
#.........#
#.........#
#####D#####
key : 4

5
2
#####D#####
#e.#......#
##.##.....#
##..p.....#
#...#.....#
D..#?#....#
#.........#
#.........#
#.........#
#.........#
#####D#####
enemies 1
sign Many have walked this path.

5
1
#####D#####
#........##
##.#......#
#.#.......#
#.........#
D.........D
#.........#
#.......#.#
#......#..#
#.......#.#
#####D#####

7
0
#####D#####
#.........#
#.........#
#..#..#..##
#.........#
#.........#
#...#..#..#
#.........#
#.........#
#..#.....##
#####d#####

4
3
#####D#####
#.........#
#.......#.#
#.........#
#.........#
D..#..#...#
#.........#
#.........#
#.#.....#.#
#........k#
###########
key : 3

6
1
#####D#####
##.....#.##
#.........#
##.#...#.##
#.........#
D..#.#.#..D
#.........#
#..#.#.#.##
#.........#
##.#......#
###########

4
2
#####D#####
#.........#
#.#.#...#.#
#.........#
#.#.#...#.#
d.........D
#.#...#.#.#
#.........#
#.#.......#
#.........#
#####D#####

3
3
#####D#####
#e#.....#.#
#.........#
#.#.#.#.#.#
#.........#
D...#.#...#
#.........#
#.#.#.#.#.#
#.........#
#.#.......#
#####D#####
enemies 1

0
3
###########
#X.....#..#
#..#...#..#
#..#...#..#
#..###.#..#
#.........#
#.........#
#.........#
#.........#
#..p......#
#####D#####

3
2
#####D#####
#k........#
###.......#
#.........#
#..#......#
D.........D
#.........#
#.........#
#.........#
#.........#
#####D#####
key : 2

4
1
#####D#####
#.#.....#.#
#.........#
#.........#
#.#..#..#.#
#.........d
#.........#
#.#..#....#
#.........#
#.........#
#####D#####

3
1
###########
#k........#
##..#.....#
#.........#
#.........#
#...#.....D
#.........#
#.........#
##.....#..#
#.........#
#####D#####
key : 0

