3
2
#####.#####
###.......#
####..#...#
#####.#...#
#.#.......#
d..####....
#.........#
#.........#
#.........#
#.........#
#####.#####

0
1
###########
#.........#
##.....#..#
#.........#
#.........#
.....#....#
#.........#
#.........#
#......#..#
#.........#
#####d#####

2
1
#####d#####
#.........#
#.........#
#.........#
#.........#
.....e.....
#.........#
#.........#
#.........#
#.........#
#####.#####
boss
enemies 1

4
2
#####.#####
#.........#
#.........#
#.#..#..#.#
#.........#
...........
#.#..#..#.#
#.........#
#.........#
#k#.......#
#####l#####
key : 4

3
1
#####.#####
#.........#
##.#.....##
#.........#
#..#.#.#..#
..........d
#..#.#....#
#.........#
##.....#.##
#.........#
#####.#####

1
0
#####l#####
#.........#
#..#...#..#
#.#.....#.#
#.........#
#.........l
#.........#
#.........#
#.........#
#.........#
#####d#####

4
3
#####.#####
#......##.#
#...#.##..#
#....####.#
#..####.#.#
....#.....#
#.....#...#
#.........#
#.........#
#.........#
###########

5
2
#####l#####
#.........#
#.........#
#.........#
#.........#
#.........#
#.........#
#.........#
#.........#
#.........#
###########
locked : 7

3
0
#####.#####
#.........#
#..#......#
#.........#
#.........#
#...#......
#.........#
#.........#
#.....#..##
#.........#
#####l#####
locked : 0

4
0
#####l#####
#.........#
#.........#
#........##
#.........#
#....@.....
#...#.....#
#.........#
#.........#
#.........#
#####.#####

1
2
###########
#........X#
#.........#
#.........#
#.........#
..........#
#.........#
#.........#
#.........#
#.........#
#####.#####

2
2
#####.#####
#.........#
#......####
#......#..#
#......##.#
.....##....
#.....##..#
#.........#
#.........#
#.........#
#####.#####

0
0
###########
#.........#
#..#......#
#.#.......#
#.........#
#..........
#.........#
#.......#.#
#......#..#
#.........#
#####l#####
locked : 4

2
3
###########
#..#.....k#
#..#..#...#
#.###.#...#
#.#..##...#
.....#....#
#...##....#
#.........#
#.........#
#.........#
#####.#####
key : 7

5
0
#####.#####
#.........#
#.........#
#.........#
#.........#
#.........#
#.........#
#.#.....#.#
#..#...#..#
#k........#
###########
key : 0

4
1
#####.#####
#.........#
##.#...#.##
#.........#
#.#.......#
...........
#..#.#.#..#
#.........#
#.#...#.#.#
#.........#
###########

1
1
#####d#####
#.#.....#.#
#.........#
#..#.....##
#.........#
l...#.#....
#.........#
#....#...##
#.........#
#.......#.#
#####d#####
locked : 3

3
3
#####.#####
#.........#
#.........#
#.........#
#.........#
.........k#
#.........#
#.........#
#.........#
#.........#
#####.#####
key : 3

2
0
#####d#####
#.........#
#.........#
#.........#
#...###...#
#....##....
#.....###.#
#...###e..#
#.....##..#
#.........#
#####.#####
enemies 1

