4
1
#####d#####
#.##......#
#..#..#...#
#.#..##...#
#.#.#.#...#
#..##.#....
#.........#
#.........#
#.........#
#.........#
#####.#####

3
1
#####.#####
#.........#
#......#..#
#.......#.#
#....#....#
#..........
#.........#
#.........#
#.........#
#.#.......#
#####d#####

2
1
#####d#####
#.........#
#.........#
#.........#
#.........#
#k.........
#.........#
#.........#
#.........#
#.........#
#####.#####
key : 2

5
2
#####.#####
##.....#.##
#.........#
#.....#.#.#
#.........#
...#.#.#...
#.........#
#...#.#.#.#
#.........#
##.#.....##
###########

2
2
#####d#####
#.........#
#.......#.#
#.....##k.#
#.....###.#
..........#
#......#..#
#.....##..#
#.......#.#
#.........#
#####.#####
key : 3

3
2
#####.#####
#k........#
#..#......#
#.#.......#
#.........#
...........
#.........#
#.##......#
#.........#
#.........#
#####.#####
key : 1

4
4
#####l#####
##.#.....##
#.........#
#..#.#.#.##
#.........#
l..#...#...
#.........#
#..#...#.##
#.........#
##.#...#.##
###########
locked : 1

3
3
###########
#.........#
#..#......#
#.#.......#
#.........#
...........
#.....#...#
#.#.....#.#
#..#...#..#
#.........#
#####.#####

5
3
#####l#####
#......##.#
#.......#.#
#.......#.#
#.........#
...#......#
#..#......#
#.........#
###.......#
#.........#
###########
locked : 2

3
4
###########
#.........#
#..#...#..#
#.#.....#.#
#.........#
..........#
#.........#
#.#.......#
#..#......#
#.........#
#####l#####
locked : 3

1
2
#####.#####
#.........#
#.........#
#..####...#
#..#e#....#
.....##...#
#.#.......#
#..####...#
#.........#
#.........#
#####d#####
boss
enemies 1

0
2
###########
#X........#
#.........#
#...##..#.#
#...#.###.#
#.....##..#
#...###...#
#...#..##.#
#.........#
#.........#
#####.#####

6
1
#####.#####
#.........#
#.........#
#.........#
#.........#
#.........#
#.........#
#.........#
#.........#
#e.......e#
###########
enemies 2

4
5
###########
##.....#..#
#.........#
##.#.#.#.##
#.........#
.....#....#
#.........#
##.#...#.##
#.........#
##.#...#.##
###########

4
3
#####.#####
#.........#
##.....#..#
#.........#
#.........#
d...#.....l
#.........#
#.........#
##..#..#..#
#.........#
#####l#####

5
1
#####.#####
#.........#
#.........#
#...#..#..#
#.........#
...........
#.#..#..#.#
#.........#
#.........#
##.....#..#
#####.#####

5
0
###########
#.........#
#.........#
#.#.#.....#
#..#@.....#
#....#.....
#.###.....#
#.#..#....#
#.........#
#.........#
###########

1
1
###########
#.........#
#.........#
#...#.....#
#.........#
#...#......
#.##......#
#.###.....#
#..##.#...#
####......#
#####d#####

4
2
#####.#####
#k........#
#......#..#
#...#...#.#
#.........#
..........d
#.........#
#.........#
#.....#...#
#.........#
#####.#####
key : 0

