3
1
#####D#####
#.........#
#..#......#
#.#.......#
#.........#
D.........d
#..##.....#
#.........#
#......#..#
#.........#
#####D#####

2
1
#####D#####
#.........#
#.........#
#.#..#..#.#
#.........#
D.........#
#..#..#...#
#.........#
#.........#
#k#.....#.#
#####D#####
key : 0

4
1
#####D#####
#.........#
#.........#
##..#..#..#
#.........#
D.........D
#.........#
#.........#
#.........#
##....k#..#
###########
key : 1

3
2
###########
#.........#
#.....#..##
#....###..#
#.....###.#
d......#..D
#....####.#
#.........#
#.........#
#.........#
#####D#####

5
3
#####D#####
#.#.......#
#.###.....#
#...###...#
#.##......#
l.........#
#.........#
#.........#
#.........#
#.........#
###########
locked : 4

7
2
#####D#####
#......##.#
#...#.###.#
#...#..#..#
#...#.###.#
#....##...#
#.........#
#.........#
#.........#
#X........#
###########

3
0
#####D#####
#.........#
#.........#
#.........#
#.........#
#....@....D
#.........#
#.........#
#.........#
#.........#
#####D#####

6
2
#####d#####
#.........#
####......#
###.#.....#
#.#.#.....#
#....e.#..#
#.....#...#
#....#.#..#
#.........#
#.........#
#####D#####
boss
enemies 1

0
1
###########
#.........#
#.........#
#.........#
#.........#
D....#....#
#.........#
#.#.....#.#
#..#...#..#
#.........#
#####D#####

2
0
#####D#####
#.........#
#.........#
#.........#
#.........#
#.........D
#.........#
#.#.......#
#..#......#
#.........#
#####D#####

4
0
#####D#####
#..#......#
#.##..#...#
#.#.......#
#.#.###...#
#.........D
#.........#
#.........#
#.........#
#.........#
###########

3
3
###########
#.........#
#..#...#..#
#.#.....#.#
#.#.......#
D.........d
#.........#
#.....#k#.#
#......#..#
#.........#
#####D#####
key : 3

1
1
#####D#####
#.........#
#.........#
#.........#
#.........#
l.........#
#.........#
#.......#.#
#......#..#
#.........#
#####D#####
locked : 0

4
3
#####D#####
#.........#
#.........#
#.#..#..#.#
#.........#
D.........#
#.....#...#
#.........#
#.........#
#k#.....#.#
#####D#####
key : 4

4
2
#####D#####
##.#...#.##
#.........#
#..#.#.#..#
#.........#
D..#.#.#..D
#.........#
##.#.#.#.##
#.........#
##.#.....##
#####d#####

1
0
#####l#####
#.........#
#.....#...#
#.#..#....#
#.##......#
#...##....l
#.####....#
#####.....#
#.........#
#.........#
#####D#####

5
2
#####d#####
#.........#
#......#..#
#...#..##.#
#.........#
#.........l
#....#....#
#.#.......#
#..#......#
#.........#
#####d#####

0
0
###########
#.........#
####..p...#
#..##.....#
#..##.....#
#.........D
#.....###.#
#.....#.#.#
#.........#
#.........#
#####l#####
locked : 1

3
4
###########
#.........#
#.........#
#.........#
#....##.#.#
d...##....#
#...##.##.#
#....#.##.#
#...#...#.#
#.........#
###########

