3
1
#####.#####
#.........#
#..#......#
#.#.......#
#.........#
......##...
#.........#
#...#.....#
#.........#
#....k....#
###########
key : 0

2
1
#####l#####
#.........#
#.........#
#.........#
#.........#
#.........l
#.........#
#.......#.#
#......#..#
#.........#
#####.#####

3
4
#####.#####
##.......##
#.........#
#..#.#.#.##
#.........#
...#...#...
#.........#
##.#.#.#.##
#.........#
##.......##
###########

2
3
#####d#####
#.........#
#......#..#
#.......#.#
#.........#
...........
#.........#
#.#.......#
#.........#
#.........#
#####.#####

2
4
#####l#####
##.#......#
#...#.....#
#.###.....#
#..##.....#
...#.#....d
#.........#
#.#.#.....#
##k##.....#
##........#
#####.#####
key : 3

3
3
#####.#####
#e.......?#
#.........#
#..#.....##
#.........#
...........
#...#..#..#
#.........#
#.........#
#e.#.....##
#####.#####
enemies 2
sign Something glints behind that door…

4
3
#####.#####
#.........#
#.........#
#....#....#
#....###..#
#....##...#
#.........#
#.........#
#.........#
#e.......e#
###########
enemies 2

0
1
###########
#.........#
#.........#
#.........#
#.........#
#......#..#
#...#.#.#.#
#....##.#.#
#.........#
#......##.#
#####.#####

1
3
###########
#.........#
#.........#
#.........#
#.........#
...........
#.........#
#.........#
#.........#
#.........#
#####d#####

1
5
###########
#.........#
#......#..#
#...#...#.#
#.........#
..........#
#..#......#
#.........#
#.........#
#.........#
#####.#####

3
5
#####d#####
#.........#
#.........#
#.........#
#.........#
....#e....#
#..##.....#
#.##......#
#.........#
#.........#
#####.#####
boss
enemies 1

3
0
###########
####......#
###.......#
#.#.......#
#...#.....#
#...@#.....
#....#..#.#
#.....###.#
#........##
#......####
###########

4
5
#####.#####
#.........#
#.........#
#...#.....#
#....##...#
#..###....#
#.##......#
#.###.....#
#.........#
#X........#
###########

2
5
#####.#####
#.........#
#.#.#...#.#
#.........#
#.#.#...#.#
d.........#
#.#.#.#.#.#
#.........#
#.#.#.#.#.#
#.........#
#####d#####

1
1
#####.#####
#.........#
#......#..#
#.......#.#
#.........#
#..........
#.........#
#.........#
#.........#
#.........#
#####l#####
locked : 1

1
2
###########
#..#k.....#
#..##.#...#
#..###....#
#.........#
...........
#.........#
#.........#
#.........#
#.........#
#####.#####
key : 2

1
4
###########
#.........#
#.........#
#.........#
#.........#
...........
#.........#
#.........#
#.........#
#.........#
#####l#####
locked : 3

2
2
#####.#####
#.......#.#
#.........#
#.........#
#..#..#...#
l..........
#.........#
#.#..#..#.#
#.........#
#.........#
#####.#####
locked : 0

3
2
#####.#####
#.........#
#..#......#
#.#.......#
#.........#
...........
#.........#
#.......#.#
#.....##..#
#......k#.#
###########
key : 1

