1
1
#####D#####
#.........#
#.........#
#.........#
#.....#.#.#
D.....##..D
#.....#.#.#
#.....#...#
#.........#
#.........#
#####D#####

1
0
#####D#####
#.........#
#.........#
#.........#
#.........#
#?...@....D
#.........#
#.........#
#.........#
#.........#
#####D#####
sign Beware what lurks ahead.

3
0
#####D#####
#.........#
#......#..#
#.......#.#
#.........#
#.........#
#.........#
#.#.......#
#..#......#
#.........#
###########

1
3
#####D#####
#k........#
#......#..#
#.......#.#
#.........#
D.........d
#.........#
#.........#
#.........#
#.........#
#####D#####
key : 2

1
4
###########
#......#..#
#......#..#
#....#....#
#.........#
d.........l
#.........#
#.........#
#.....#...#
#.........#
#####D#####

2
5
#####D#####
#.........#
#.....#...#
#...#.##..#
#..#####..#
d..#####..#
#..#e#....#
#.........#
#.........#
#.........#
#####D#####
boss
enemies 1

2
3
#####D#####
#e........#
##.#......#
#.........#
#....#.#..#
D.........l
#....#....#
#.........#
#..#...#.##
#........e#
###########
enemies 2

2
4
#####D#####
#.........#
#.........#
#.........#
#...#.....#
l.........d
#.#.#.....#
#.........#
#.#.......#
#.........#
#####d#####
locked : 6

2
1
#####D#####
#e.....#..#
#.........#
#.........#
#...#..#..#
D.........l
#.........#
#...#..#..#
#.........#
#....e....#
###########
enemies 2

2
2
#####D#####
#.........#
#.........#
#.........#
#.........#
l...#.....D
#.........#
#..#......#
#.........#
#.........#
###########
locked : 0

0
0
###########
#.#.......#
#.........#
#..#.#...##
#.........#
#...#.#...d
#.........#
#....#...##
#.........#
#.......#.#
#####D#####

3
5
#####D#####
#.........#
#.........#
#.........#
#.....#...#
D..##..#..#
#.###.##..#
#..###....#
#.........#
#.#......X#
###########

2
0
#####D#####
#.........#
#......#..#
#.......#.#
#.........#
#.........D
#....#..#.#
#.........#
#...#.....#
#.........#
#####D#####

0
1
###########
#.........#
##.....#.##
#.........#
#.#.....#.#
d.........D
#....#.#..#
#.........#
#.#.#.#.#.#
#.........#
#####D#####

0
2
###########
##.....#k##
#.........#
#.#.#.#.#.#
#.........#
D....#.#..D
#.........#
#...#...#.#
#.........#
##.....#.##
#####D#####
key : 3

1
5
###########
#.........#
#.........#
#....#....#
#...#.#...#
l...#.#...#
#.........#
#p........#
#.........#
#.........#
#####D#####
locked : 3

1
2
#####D#####
#k........#
#.........#
#.#..#..#.#
#.........#
D.........D
#.........#
#.#.......#
#..#......#
#.........#
#####D#####
key : 0

3
4
#####d#####
#.........#
#..#...#..#
#.#.....#.#
#.........#
#.........D
#.........#
#.......#.#
#......#..#
#.........#
###########

0
3
###########
#..#.....k#
#..##.#...#
#...###.#.#
#...###...#
D......#..#
#.........#
#.........#
#.........#
#.........#
#####D#####
key : 6

