3
2
#####d#####
#.........#
#.........#
#.........#
#.........#
D.........#
#.........#
#.......#.#
#......#..#
#.........#
#####D#####

1
1
#####d#####
#.........#
#..#......#
#s#.......#
#.........#
#.........D
#.........#
#.#.......#
#..#......#
#.........#
#####D#####
switch 0 : 0

0
1
###########
#..#......#
#..#......#
#....#....#
#.........#
#.........D
#.........#
#.........#
#.........#
#.........#
#####d#####

5
1
#####D#####
#.........#
#?........#
##..#.....#
#e........#
#.........l
#...#..#..#
#.........#
#.........#
##.....#..#
#####l#####
enemies 1
sign Turn back; you are not yet ready.

6
0
###########
#X........#
#.........#
#.........#
#.........#
#.........D
#.........#
#.........#
#.........#
#.........#
###########

1
3
###########
#.......#.#
#.........#
#..#.#.#..#
#.........#
D.........D
#.........#
#..#.#.#.##
#.........#
#k#.....#.#
#####D#####
key : 3

2
3
#####D#####
#.........#
#.....##..#
#.....#.#.#
#.........#
D..#......#
#...##....#
#..##.....#
#.........#
#........k#
###########
key : 1

2
2
#####D#####
#.........#
#.........#
#..#......#
#.........#
D.........D
#...#..#..#
#.........#
#.........#
#..#.....##
#####d#####

6
2
#####D#####
#.........#
#.........#
#.........#
#.........#
D.........#
#.#.......#
#..#......#
#........e#
#.......ee#
###########
enemies 3
door 0 : 0

1
2
#####D#####
#k........#
#.........#
#.........#
#.........#
D.........D
#.........#
#.#.....#.#
#..#...#..#
#.........#
#####D#####
key : 0

6
1
#####l#####
#.........#
#...#.....#
#..##.....#
#.#.###...#
D...###...D
#...e##...#
#..####...#
#.........#
#.........#
#####D#####
locked : 3
boss
enemies 1

3
1
#####D#####
##........#
#.........#
#...#.#.#.#
#.........#
#..#.#.#..D
#.........#
#...#.#.#.#
#.........#
##.#...#..#
#####l#####

1
4
###########
#.#......k#
#.........#
#.#.#.....#
#.........#
D.....#...#
#.........#
#.#...#.#.#
#.........#
#.#.......#
###########
key : 6

0
2
###########
#......?se#
#.........#
#.........#
#....#....#
D...##....#
#.####....#
#.#####...#
#.###.#...#
#.........#
#####D#####
enemies 1
switch 1 : 1 2
sign A useful tool lies just ahead.

5
2
#####D#####
#.........#
#......#..#
#..#....#.#
#.........#
l.........#
#.........#
#.#.......#
#..#......#
#.........#
#####D#####
locked : 6

4
2
#####D#####
#.........#
#..#...#..#
#.........#
#...#.#e#e#
D........e#
#..#...#..#
#.........#
#.#...#.#.#
#.........#
#####D#####
enemies 3

2
1
#####D#####
####......#
##..#.....#
#.#.......#
#..#......#
#..##@....D
#.........#
#.#.......#
##........#
#.........#
#####D#####

4
1
#####l#####
#.........#
#.........#
#.........#
#.........#
#.........D
#.........#
#.........#
#.........#
#.........#
#####D#####
locked : 1

7
1
#####D#####
#......#..#
#.........#
#.........#
#.........#
#..#......#
#.........#
#.......#.#
#......#..#
#?........#
###########
door 1 : 1 2
sign This door will not yield without a key.

