1
3
###########
#e...e....#
#.........#
#.....#..##
#.........#
D.........D
#..#......#
#.........#
#.........#
#e.#.....##
#####D#####
enemies 3

1
4
###########
#.........#
#..#...#..#
#.#.....#.#
#.........#
D.........D
#.........#
#.#.......#
#..#......#
#.........#
#####D#####

2
6
###########
#.........#
#...p.....#
#.........#
#..##.....#
l..###....#
#.##......#
#####.....#
#####.....#
#.........#
###########
locked : 4

2
3
#####D#####
#.........#
#...#.#...#
#.#.#.....#
#.####....#
D..###....D
#...#k#...#
#.........#
#.........#
#.........#
###########
key : 2

4
0
###########
#?........#
#.........#
##.#......#
#..#@.###.#
#....##...D
#....#.##.#
#......####
#......##.#
#.........#
###########
sign The dungeon remembers all who enter.

2
4
#####D#####
#k........#
#..#......#
#.#....#..#
#.........#
D.........D
#.........#
#.........#
#.........#
#.........#
#####l#####
key : 3

2
5
#####d#####
#k........#
#.........#
#.........#
#.........#
D.........l
#.........#
#.#.....#.#
#..#...#..#
#.........#
#####d#####
key : 4

3
1
#####D#####
#.........#
#.........#
#.........#
#.........#
#...#..#..d
#.........#
#.........#
##..#..#..#
#.........#
#####D#####

1
2
###########
#.........#
#.........#
#.........#
#.........#
#...#..#..D
#.....#.#.#
#...##....#
#......#..#
#.........#
#####l#####
locked : 2

2
2
#####l#####
#......#..#
#...#.#...#
#...####.##
#.....#...#
d......#..D
#.........#
#.....##..#
#.........#
#.........#
#####D#####

4
1
#####D#####
#.........#
#.........#
#.........#
#.........#
D.........D
#..#..##..#
#...#.....#
#.........#
#.........#
#####D#####

1
5
#####D#####
#.........#
#.........#
#...#.....#
#..#.###..#
D....e#...#
#...#.##..#
#..#.###..#
#.........#
#.........#
#####d#####
boss
enemies 1

3
5
#####d#####
#.........#
#.........#
#.....#...#
#.....###.#
D......#..#
#.........#
#.........#
#p........#
#.........#
###########

2
1
###########
#k........#
#.........#
#.#####...#
#.###.....#
#..####...d
#...###...#
#.###.#...#
#.........#
#.........#
#####D#####
key : 0

5
1
#####D#####
#.........#
#..#......#
#.#.......#
#.....#...#
#.........#
#.........#
##......#.#
#......#..#
#.........#
###########

3
2
#####D#####
#.......#.#
#..#......#
#.#.......#
#.........#
d..#......#
#...#.....#
#.........#
#.........#
#.........#
#####D#####

4
2
#####D#####
#.........#
##........#
#.##......#
#.##......#
D.........#
#......#..#
#.........#
#.........#
#.........#
###########

3
4
#####l#####
#.........#
#.....#.#.#
#......##.#
#.........#
#.........D
#.........#
#.........#
#.........#
#.........#
###########
locked : 3

0
5
###########
#X........#
#.....#...#
#.....#...#
#.###.....#
#...#.#...#
#.........#
#.........#
#.........#
#.........#
#####D#####

