1
3
#####.#####
##........#
##.##.....#
####......#
#.####....#
d....e....#
#.........#
#.........#
#.........#
#.........#
#####.#####
boss
enemies 1

4
3
###########
#........##
#.....##..#
#.......###
#....####.#
l.........#
#.........#
#.........#
#.........#
#.........#
###########
locked : 0

5
1
#####.#####
#.........#
#.#.......#
#.........#
#.........#
#....#.....
#.........#
#.........#
#.......#.#
#k........#
###########
key : 0

2
2
#####l#####
#k.#......#
#.........#
#.........#
#...#..#..#
...........
#.........#
#........##
#.........#
#.........#
#####.#####
key : 2

1
2
###########
#..#...#..#
#.........#
##.#...#.##
#.........#
.....#.#..d
#.........#
##.#.#....#
#.........#
##.#...#..#
#####l#####
locked : 2

5
2
#####.#####
#.........#
#.........#
#.........#
#.........#
.........k#
#.........#
#.........#
#.........#
#.........#
#####.#####
key : 1

4
0
###########
#.........#
#.........#
#.........#
#.........#
#..#.@.....
#...#.#...#
#......#..#
#.....#...#
#..#...#..#
###########

2
1
#####d#####
#.........#
#.........#
#.##.#....#
#.#.#.....#
#...#.##...
#..#.#.##.#
###..#.#..#
#.........#
#......##.#
#####d#####

6
3
###########
#.........#
#.........#
#.........#
#.........#
d.........#
#.........#
#.#.....#.#
#..#...#..#
#.........#
#####.#####

2
3
#####.#####
#.##......#
#...#.....#
#.###.....#
#.#...#...#
....#.....#
#.###.....#
#...#.....#
#.........#
#........X#
###########

7
3
#####.#####
#.........#
#.........#
#.........#
#....#....#
..........#
#.....#...#
#.#..#....#
#..#......#
#.........#
###########

3
2
#####.#####
#.........#
#.........#
#.........#
#.........#
.....#....#
#.........#
#.........#
#.......#.#
#.........#
#####l#####
locked : 1

6
2
#####.#####
#.........#
#.#.#.#.#.#
#.........#
#.#.#.#.#.#
#.........d
#.#...#.#.#
#.........#
#.#.#.#...#
#.........#
#####.#####

1
1
###########
#.........#
#..#......#
####......#
#..#......#
#..#.......
#.........#
#.........#
#.........#
#.........#
#####d#####

4
2
#####l#####
#.........#
#.........#
#.........#
#.........#
..........l
#.........#
#.........#
#.........#
#.........#
#####.#####

4
1
#####.#####
#.........#
#.........#
#.........#
#.........#
...........
#.........#
#.......#.#
#......#..#
#.........#
#####.#####

3
1
#####d#####
#.........#
#......#..#
#.......#.#
#.........#
#..........
#.........#
#.........#
#.........#
#.........#
#####.#####

0
3
###########
#k........#
#.........#
#.........#
#....##.#.#
#.....##..#
#....##.#.#
#.......#.#
#.........#
#.........#
#####.#####
key : 5

7
2
#####.#####
#.........#
#.........#
#.........#
#.........#
#..........
#.........#
#.........#
#.........#
#.........#
###########

