4
0
###########
##........#
##.##.....#
####......#
#.####....#
#....@....D
#.........#
#.........#
#.........#
#.........#
###########

5
1
#####D#####
#........##
#.....##..#
#.......###
#....####.#
#.........D
#.........#
#.........#
#.........#
#k........#
###########
key : 0

0
3
###########
#k........#
#.#.......#
#.........#
#.........#
#....#....#
#.........#
#.........#
#.......#.#
#.........#
#####D#####
key : 5

2
3
#####D#####
#.........#
#.........#
#.........#
#.........#
D..#......#
#..###....#
#..#......#
#.#.......#
##.......X#
###########

3
1
#####d#####
#.........#
#.........#
#....##...#
#..##..#..#
#...#.....D
#.........#
#..##.##..#
#.........#
#.........#
#####D#####

2
2
#####l#####
#k........#
#.........#
#.........#
#.........#
D.........D
#.........#
#.#.......#
#..#......#
#.........#
#####D#####
key : 2

4
1
#####D#####
#.........#
#.........#
#.........#
#.........#
D.........D
#.........#
#.......#.#
#......#..#
#.........#
#####D#####

6
2
#####D#####
#.........#
#..#......#
#.#.......#
#.........#
#.........d
#.........#
#.#.......#
#..#......#
#.........#
#####D#####

2
1
#####d#####
#.........#
#......#..#
#.......#.#
#.........#
#.........D
#.........#
#.........#
#.........#
#.........#
#####d#####

6
3
###########
#.........#
#.........#
#.........#
#.........#
d...###...#
#....##...#
#.........#
#.........#
#.........#
#####D#####

5
2
#####D#####
#.........#
#..#......#
#.#.......#
#.........#
D........k#
#.........#
#.........#
#..#...#..#
#.........#
#####D#####
key : 1

7
2
#####D#####
##.#......#
#.........#
##.#.#...##
#.........#
#..#.#.#..D
#.........#
##.....#.##
#.........#
#......#..#
###########

1
2
###########
#.#.......#
#.........#
#.........#
#.#.....#.#
D.........d
#.........#
#.#..#..#.#
#.........#
#.........#
#####l#####
locked : 2

7
3
#####D#####
#.........#
#.........#
#.........#
#.........#
D.........#
#.........#
#.........#
#.........#
#.........#
###########

4
2
#####l#####
#.........#
#..#......#
#.#.......#
#.........#
D.........l
#.........#
#.......#.#
#......#..#
#.........#
#####D#####

1
1
###########
#.........#
#.........#
#.........#
#.........#
#.........D
#.........#
#.........#
#.........#
#.........#
#####d#####

1
3
#####D#####
#.........#
#.........#
#.........#
#.........#
d....e....#
#.....##..#
#......##.#
#.........#
#.........#
#####D#####
boss
enemies 1

4
3
###########
#.........#
#.........#
#....#..#.#
#.........#
l.........#
#.#.....#.#
#.........#
#.........#
#.......#.#
###########
locked : 0

3
2
#####D#####
#.........#
##.#.....##
#.........#
#.#.#.#.#.#
D.........#
#..#.#.#..#
#.........#
#.#.#...#.#
#.........#
#####l#####
locked : 1

