0
3
###########
#.#.....#.#
#.........#
#..#.#.#.##
#.........#
D...#.#...#
#.........#
#..#...#.##
#.........#
#.#.....#.#
#####d#####

1
3
#####d#####
#k........#
#.........#
#.........#
#.........#
D.........d
#.........#
#.........#
#.........#
#.........#
#####l#####
key : 1

2
2
#####D#####
##.......e#
#.........#
#.........#
#.#..#..#.#
D.........D
#.........#
##..#..#..#
#.........#
#e.......e#
#####D#####
enemies 3

3
1
#####l#####
#.........#
#.#.....#.#
#.........#
#.........#
D..#..#...D
#.........#
#.........#
#.#.....#.#
#.........#
#####D#####

0
0
###########
#.........#
#.........#
#.........#
#.........#
#....@....D
#....#....#
#....#....#
#.........#
#.........#
#####D#####

1
0
#####D#####
#.........#
#.........#
#.........#
#.........#
#.........D
#.........#
#.........#
#.........#
#.........#
#####D#####

3
3
#####D#####
####......#
#.........#
###.......#
#.###.....#
D..##.....#
#..###....#
#..#......#
#.........#
#........X#
###########

1
1
#####d#####
#k........#
#.........#
#..#.....##
#.........#
D.........d
#...#..#..#
#.........#
#.........#
#..#......#
#####D#####
key : 0

2
3
#####l#####
#.........#
#.........#
#.........#
#.........#
D....e....#
#.........#
#.........#
#.........#
#.........#
#####D#####
locked : 2
boss
enemies 1

0
1
###########
#.........#
#......#..#
#.......#.#
#.........#
D.........D
#.........#
#.........#
#.........#
#.........#
#####d#####

1
2
#####l#####
##.#...#.##
#.........#
#.#...#.#.#
#.........#
d..#.#....D
#.........#
#.#.#.#.#.#
#.........#
#..#...#..#
#####D#####

3
0
#####D#####
###.......#
##.##.....#
##.#......#
#..##.....#
#..#......D
#.........#
#.........#
#...#.....#
#.........#
#####D#####

4
0
#####D#####
#.........#
#.#.#.#.#.#
#.##.#.##.#
#....#....#
#..#..#...D
#e#e#.....#
#.........#
#?........#
#e........#
###########
enemies 3
sign What you seek is close.

1
4
###########
#.........#
#.........#
#.........#
#.........#
d.........#
#.........#
#.#.......#
#..#......#
#.........#
###########

2
1
#####D#####
#.........#
#.........#
#..#.#.#.##
#.........#
D...#.....D
#.........#
#....#.#.##
#.........#
#.#.......#
#####l#####
locked : 0

0
2
###########
#.........#
#......#..#
#.......#.#
#.........#
D.........D
#.........#
#.........#
#.........#
#.........#
#####l#####
locked : 1

4
1
#####D#####
#.........#
#.........#
#..#..#...#
#.........#
D.........#
#...#..#..#
#.........#
#.........#
#..#....k##
###########
key : 3

2
0
#####D#####
#.........#
#.........#
#.........#
#.........#
#.........D
#.........#
#.........#
#.........#
#.........#
#####D#####

3
2
#####D#####
#..#...#.##
#.........#
#..#.#...##
#.........#
D..#.#....D
#.........#
##...#...##
#.........#
##k#...#.##
###########
key : 2

