3
2
#####.#####
#.......###
#.......#.#
#....##...#
#....#.#..#
l.........d
#....#.#..#
#.....#...#
#.........#
#.........#
#####.#####
locked : 1

2
1
#####.#####
#.........#
#.........#
#.........#
#.........#
..........d
#...#.....#
#.........#
#.........#
#.........#
#####l#####
locked : 0

4
0
#####.#####
#k........#
##.#...#.##
#.........#
#...#.....#
#..........
#....#....#
#.........#
#.#.#.#...#
#.........#
#####.#####
key : 1

1
0
###########
##e#...#.##
#e.?......#
##s#.#.#.##
#e........#
#....#.#...
#.........#
##.#.#.#..#
#.........#
##.#...#.##
#####.#####
enemies 3
switch 0 : 0 1
sign Many have walked this path.

4
1
#####.#####
#.........#
#.........#
#.......#.#
#.........#
...........
#...#.....#
#.........#
#.........#
#....k....#
###########
key : 2

1
3
###########
#.........#
#.........#
#.........#
#.........#
d....e....#
#.........#
#.........#
#.........#
#.........#
#####.#####
boss
enemies 1

2
0
#####.#####
#.........#
#.........#
#.........#
#.........#
#..........
#.........#
#.........#
#.........#
#.........#
#####.#####

3
3
#####.#####
#.......#.#
#.........#
#..#.#....#
#.........#
d...#.#...#
#.........#
#..#.#...##
#.........#
#.#.....#.#
###########

6
0
#####d#####
#.........#
#......#..#
#.......#.#
#.........#
#.........#
#.........#
#.#.......#
#..#......#
#.........#
###########

4
2
#####.#####
#.........#
#......##.#
#....##.#.#
#.......#.#
.....###..#
#....###..#
#.###.#...#
#..#......#
#..#......#
###########

1
1
#####.#####
#.........#
#.........#
#.........#
#.........#
...........
#.........#
#.#.......#
#..#......#
#.........#
#####.#####

2
2
#####.#####
#.........#
#..#......#
#.#.......#
#.........#
d..........
#.........#
#.........#
#.........#
#.........#
#####.#####

0
2
###########
#........k#
#.........#
#.........#
#.........#
..........#
#.........#
#.........#
#.........#
#.........#
#####.#####
key : 5

3
1
#####l#####
#.........#
#..#.....##
#.........#
#......#..#
..........l
#....#.#..#
#.........#
##.#...#.##
#k........#
#####.#####
key : 0

2
3
#####.#####
#.........#
#.........#
#.........#
#.........#
.........X#
#.........#
#.........#
#.........#
#.........#
#####.#####

3
0
#####.#####
#.........#
#.........#
#.........#
#.........#
#....@.....
#.........#
#.........#
#.........#
#.........#
#####.#####

1
2
#####.#####
#e........#
#...#...#.#
#.........#
#..#.#.#..#
..........d
#...#.#.#.#
#.........#
#..#.....##
#?.......e#
#####.#####
enemies 2
door 0 : 0 1
sign A useful tool lies just ahead.

0
1
###########
#.........#
#.........#
#....#.#..#
#...#.#.#.#
#.....#....
#...#.....#
#....##...#
#.........#
#.........#
#####.#####

5
0
#####.#####
#.........#
#.........#
###.##....#
#..##.....#
#..#####..#
#.##.#....#
#.##.###.##
#.....###.#
#.........#
#####d#####

