2
4
###########
#.........#
#.........#
#.........#
#.........#
D.........D
#.........#
#.......#.#
#......#..#
#.........#
###########

6
0
#####D#####
#.........#
#.#.#.#.#.#
#.........#
#..#.#....#
#.........#
#.#.#...#.#
#.........#
#......#.##
#.........#
###########

3
1
###########
#..#......#
#.........#
#.........#
#.....#...#
D.........D
#.........#
#..#.....##
#.........#
#.........#
#####d#####

5
0
#####D#####
#.........#
#...#.#...#
#.........#
#..#.#.#..#
#.........D
#e#...#.#.#
#.........#
#..#.....##
#........s#
#####D#####
enemies 1
switch 0 : 0

2
5
###########
#.......ee#
#.........#
#.........#
#.##......#
D..#......#
#.#.......#
#.........#
#.........#
#........e#
###########
enemies 3
door 0 : 0

4
1
#####d#####
#k........#
##.#...#.##
#.........#
#..#...#..#
D.........l
#..#.#.#..#
#.........#
##.#...#.##
#.........#
#####D#####
key : 0

4
2
#####D#####
#.........#
#.........#
#.#..#..#.#
#.........#
l.........#
#..#..#...#
#.........#
#.........#
#.#.......#
###########
locked : 0

0
3
###########
#........X#
#.........#
#.........#
#....#....#
D..#...#..#
#..#..#.#.#
#........##
#......##.#
#.........#
#####D#####

1
3
#####D#####
#.........#
#...p.....#
#.........#
#...e.....#
d....###..#
#.....#...#
#....##.#.#
#.p...#.#.#
#......##.#
#####D#####
boss
enemies 1

3
0
#####D#####
#.......#.#
#.........#
#.#.#.....#
#.........#
#...#.#...D
#.........#
#.#.#...#.#
#.........#
#.#.....#.#
#####D#####

2
0
###########
#.........#
#.......#k#
#.p..##..##
#.......#.#
#.........#
#.........#
#.........#
#.........#
#.........#
#####D#####
key : 1

2
2
#####D#####
#.........#
#.........#
#.......#.#
#.........#
#.........d
#.......#.#
#.........#
#.........#
#.#.......#
#####d#####

4
0
#####D#####
#.........#
#.........#
#.........#
#.........#
#....@....D
#.........#
#.........#
#.........#
#.........#
#####D#####

3
3
#####D#####
#.......#.#
#.........#
#.........#
#..#..#...#
D.........#
#.........#
#.#..#..#e#
#........?#
#.......ee#
###########
enemies 3
sign Those who search shall find.

1
2
#####l#####
#........k#
#..#..#..##
#.........#
#.........#
#...#..#..d
#.........#
#.........#
#........##
#.........#
#####D#####
key : 6

0
2
###########
#.........#
#.........#
#.........#
#.........#
#.........D
#.........#
#.#.......#
#..#......#
#.........#
#####l#####
locked : 6

3
2
#####d#####
#k........#
#..#......#
#.#.......#
#.........#
D.........D
#.........#
#.#.......#
#..#......#
#.........#
#####D#####
key : 2

2
3
#####D#####
#.........#
#.........#
#.........#
#.........#
d.........D
#.........#
#.....#...#
#.........#
#.........#
#####D#####

5
1
#####D#####
#.........#
#...#.....#
#.###.....#
#.####.##.#
D.........#
#...##....#
#....#.##.#
#...#.#...#
#.........#
###########

