5
3
#####.#####
#.........#
#.........#
#.........#
#.........#
#..........
#.........#
#?........#
#e........#
#ee.......#
###########
enemies 3
sign The brave are rewarded.

3
4
#####d#####
#.........#
#..#...#..#
#.......#.#
#.........#
..........#
#.........#
#.........#
#.........#
#.........#
#####.#####

0
3
###########
#k........#
#.......#.#
#.........#
#....#....#
#.........#
#.#.#...#.#
#.........#
#..#...#..#
#.........#
#####.#####
key : 4

3
0
#####d#####
#.#.......#
#..##.....#
#.........#
#.###.....#
#...#@.....
#....#....#
#.##..#...#
#.#.......#
#.........#
###########

2
0
#####.#####
#.........#
#...#.#...#
#...###...#
#...###...#
#..........
#.........#
#.........#
#.........#
#.........#
#####d#####

2
2
#####.#####
#.........#
#.........#
#.........#
#.........#
..........d
#.....#...#
#.........#
#.........#
#.........#
#####.#####

1
3
#####.#####
#.........#
#.........#
#.........#
#..#.#....#
...#..##..#
#..#......#
#..#.#....#
#...#.##..#
#.........#
#####d#####

2
4
###########
#.......#k#
#.........#
#.........#
#..#..#...#
..........#
#.........#
#.#..#..#.#
#.........#
#.........#
#####d#####
key : 1

1
0
###########
#.........#
#..#...#..#
#.#.....#.#
#.........#
#.........#
#.........#
#.........#
#.........#
#.........#
#####.#####

1
2
###########
##e#....#.#
##..#.....#
#..#....#.#
#...###.#.#
#..........
#.........#
#.........#
#.........#
#.........#
#####.#####
enemies 1

3
1
#####.#####
#.........#
#.#.......#
#.........#
#.........#
...........
#.........#
#.........#
#.#.....#.#
#.........#
###########

4
3
#####.#####
##k#.....##
#.........#
#...#.#.#.#
#.........#
...#.#....l
#.........#
#.#.#.#...#
#.........#
##........#
#####.#####
key : 3

4
4
#####.#####
#.........#
#.........#
#.........#
#.........#
l..#.e....#
#.#.......#
##........#
#.........#
#.........#
#####.#####
locked : 4
boss
enemies 1

4
2
#####l#####
#.........#
#.........#
#.........#
#....#.##.#
#....#.....
#.....###.#
#...##.##.#
#......##.#
#.........#
###########
locked : 0

2
1
###########
#.........#
#..#...#..#
#.#.....#.#
#.........#
...........
#.........#
#.#.......#
#..#......#
#.........#
#####.#####

5
4
#####.#####
#.........#
#.....#...#
#.#.#.#...#
#.###.#...#
....###...#
#.####....#
#.........#
#.........#
#........X#
###########

3
3
#####l#####
#.........#
#.........#
#..#..#..##
#.........#
...........
#..#..#...#
#.........#
#.........#
#..#.....##
#####.#####
locked : 1

2
3
#####d#####
#.........#
#.........#
#....###..#
#..##..#..#
d.....##...
#...#..#..#
#..###....#
#.........#
#.........#
#####l#####

3
2
#####.#####
##.#...#.##
#k........#
##...#.#.##
#.........#
...........
#.........#
##.#.#.#.##
#.........#
#..#...#.##
#####l#####
key : 0

