5
0
#####l#####
##........#
#.........#
#.........#
#.........#
#.........D
#....#....#
#.........#
#.........#
#.........#
#####D#####
locked : 1

7
1
#####d#####
#.........#
#...#..#..#
#.........#
#.........#
D....#....#
#.........#
#.........#
##.....#..#
#.........#
###########

8
0
#####d#####
#.........#
#..##.....#
###.#.....#
#.#.#...#.#
#....e....#
#.........#
#.........#
#.........#
#.#.......#
#####D#####
boss
enemies 1

6
2
###########
#.........#
#..#......#
#.#.......#
#.........#
D.........#
#.........#
#.#.......#
#..#......#
#.........#
###########

4
1
#####D#####
#.........#
#.........#
#..#..#..##
#........k#
D.........#
#..#..#...#
#.........#
#.........#
#..#.....##
#####D#####
key : 1

1
1
#####d#####
#.........#
#.###.....#
#.##......#
#....#....#
#.....##..D
#...###...#
#...###.#.#
#.....#...#
#.........#
#####D#####

3
1
#####D#####
#.........#
##.#......#
#.........#
#.#...#.#.#
D.........#
#..#.#.#..#
#.........#
#.#.#...#.#
#.........#
#####D#####

1
3
###########
#........k#
#.........#
#.........#
#.........#
D.........#
#.........#
#.........#
#.........#
#.........#
###########
key : 3

6
1
#####D#####
#.........#
#.........#
#.#...#...#
#.........#
d...#.#...D
#.........#
#.#.....#.#
#.........#
#.......#.#
#####d#####

1
2
###########
#.........#
#.........#
#.........#
#.....##..#
D....#....D
#......#..#
#.........#
#.........#
#.........#
###########

2
1
#####D#####
#.........#
#......#..#
#.......#.#
#.........#
D.........#
#.........#
#.#.......#
#..#......#
#.........#
#####D#####

9
0
#####D#####
#.........#
#.........#
#.........#
#..#......#
#.........#
#.#.#.....#
####......#
#X##......#
#.........#
###########

0
1
###########
#.........#
#......#..#
#.......#.#
#..#......#
#.........#
#.........#
#.........#
#.........#
#.........#
#####d#####

6
0
#####D#####
#e#.......#
#..#......#
#..#...#..#
#....#.##.#
#?........d
#....####.#
#......#..#
#.........#
#.........#
#####D#####
enemies 1
sign Turn back; you are not yet ready.

2
0
###########
#.........#
#.........#
#.........#
#.........#
#....@....D
#.........#
#....p....#
#.........#
#.........#
#####D#####

5
1
#####D#####
#.........#
#.........#
#.........#
#.....###e#
D.........#
#....###..#
#....###..#
#.........#
#.........#
#####D#####
enemies 1

7
0
#####D#####
#.........#
#.........#
#..#..#...#
#.........#
#k........D
#...#..#..#
#.........#
#.........#
#..#......#
#####d#####
key : 2

3
0
#####D#####
#.........#
#.........#
#e#..#..#.#
#.........#
#.........D
#..#..#...#
#.........#
#.........#
#e#.......#
#####D#####
enemies 2

4
0
#####D#####
#k#.......#
#.........#
#.........#
#.#..#..#.#
#.........D
#.........#
#.#..#..#.#
#.........#
#.........#
#####l#####
key : 0

