3
3
#####.#####
#.........#
#..#......#
#.#.......#
#.........#
l..#.......
#.........#
#.#.......#
#..#......#
#.........#
#####d#####
locked : 0

1
0
###########
#k.....#..#
#.........#
#.#.#.#...#
#.........#
#..#.#.....
#.........#
#.#.....#.#
#.........#
##.#...#..#
#####.#####
key : 0

1
1
###########
##....e#e##
#e........#
##.#.#.#.##
#.........#
...#.......
#.........#
##.#.#.#.##
#.........#
##........#
#####.#####
enemies 3

1
4
###########
#........X#
#..##.....#
#....#....#
#.........#
......#...#
#......##.#
#...##....#
#.......#.#
#.......###
#####.#####

2
4
#####.#####
#.........#
#.........#
#....#.##.#
#.....###.#
.....e.#..#
#.....##..#
#....#.####
#.........#
#.........#
#####l#####
locked : 3
boss
enemies 1

3
1
#####.#####
#.........#
#.........#
#.........#
#.........#
#..........
#.........#
#.#.....#.#
#..#...#..#
#k........#
###########
key : 2

2
2
#####l#####
#k........#
#......#..#
##......#.#
#.........#
..........l
#.........#
#.#.......#
#..#......#
#.........#
#####.#####
key : 1

5
3
#####d#####
#.........#
##.#.....##
#.........#
#..#.#.#..#
#.........#
#..#...#..#
#.........#
#..#...#.##
#.........#
###########

4
3
#####d#####
#.........#
#...#.#.#.#
#.........#
#..#.#.#..#
...........
#.....#.#.#
#.........#
#..#...#..#
#.........#
#####d#####

4
2
#####.#####
#.#.....#.#
#.........#
#.#.#...#.#
#.........#
#...#.#....
#.........#
#.#.#.....#
#.........#
#.#.....#.#
###########

3
2
#####.#####
#.........#
#.........#
#.........#
#.........#
..........l
#..####...#
#....##...#
#.........#
#.........#
#####.#####

3
4
#####l#####
#e........#
##?.#.....#
#e#.......#
#..#......#
.........e#
#.........#
#...#.....#
#.........#
#s........#
#####.#####
enemies 3
switch 0 : 0 1
sign Only the prepared may pass.

2
1
#####.#####
#.........#
#..#...#..#
#.#.....#.#
#.........#
...........
#.....#...#
#.#...#..##
#..#......#
#.........#
#####.#####

4
4
#####.#####
#.........#
#.........#
#..#..#..##
#.........#
..........#
#...#..#..#
#.........#
#........?#
#..#....e##
###########
enemies 1
door 0 : 0 1
sign The dungeon remembers all who enter.

2
3
#####.#####
#.........#
#.........#
#.#..#..#.#
#.........#
l..........
#....#..#.#
#.........#
#.........#
#.#.....#.#
#####.#####
locked : 2

0
2
###########
####.....k#
##........#
##..#.....#
#..#......#
#..#......#
#.........#
#.........#
#.........#
#.........#
#####.#####
key : 3

2
0
#####.#####
#.........#
#.........#
#.........#
#.........#
#....@.....
#....#....#
#...#.....#
#..#......#
#.........#
###########

1
3
###########
#.........#
#.........#
#.........#
#..##.....#
d..##......
#....#....#
#.........#
#.........#
#.........#
#####.#####

1
2
#####.#####
#.......#.#
#...#...#.#
#....#.##.#
#...###...#
..........d
#.........#
#.........#
#.........#
#.........#
#####l#####
locked : 1

