2
2
###########
#.........#
#..#..#..##
#.........#
#.........#
l..#......d
#.........#
#.........#
#..#..#..##
#.........#
###########
locked : 1

1
1
###########
#.........#
#.......#.#
#.........#
#.........#
D.........#
#.........#
#.........#
#.#.....#.#
#.........#
#####l#####
locked : 2

6
3
#####d#####
#.........#
#.........#
#.........#
#.........#
#....e....#
#.........#
#.........#
#.........#
#.........#
#####D#####
boss
enemies 1

5
0
#####D#####
#.........#
#.........#
#.........#
#.........#
#.........#
#.........#
#...#.....#
#.........#
#.........#
###########

4
1
#####D#####
#.........#
#.........#
#.........#
#.........#
D..#......#
#.........#
#.........#
#.........#
#.........#
###########

2
4
###########
#........k#
#.........#
#.....#...#
#.........#
D.........#
#.........#
#.........#
#.........#
#........##
#####D#####
key : 3

7
3
#####D#####
#......#..#
#.........#
#.....##..#
#.........#
#.........#
#.........#
#.........#
#.........#
#X........#
###########

0
0
###########
#k........#
#......#..#
#........##
#.........#
#.........#
#....#....#
#.#.......#
#..#......#
#.........#
#####D#####
key : 1

3
1
#####D#####
#.........#
#.........#
#....#..#.#
#.........#
D.........#
#..#......#
#.........#
#.........#
#k#.......#
#####D#####
key : 2

2
3
###########
#.........#
#......#..#
#.......#.#
#.........#
d.........D
#.........#
#.........#
#.........#
#.........#
#####l#####

3
4
#####D#####
#..#...#.##
#.........#
#..#.#...##
#.........#
D..#...#..#
#.........#
#..#.#.#..#
#........e#
#..#...#e##
###########
enemies 2

2
0
#####l#####
#.........#
#.........#
#.........#
#.........#
#?...@....D
#.........#
#.........#
#.........#
#.........#
#####D#####
sign This room feels watched.

2
1
#####l#####
#.......#.#
##.#..##..#
###.#..#..#
#.#.......#
D...#.....l
#.##......#
#.........#
#.#.......#
#.........#
#####D#####

4
3
#####D#####
#..#......#
#.........#
#.........#
#...#..#..#
#.........#
#.........#
#..#..#..##
#.........#
#.........#
#####d#####

4
0
#####d#####
#.........#
#.........#
#.........#
#...#.....#
#..##.....D
#..#......#
###.......#
#..#......#
#.........#
#####D#####

3
0
#####D#####
#.........#
#.........#
#.........#
#....#..#.#
#....##...D
#....#k#..#
#.......###
#.....#..##
#.........#
#####d#####
key : 0

1
0
#####D#####
#.........#
#.........#
##..#..#..#
#.........#
#.........D
#.#..#....#
#.........#
#.........#
##.....#..#
#####l#####
locked : 0

5
3
#####d#####
#.........#
##.#......#
#.........#
#..#.#....#
#.........#
#......#..#
#.........#
##.#...#..#
#.........#
#####d#####

3
3
#####l#####
#.........#
#......#..#
#.......#.#
#.........#
#.........D
#.........#
#.#.......#
#..#......#
#.........#
#####D#####
locked : 3

