1
0
###########
#k........#
#.........#
#.........#
#.........#
#..........
#.........#
#.#.....#.#
#..#...#..#
#.........#
#####.#####
key : 0

1
1
#####.#####
#.........#
#.........#
#.........#
#.........#
...........
#.........#
#.#.......#
#..#......#
#.........#
#####.#####

2
1
#####.#####
#.........#
#.........#
#.#..#..#.#
#.........#
d..........
#.#..#....#
#.........#
#.........#
#.........#
#####.#####

3
0
#####.#####
#.........#
#.........#
#.........#
#.........#
#?...@.....
#.........#
#.........#
#.........#
#.........#
#####.#####
sign Beware what lurks ahead.

3
1
#####.#####
#..#.....##
#.........#
#.........#
#..#..#...#
...........
#.........#
#.....#..##
#.........#
#.........#
#####.#####

3
2
#####.#####
#k........#
##.#...#.##
#.........#
#..#.#....#
..........l
#....#.#..#
#.........#
##.#...#.##
#.........#
#####.#####
key : 2

4
2
#####.#####
#........##
#.........#
#.........#
#.....#...#
..........d
#.........#
#..#..#..##
#.........#
#.........#
#####d#####

1
2
###########
#.........#
#.###.....#
#..##.....#
#...#.....#
..........#
#..#......#
####......#
#..#......#
#.........#
#####.#####

4
1
#####.#####
#..#......#
#..#......#
#.#.......#
#.......#.#
...........
#.........#
#.........#
#.........#
#.......#k#
###########
key : 1

4
3
#####.#####
#.........#
#.........#
#.#...#...#
#.##e.....#
d...###...#
#.##.##...#
#..#......#
#.........#
#.........#
#####.#####
boss
enemies 1

0
1
###########
##k#...#..#
#.........#
#.#.#...#.#
#.........#
#..#.#.#..#
#.........#
#...#.#.#.#
#.........#
##.#...#..#
#####.#####
key : 4

4
0
#####.#####
#.........#
#.........#
####......#
#..#......#
#..........
#.........#
#.........#
#e........#
#ee.......#
###########
enemies 3

2
2
#####.#####
#.........#
#.........#
#.........#
#..#.#....#
...........
#..##.....#
##........#
#.#.......#
#.........#
#####.#####

2
0
#####.#####
#.........#
#.........#
#.........#
#.........#
#ee#......d
#e#.......#
##........#
#?........#
#.........#
#####.#####
enemies 3
sign What you seek is close.

2
3
###########
#.........#
#......#..#
#.......#.#
#.........#
..........#
#.........#
#.........#
#.........#
#.........#
#####.#####

5
3
#####.#####
#.........#
#.........#
#.........#
#.........#
..........#
#.........#
#.........#
#.........#
#........X#
###########

5
2
#####d#####
#.........#
#......#..#
#.###..#..#
#..#.#.#..#
#..#...#...
#..###....#
#.........#
#.........#
#........##
###########

3
3
#####.#####
#.........#
#..#..#..##
#.........#
#.........#
l..#..#...d
#.........#
#.........#
#..#..#..##
#.........#
#####.#####
locked : 2

3
4
###########
#.........#
#.........#
#.........#
#.........#
d.........#
#.........#
#.#.....#.#
#..#...#..#
#.........#
###########

