2
5
#####D#####
#.........#
##.....#.##
#.........#
#..#.#.#..#
D.........D
#..#.#.#..#
#.........#
##.#.....##
#.........#
#####l#####

3
0
#####l#####
##.#......#
#.........#
#....#.#.##
#.........#
#..#.#.#..#
#.........#
##.#.....##
#.........#
#..#...#.##
###########
locked : 2

2
1
#####D#####
#.........#
#..#...#..#
#.#.....#.#
#.........#
D.........D
#.........#
#.......#.#
#......#..#
#......k..#
###########
key : 3

1
5
#####d#####
#.........#
#.........#
#....#.#.##
#.........#
D...#.#...D
#.........#
#..#.#.#.##
#.........#
#.#.....#.#
#####D#####

0
5
###########
#.........#
##.#......#
#.........#
#......#..#
#.........#
#....#.#..#
#.........#
##.#...#..#
#.........#
#####d#####

0
1
###########
#..#...#.##
#.........#
#..#...#.##
#.........#
#..#.#.#..D
#.........#
##.#.....##
#.........#
##.#...#.##
#####D#####

1
0
###########
#?........#
#.........#
#.........#
#..#......#
#..##@....D
#.###.....#
#.........#
#.........#
#.........#
#####D#####
sign Those who search shall find.

1
2
#####D#####
#k........#
#.........#
#.........#
#.........#
D.........l
#.........#
#.#.......#
#..#......#
#.........#
#####l#####
key : 2

3
5
#####l#####
#.........#
#.........#
#.##......#
#..###....#
#..##e....#
#.####....#
#.##......#
#.###.#...#
#.........#
#####D#####
locked : 1
boss
enemies 1

2
6
#####D#####
#..#......#
#.........#
#.........#
#...#..#..#
D.........#
#.........#
#........##
#........e#
#........e#
###########
enemies 2
door 0 : 0

2
2
#####l#####
#.#.......#
#.........#
#..#.....##
#.........#
D...#.#...#
#.........#
#..#...#..#
#.........#
#.#.......#
###########
locked : 0

1
3
###########
#.........#
#..#......#
#.#.......#
#.........#
l.........d
#.........#
#.......#.#
#......#..#
#.........#
###########
locked : 3

2
4
#####d#####
#.........#
#.........#
#.........#
#.##.p....#
#.....#...D
#.##..##..#
#...p.###.#
#.........#
#.........#
###########

1
1
#####D#####
###.......#
#k#.......#
#.#.#.....#
#...##....#
D.........D
#..#......#
#.##......#
#.###.....#
#.........#
#####D#####
key : 0

1
6
###########
#......e###
#.......e##
#....###.s#
#......##.#
D....#.#..#
#.........#
#.........#
#.........#
#.........#
#####D#####
enemies 2
switch 0 : 0

4
5
#####D#####
#.........#
#.........#
#.###.....#
#...#.....#
#...##....#
#...#.#...#
#.........#
#.........#
#X........#
###########

1
4
###########
#.#.....#.#
#.........#
#.#.#.#.#.#
#.........#
d...#.#...D
#.........#
#.#.#...#.#
#.........#
#.#.......#
#####d#####

2
0
#####D#####
#.........#
#.........#
#.........#
#.........#
#k...#....D
#.........#
#.........#
#.........#
#.........#
#####l#####
key : 1

0
2
###########
#.........#
#.........#
#......#..#
#....###..#
D......#..#
#.........#
#.........#
#.........#
#.........#
#####D#####

