3
1
#####D#####
#.#.....#.#
#.........#
#.#.#.....#
#.........#
D...#.....D
#.........#
#.#.#.#...#
#.........#
#.#.....#.#
###########

5
2
#####d#####
#.........#
#.........#
#..#.....##
#.........#
#.........#
#..#......#
#.........#
#.........#
#..#.....##
###########

1
3
#####D#####
#.........#
#..#......#
#.#.......#
#.........#
D.........D
#.........#
#.......#.#
#......#..#
#.........#
#####l#####
locked : 0

1
2
###########
#.........#
#.........#
#.........#
#......#..#
D.....#...D
#.........#
#.......#.#
#......#..#
#.........#
#####D#####

0
3
###########
#e?......e#
#e#.#.#.#.#
#.........#
#..#......#
#.........#
#...#.#...#
#.........#
#..#...#..#
#.........#
#####D#####
enemies 3
door 0 : 0
sign Turn back; you are not yet ready.

2
1
#####D#####
#.........#
#..#......#
#.#.......#
#.........#
D.........D
#.........#
#..#......#
#.........#
#.........#
#####D#####

4
2
#####d#####
#.........#
#..#......#
#.#.......#
#.........#
#.........D
#.......#.#
#.#.....#.#
#.....##..#
#.........#
#####d#####

3
2
#####d#####
#.......#.#
#.........#
#.....#.#.#
#.....#.#.#
D.....#...D
#.........#
#.........#
#.......#.#
#.........#
#####d#####

3
3
#####D#####
#......#..#
#.....##p.#
#....##e#.#
#..###..#s#
D..###.#e.#
#...##.e#.#
#....#.##.#
#.........#
#.........#
#####D#####
enemies 3
switch 0 : 0

2
0
###########
#.........#
###.......#
#.#.......#
#.##......#
#....@....D
#.........#
#.........#
#.........#
#.........#
#####D#####

2
4
#####D#####
#.........#
##.#...#.##
#.........#
#.#.#.#.#.#
D.........l
#..#.#.#..#
#.........#
#...#.#.#.#
#.........#
###########

4
3
#####D#####
#.........#
#..#.....##
#.........#
#.........#
D...#..#..#
#.........#
#.........#
#.....#..##
#........k#
###########
key : 7

1
4
###########
#........k#
#.........#
#.........#
#.#.......#
D..##.....#
#..#......#
#...#.....#
##.#......#
#.........#
#####D#####
key : 9

2
2
#####D#####
#k#.......#
#.........#
#..#.#.#.##
#.........#
D...#.#...d
#.........#
#..#.#.#..#
#.........#
#.#.....#.#
#####d#####
key : 1

1
1
###########
#.#.......#
#.........#
#.#.#.#.#.#
#.........#
#.....#...D
#.........#
#...#.#.#.#
#.........#
#.........#
#####D#####

2
5
###########
#.........#
#.........#
#...##....#
#.........#
l....e....#
#.........#
#.........#
#.........#
#..#......#
#####D#####
locked : 7
boss
enemies 1

3
0
#####D#####
#.........#
#.........#
#.........#
#....#....#
#..#.#....D
#.###.....#
#.###.....#
#.###.....#
#k........#
###########
key : 0

3
5
#####D#####
#.........#
#.........#
#.........#
#.........#
#.........#
#.........#
#.........#
#.........#
#X........#
###########

2
3
#####l#####
#.........#
#.........#
#.........#
#.#.......#
d.........D
#.........#
#.....#...#
#.......#.#
#.........#
#####D#####

