4
1
#####.#####
#.##......#
#.#.#.....#
#.........#
#....#....#
#.........#
#.........#
#.........#
#.........#
#.........#
###########

2
4
#####.#####
#.........#
#..#...#..#
#.#.....#k#
#.........#
..........#
#.........#
#.........#
#.........#
#.........#
#####.#####
key : 3

5
3
#####l#####
#.........#
#......#..#
#.........#
#...e.....#
#...##....#
#.#.#.....#
#.....#...#
#.#.#.#...#
#.#.......#
#####.#####
locked : 3
boss
enemies 1

4
3
#####d#####
#.........#
#.........#
#....#.#..#
#...#.##..#
#...#..#..#
#......##.#
#...#..#.##
#.........#
#.........#
#####l#####

2
2
#####.#####
#.........#
#.........#
##.#......#
#.##......#
......#....
#......#..#
#.....##..#
#.....#..##
#.......###
#####.#####

1
3
###########
#.#.......#
#.........#
#..#.#.#.##
#.........#
......#...l
#.........#
#..#...#.##
#.........#
#.......#.#
#####d#####

0
0
###########
#k........#
#.........#
#.........#
#.........#
#..........
#.........#
#.........#
#.........#
#.........#
#####.#####
key : 0

1
2
###########
#.........#
#.........#
#..#..#..##
#.........#
...........
#...#..#..#
#.........#
#.........#
#........##
#####.#####

3
2
#####.#####
#.........#
#......#.##
#.........#
#.#.#.#.#.#
...........
#..#...#..#
#.........#
#.#...#...#
#.........#
###########

1
1
#####.#####
#e.......e#
#?........#
##.....#..#
#.........#
...........
#......#..#
#.........#
#.........#
##.....#.e#
#####l#####
enemies 3
sign Turn back; you are not yet ready.

3
3
#####d#####
#.........#
#.........#
#.........#
#.........#
..........d
#.........#
#.#.......#
#..#......#
#.........#
#####d#####

2
1
#####l#####
#.........#
#......#..#
##......#.#
#.........#
#..........
#.........#
#.#.......#
#..#......#
#.........#
#####.#####
locked : 0

1
4
###########
#.........#
#.........#
#.........#
#.........#
l.........#
#.........#
#.........#
#.........#
#.........#
#####.#####
locked : 2

6
3
#####.#####
#.........#
#.........#
#.........#
#.........#
#.........#
#.........#
#.........#
#.........#
#X........#
###########

3
1
#####.#####
#e.......e#
#..#..#..##
#.........#
#?........#
#e.#..#....
#.........#
#.........#
#..#..#...#
#.........#
#####.#####
enemies 3
sign Only the prepared may pass.

2
3
#####d#####
#k........#
#.........#
#.........#
#.........#
...........
#.........#
#.#.......#
#..#......#
#.........#
#####d#####
key : 2

3
4
#####.#####
#.........#
#.........#
#..#......#
#.........#
d...#.....#
#..#......#
####......#
#####.....#
#.........#
###########

1
0
#####.#####
#.........#
#.#.......#
#.........#
#.........#
#....@.....
#.........#
#.........#
#.....#...#
#?........#
###########
sign A useful tool lies just ahead.

0
1
###########
#.......k##
#...#.#...#
#...#..##.#
#....###..#
....####..#
#......##.#
#.........#
#.........#
#.........#
#####.#####
key : 1

