5
3
#####.#####
#.........#
#..#......#
#.#.......#
#.........#
#.........#
#.........#
#.........#
#.........#
#k........#
###########
key : 2

3
4
###########
#.........#
#.........#
#.........#
#.#.#.....#
d.........#
#..##.....#
#.##......#
#.........#
#.........#
#####.#####

4
2
#####.#####
#.........#
#.........#
#.........#
#.####.#..#
...........
#...#.....#
##?##..#..#
#####..#..#
#e..e.....#
###########
enemies 2
door 0 : 0
sign Something glints behind that door…

3
2
#####l#####
#k........#
#.........#
#.........#
#.........#
...........
#...#.....#
#.........#
#.........#
#.........#
#####.#####
key : 1

2
0
###########
#.........#
#.........#
#.....#####
#...#..##.#
#...@##....
#...#.....#
#...#.#...#
#.........#
#.........#
#####.#####

4
1
#####.#####
#........e#
#..#..#..##
#.........#
#.........#
...#..#....
#.........#
#.........#
#.....#..##
#.....e..s#
###########
enemies 2
switch 0 : 0

2
2
###########
#.........#
#......#..#
#.......#.#
#.........#
...........
#.........#
#.........#
#.........#
#.........#
#####l#####
locked : 1

1
3
#####.#####
#.........#
#.........#
#.........#
#.........#
#....e....#
#.........#
#.........#
#.........#
#.........#
#####d#####
boss
enemies 1

1
1
###########
#.........#
#.........#
#.........#
#.........#
#.........#
#.........#
#.#.....#.#
#..#...#..#
#.........#
#####.#####

3
0
#####.#####
#.........#
#.........#
#.........#
#.........#
#..........
#.........#
#.#.....#.#
#..#...#..#
#.........#
#####.#####

0
3
###########
#X........#
#.........#
#......#..#
#.....#...#
#....##...#
#.........#
#.........#
#.........#
#.........#
#####.#####

4
0
#####.#####
#.........#
#......#..#
#.......#.#
#.........#
#..........
#.........#
#.#.......#
#..#......#
#.........#
#####.#####

4
4
#####.#####
#.........#
#..#......#
#.#.......#
#.........#
..........#
#....#....#
#.........#
#..#..#...#
#........k#
###########
key : 3

4
3
#####d#####
#.........#
#.........#
#.........#
#.........#
...........
#.........#
#.........#
#.........#
#.........#
#####.#####

2
1
#####.#####
#.........#
#..#...#.##
#.........#
#...#...#.#
...........
#....#.#..#
#.........#
#...#.#...#
#.........#
#####l#####
locked : 0

3
1
#####l#####
#k........#
#......#..#
#.......#.#
#.........#
...........
#.........#
#.........#
#.........#
#.........#
#####.#####
key : 0

5
0
#####.#####
#.........#
#.........#
#.........#
#.........#
#.........#
#.........#
#.#.....#.#
#..#...#..#
#.........#
###########

3
3
#####d#####
#.........#
#.........#
#.........#
#.........#
..........d
#.........#
#.#.....#.#
#..#...#..#
#.........#
#####d#####

2
3
#####d#####
#.........#
#.........#
#....#..#.#
#.........#
..........#
#..#..#...#
#.........#
#.........#
#.#.....#.#
#####d#####

