1
3
#####D#####
#.........#
#.........#
#.........#
#.........#
#....e....#
#.........#
#.........#
#.........#
#.........#
#####l#####
locked : 2
boss
enemies 1

4
3
#####D#####
#.........#
#.........#
#.........#
#.........#
D.........#
#.........#
#.......#.#
#......#..#
#.........#
###########

0
3
###########
#X........#
#..##.....#
#..#####..#
#..###....#
#..###....#
#...####..#
#.........#
#.........#
#.........#
#####D#####

3
3
#####D#####
#.........#
#.........#
#.........#
#.....#...#
D...#.##..d
#.#k#..#..#
#..#......#
#.........#
#.........#
#####D#####
key : 4

3
2
###########
#.........#
#..#......#
#.#.......#
#.........#
D.........D
#.........#
#.......#.#
#......#..#
#........##
#####l#####
locked : 1

3
4
###########
#.........#
#.........#
#.........#
#..#..#...#
d.........#
#.........#
#........##
#.........#
#.........#
###########

5
2
#####D#####
#.........#
#.###.....#
#...##....#
#..##.#...#
D.........#
#.##.##...#
#.........#
#.........#
#.........#
#####D#####

4
2
#####l#####
#.........#
#.........#
#.........#
#.........#
D.........D
#.........#
#.........#
#.........#
#.........#
#####D#####

2
3
#####l#####
#k#.....#.#
#.........#
#..#.#.#.##
#.........#
#...#.#...#
#.........#
#....#...##
#.........#
#.#.....#.#
#####D#####
key : 5

5
0
###########
#..#......#
#..##.....#
##.##.....#
#.........#
#....@....D
#.........#
#.........#
#.........#
#.........#
#####D#####

6
3
###########
#.........#
#.........#
#.........#
#.........#
d.........#
#.........#
#.#.....#.#
#..#...#..#
#.........#
###########

8
1
#####d#####
#.........#
#.........#
#.........#
#.........#
#.........#
#.........#
#.........#
#.........#
#.........#
###########

3
1
###########
#.........#
#.........#
#.........#
#.........#
#.........D
#.........#
#.........#
#.........#
#.........#
#####D#####

7
1
#####D#####
#k.#......#
##.#......#
#.........#
#.........#
#.........#
#.........#
#.........#
#.........#
#.........#
#####d#####
key : 2

5
1
#####D#####
#.........#
#...#...#.#
#...##....#
#.....##..#
D...#.#...D
#...#.....#
#.........#
#.........#
#.........#
#####d#####

6
1
#####d#####
#.........#
#.........#
#.........#
#.........#
D.........D
#.........#
#.........#
#.........#
#.........#
#####D#####

4
1
#####D#####
#.........#
#.###.....#
#####.....#
#...#.....#
#..#......D
#.........#
#.........#
#.........#
#.........#
#####D#####

6
2
#####D#####
#.........#
#......#..#
#.........#
#.#.#.#.#.#
D.........d
#....#....#
#.........#
#.#...#.#.#
#.....k...#
###########
key : 1

6
0
#####D#####
#......#.##
#.........#
##.#.#...##
#.........#
#..#.#.#..D
#.........#
##.#.....##
#e........#
#e.#...#.##
###########
enemies 2

