3
1
#####D#####
#.#.....#.#
#.........#
#.#.#.#...#
#.........#
D...#.#...d
#.........#
#.#.#.#.#.#
#.........#
#.#.....#.#
#####l#####

0
3
###########
#e.......e#
#?#.#...#.#
#.........#
#.#...#.#.#
#.........#
#.#.#.#.#.#
#.........#
#.#.#.....#
#.........#
#####D#####
enemies 2
sign A useful tool lies just ahead.

3
5
###########
#........k#
#.........#
#.........#
#.........#
D.........#
#.........#
#.........#
#.........#
#.........#
###########
key : 4

2
3
#####D#####
##e#...#e##
#.........#
#...#.....#
#.........#
D....#.#..D
#.........#
#.#.......#
#.........#
#......#?##
#####D#####
enemies 2
sign A useful tool lies just ahead.

2
0
#####D#####
#.........#
#.#.....#.#
#.........#
#.........#
#..#..#...d
#.........#
#.........#
#.#.....#.#
#.........#
#####D#####

1
0
###########
#k........#
#.........#
#.........#
#.........#
#...#.....#
#.###.....#
#.........#
#.........#
#.........#
#####D#####
key : 0

2
2
###########
##e#e.....#
##.#......#
#..#e.....#
#.###.....#
D..#......D
#.........#
#.........#
#.........#
#.........#
#####D#####
enemies 3

4
4
#####D#####
#.........#
#.........#
#.........#
#.#.......#
D.........#
#.........#
##.....#..#
#.........#
#........k#
###########
key : 5

2
1
###########
#.........#
#.......#.#
#.........#
#.........#
d..#..#...D
#.........#
#.........#
#.#.....#.#
#.........#
#####D#####

4
2
#####d#####
#..#...#.##
#.........#
#...#.#.#.#
#.........#
D..#...#..D
#.........#
#.#...#.#.#
#.........#
##.#...#.##
###########

3
4
#####d#####
##e.......#
#####.....#
#.###.....#
#.#.#.....#
D.........D
#.........#
#.........#
#.........#
#.........#
#####D#####
enemies 1

4
3
#####D#####
#.........#
##.....#.##
#.........#
#..#...#..#
D.........D
#......#..#
#.........#
##.#...#..#
#.........#
###########

3
0
#####D#####
#.........#
#.........#
#.........#
#.........#
#....@....D
#.........#
#.........#
#.........#
#?........#
###########
sign The dungeon remembers all who enter.

3
3
#####D#####
#.........#
#......#..#
#..#####..#
#..#......#
D...#.....D
#.........#
#####.....#
#.........#
#.........#
#####D#####

1
3
#####D#####
##........#
#.........#
#.........#
#...#..#..#
#.........D
#k........#
##..#.....#
#.........#
#.........#
#####D#####
key : 6

3
2
#####D#####
#.........#
#......#..#
#.......#.#
#.........#
d.........D
#.........#
#.......#.#
#......#..#
#.........#
#####d#####

4
1
#####l#####
#.........#
#.........#
#.........#
#.........#
#.........D
#.........#
#.........#
#.........#
#.........#
###########
locked : 0

2
4
#####D#####
#.........#
#.........#
#.........#
#.........#
D....e....#
#.........#
#.........#
#.........#
#.........#
#####d#####
boss
enemies 1

1
4
###########
#........X#
#......#..#
##.#.##..##
#...##....#
D..##.....#
#.##.###..#
#.........#
#.........#
#.........#
#####D#####

