2
1
#####D#####
#..#.....##
#.........#
#.#.#.#.#.#
#.........#
D....#.#..D
#.........#
#.#.#.#.#.#
#.........#
##k#...#.##
#####D#####
key : 0

1
1
#####D#####
#k........#
#.....#...#
#.........#
#.#.#.#.#.#
D.........l
#.#.#.....#
#.........#
#.#.#.#...#
#.........#
#####D#####
key : 1

1
2
#####l#####
#.......#.#
#.........#
#.........#
#..#..#...#
l.........#
#.........#
#.#..#..#.#
#.........#
#.........#
#####D#####
locked : 1

2
4
#####d#####
#.........#
#..#......#
#.#.......#
#.........#
D.........d
#.........#
#.......#.#
#......#..#
#.........#
#####d#####

0
2
###########
#.........#
#..#....#.#
#.#.......#
#.........#
D.........#
#.........#
#.........#
#......#..#
#.........#
#####l#####
locked : 3

2
5
###########
#.........#
#.........#
#.........#
#.........#
d.........#
#.........#
#.........#
#.#.......#
#.........#
#####D#####

2
3
###########
#.........#
#.......#.#
#.........#
#.........#
d....#....D
#.........#
#.........#
#.#.......#
#.........#
#####D#####

3
4
#####d#####
#.........#
#.........#
#.........#
#.##.#....#
D..##e....D
#.###.....#
#.####....#
#..##.....#
#.........#
#####D#####
boss
enemies 1

3
5
#####D#####
#.........#
#.........#
#.........#
#.........#
D.........#
#.........#
#.........#
#.........#
#......e#e#
###########
enemies 2

3
0
#####D#####
#.........#
#.........#
#.........#
#.........#
#.........D
#.........#
#.#.....#.#
#..#...#..#
#.........#
#####D#####

3
3
#####D#####
#.........#
#.........#
#......##.#
#......#..#
#.........D
#.........#
#.........#
#.........#
#X........#
###########

0
1
###########
#k........#
#.##......#
#...#.....#
#.##.#....#
#.........D
#.........#
#.........#
#.........#
#.........#
#####D#####
key : 3

3
1
#####D#####
#.........#
#.........#
#.........#
#.........#
D.........#
#.........#
#.......#.#
#......#..#
#.........#
###########

4
0
#####D#####
#.........#
#.#...#.#.#
#.........#
#.#.#...#.#
#.........#
#.#.#.#.#.#
#.........#
#...#.#.#.#
#.........#
###########

2
2
#####D#####
#.........#
#......#..#
#.......#.#
#.........#
D.........d
#.........#
#.........#
#.........#
#.........#
###########

1
4
###########
#.........#
#......#..#
#.......#.#
#.........#
#.........#
#.........#
#.#.......#
#..#......#
#.........#
#####d#####

4
4
#####D#####
#.........#
#........##
#.#.......#
#.........#
#.........#
#.........#
#.......#.#
#......#..#
#k........#
###########
key : 4

2
0
#####l#####
#.........#
#.........#
#......#..#
#...@###..#
#....#?#..D
#.........#
#.........#
#.........#
#.........#
#####D#####
sign Only the prepared may pass.

1
0
###########
#.........#
#.........#
#.........#
#.........#
#.........D
#.....##..#
#....####.#
#......#..#
#.........#
#####l#####
locked : 0

