1
4
###########
#.........#
#......#..#
#.......#.#
#.........#
..........#
#.........#
#.......#.#
#......#..#
#.........#
#####.#####

3
5
###########
#........k#
#.........#
#..#......#
#.........#
..........#
#.........#
#.........#
#.........#
#.........#
###########
key : 7

2
4
#####.#####
#.........#
#.........#
#.........#
#.#.##....#
...##?....#
#.##e#....#
#..#......#
#.........#
#.........#
#####.#####
enemies 1
sign Those who search shall find.

3
2
#####d#####
#......##.#
#...#.#.#.#
#.#.....#.#
#..#####..#
...####....
#.##.#....#
#.........#
##........#
#.........#
###########

1
0
#####.#####
#.........#
#.........#
#.........#
#.........#
#....@.....
#.........#
#.........#
#.........#
#?........#
###########
sign What you seek is close.

1
2
#####.#####
#.........#
#.........#
#.........#
#.........#
l.........l
#.........#
#.........#
#.........#
#.........#
#####.#####
locked : 1

2
2
#####.#####
##.#...#.##
#.........#
#.#.#.#...#
#.........#
...#.#.#..d
#.........#
#.#.#.#...#
#.........#
##.#...#.##
#####d#####

0
2
###########
#.........#
#.........#
#...#.....#
#.........#
..........#
#....#....#
#.........#
#.........#
#.........#
#####.#####

3
1
#####d#####
#.........#
#..#...#..#
#.#.....#.#
#.........#
#..........
#.........#
#.........#
#.........#
#.........#
###########

0
1
###########
#.....e...#
#.#...#.#.#
#.........#
#..#.#.#..#
...........
#.#.#...#.#
#.........#
#..#.....##
#........?#
#####.#####
enemies 1
sign Those who search shall find.

1
3
###########
#.........#
#.........#
#.........#
#.........#
l....#.....
#..#..#.#.#
#.....#...#
#......##.#
#.........#
#####.#####
locked : 0

3
3
#####.#####
#.........#
#......##.#
#...###...#
#...#e#.#.#
......#....
#.........#
#.........#
#.........#
#....?....#
###########
enemies 1
sign The brave are rewarded.

3
4
#####.#####
#k........#
#.........#
#..#..#..##
#.........#
...........
#..#......#
#.........#
#.........#
#..#.....##
#####d#####
key : 5

2
1
#####.#####
#.........#
#..#......#
#k#.......#
#.........#
#..........
#.........#
#.#.....#.#
#..#...#..#
#.........#
#####d#####
key : 1

2
3
#####.#####
#.........#
#.........#
#......#..#
#.##......#
d..#.......
#.##......#
#.........#
#.........#
#.........#
#####.#####

1
1
#####.#####
#.........#
#.........#
#.........#
#.........#
..........l
#.........#
#.#.....#.#
#..#...#..#
#.........#
#####.#####

0
0
###########
#k........#
#......#..#
#.........#
#.........#
#...#..#...
#.........#
#.........#
##.....#..#
#.........#
#####.#####
key : 0

5
4
#####.#####
#.........#
#.##......#
#.....#...#
#.#.#.#...#
#....#....#
#....#.#..#
#....###..#
#.........#
#X........#
###########

4
4
#####d#####
#.........#
#.........#
#...###...#
#..#e#....#
#..#.##...#
#..#.##...#
#.##.##.#.#
#......#..#
#.........#
#####.#####
boss
enemies 1

