5
1
#####d#####
#.........#
#..#......#
#.#.......#
#.........#
...........
#.........#
#.#.......#
#..#......#
#.........#
#####.#####

2
2
###########
#........k#
#.##......#
#.##.#....#
#..#.#....#
..........#
#.........#
#.........#
##.....#..#
#.........#
#####.#####
key : 6

6
3
###########
#.........#
#.........#
#......#..#
#.........#
..........#
#...#..#..#
#.........#
#.........#
##.....#..#
###########

8
2
#####d#####
#........##
#.........#
#.#...#.#.#
#.........#
#..#.#....#
#.........#
#.#...#.#.#
#.........#
##.#...#..#
###########

3
1
#####.#####
#.........#
#.........#
#.#.......#
#e#e#.....#
#..##.....d
#e.#......#
#####.....#
#.........#
#.........#
#####.#####
enemies 3

0
1
###########
#X........#
#.........#
#.........#
#.........#
#...#.....#
#....#....#
#...#.....#
#.........#
#.........#
#####.#####

6
1
#####.#####
#.......e##
#.....#.#?#
#...#...#.#
#.....#.#.#
...........
#.........#
#.........#
#.........#
#.........#
#####.#####
enemies 1
door 0 : 0
sign Many have walked this path.

4
1
#####.#####
#.........#
#.........#
#.........#
#.........#
...........
#.........#
#.........#
#.....#...#
#.........#
#####d#####

4
0
###########
#e........#
#?........#
#.........#
#.........#
#..........
#.........#
#.........#
#.........#
#.........#
#####.#####
enemies 1
sign Many have walked this path.

7
2
#####.#####
#.........#
#..#...#..#
#.#.....#.#
#.........#
..........#
#.........#
#.#.......#
#..#......#
#.........#
#####d#####

3
2
#####.#####
#.........#
#.........#
##..#.....#
#.........#
d.........#
#...#..#..#
#.........#
#.........#
##.....#..#
#####.#####

2
1
#####d#####
#.........#
#.........#
#.........#
#.........#
#k.........
#.........#
#.........#
#.........#
#.........#
#####.#####
key : 4

5
0
#####.#####
#.........#
#.###.....#
#.###.....#
#..###....#
#...@#.....
#.........#
#.........#
#.........#
#.........#
#####.#####

6
0
#####.#####
#.........#
#.#...#...#
#.........#
#.#.#.#.#.#
#..........
#.#.#.#.#.#
#.........#
#s#.#.#...#
#e........#
###########
enemies 1
switch 0 : 0

6
2
#####.#####
#?........#
#.........#
#.........#
#.........#
...........
#.........#
#.#.......#
#..#......#
#.........#
#####.#####
sign The ceiling is higher than it looks.

7
1
#####.#####
#.........#
#..#......#
#.#.......#
#.........#
#..........
#.........#
#.......#.#
#......#..#
#.........#
###########

4
2
#####.#####
##.#...#.##
#........k#
##.#.#.#.##
#.........#
.....#.#..#
#.........#
##.#.#...##
#.........#
##.#.....##
#####.#####
key : 7

5
2
#####.#####
##.#...#.##
#........k#
##.#.#.#.##
#.........#
...#.#.#..#
#.........#
##.#.#.#..#
#.........#
#......#.##
#####.#####
key : 0

1
1
#####.#####
#.........#
#......##.#
#...#.....#
#...e.###.#
#....###..#
#....##...#
#....###..#
#.....###.#
#.........#
#####d#####
boss
enemies 1

