5
0
#####l#####
#.........#
#..#..#..##
#.........#
#.........#
#..#.......
#.........#
#.........#
#..#..#...#
#.........#
#####.#####
locked : 2

8
0
#####.#####
#.........#
#.........#
#.........#
#.........#
#..##.....#
#..##.....#
##.#......#
##........#
#X........#
###########

4
1
#####.#####
#k........#
#.........#
#.........#
#.#..#..#.#
..........d
#.........#
#.#..#....#
#.........#
#.........#
#####.#####
key : 2

1
1
###########
#.........#
#.........#
#....#....#
#.........#
..........#
#....#..#.#
#.........#
#.........#
#.#.......#
#####.#####

2
2
###########
#.........#
#..#...#..#
#.#.....#.#
#.........#
..........#
#.........#
#.#.......#
#..#......#
#.........#
#####.#####

3
0
#####.#####
#.........#
#.........#
#.........#
#.....#...#
#....@.....
#.........#
#.........#
#.........#
#?#.......#
#####.#####
sign What you seek is close.

5
1
#####.#####
#.........#
#.#.#.#.#.#
#.........#
#.#.#.#.#.#
...........
#...#.....#
#.........#
#.#.#.#.#.#
#.........#
###########

5
2
#####d#####
#.........#
#..#......#
#.........#
#.........#
...#..#...#
#.........#
#.........#
#..#..#..##
#.........#
###########

7
0
#####d#####
#.........#
#.........#
#.........#
#.........#
#....e....#
#.........#
#.........#
#.........#
#.........#
#####.#####
boss
enemies 1

4
0
#####.#####
#.........#
#..#..#...#
#.........#
#.........#
#..#..#....
#.........#
#.........#
#..#..#..##
#.........#
#####l#####

1
0
#####l#####
#.........#
#.........#
#.........#
#.........#
#k...#.....
#.....#...#
#.....##..#
#.........#
#.........#
#####.#####
key : 1

3
3
###########
#.#.....#.#
#.........#
#.........#
#....#..#.#
d.........#
#.........#
#.#..#..#.#
#.........#
#.........#
###########

2
1
#####.#####
##.#......#
#.........#
##.#.#...##
#.........#
.....#.#...
#.........#
##.#.#.#.##
#.........#
##.#.....##
#####.#####

3
1
#####.#####
#k........#
#.........#
#.........#
#.........#
..........l
#.........#
#.........#
#.........#
#.........#
#####.#####
key : 0

2
0
#####.#####
#..#.....##
#.........#
#.........#
#...#..#..#
#..........
#.........#
#..#..#..##
#.........#
#.........#
#####.#####

3
2
#####.#####
#.........#
#......#..#
#.......#.#
#.........#
l.........d
#.........#
#.........#
#.........#
#.........#
#####.#####
locked : 1

0
0
###########
#.........#
#..#......#
#.#.......#
#.........#
#.........#
#.........#
#.........#
#.........#
#.........#
#####l#####
locked : 0

4
2
#####.#####
#.........#
#.........#
#..#..#..##
#.........#
d.........#
#.........#
#.........#
#.........#
#........##
#####d#####

6
0
#####.#####
#.........#
#.........#
#.........#
#...#.....#
#k........#
#.........#
#.........#
#.........#
#.........#
#####d#####
key : 3

