7
0
#####D#####
#.........#
#.........#
#.........#
#.........#
#.........#
#.#.......#
##.#......#
##.#......#
#k........#
###########
key : 1

4
0
#####d#####
#.........#
#..#......#
#.#.......#
#......#..#
#.........D
#..#......#
#.........#
#......#..#
#.........#
#####D#####

4
1
#####D#####
#.........#
#.........#
#....##...#
#...##.#..#
D..##..#..D
#...#.#...#
#.........#
#.........#
#.........#
###########

3
0
#####d#####
#.........#
#.........#
#.........#
#...##....#
#...#.....l
#.####....#
#.###.....#
#.........#
#.........#
#####d#####

3
2
#####D#####
#e........#
#.........#
#.........#
#.........#
D....?##..D
#....####.#
#....###e##
#.....#...#
#e........#
#####d#####
enemies 3
door 0 : 0
sign Turn back; you are not yet ready.

2
1
#####D#####
#k........#
#.........#
#..#.....##
#.........#
D.........d
#...#..#..#
#.........#
#.........#
#..#.....##
#####D#####
key : 3

1
1
###########
#.........#
#..#......#
#.#.......#
#.........#
D.........D
#.........#
#.......#.#
#......#..#
#.........#
#####D#####

5
2
#####D#####
#.......#.#
#......##.#
#....#..#.#
#...##.#..#
#.........#
#.........#
#.........#
#.........#
#X........#
###########

1
0
#####D#####
#e#......##
#..##.#...#
#.#####...#
#s#e##....#
#...#.#...D
#.........#
#.........#
#.........#
#.........#
#####D#####
enemies 2
switch 0 : 0

0
0
###########
#.........#
#.........#
#.........#
#.........#
#.........#
#..##.....#
###.......#
#.........#
##........#
#####D#####

3
3
#####D#####
#.........#
#.........#
#..#..#...#
#.........#
D.........#
#...#.....#
#.........#
#.........#
#........##
###########

1
2
###########
#........k#
#.........#
#.........#
#.........#
D.........#
#.........#
#.........#
#.........#
#.........#
#####D#####
key : 7

5
0
#####D#####
#.........#
#.........#
#.........#
#.........#
#?.p.@....#
#.........#
#.........#
#.........#
#.........#
#####D#####
sign Something glints behind that door…

4
2
#####d#####
#.........#
#.##..#.#.#
###...##..#
#.#.....#.#
D....e....#
#.........#
#.........#
#.........#
#.........#
#####D#####
boss
enemies 1

2
3
###########
#.........#
#.........#
#.........#
#.........#
D.........#
#.........#
#.........#
#.........#
#.........#
#####D#####

3
1
#####D#####
#.........#
##..#..#..#
#.........#
#.........#
l...#..#..D
#.........#
#.........#
##........#
#.........#
#####D#####
locked : 0

2
2
#####D#####
#.........#
#..#......#
#.#.......#
#.........#
d.........D
#.........#
#.......#.#
#......#..#
#.........#
#####D#####

2
0
#####D#####
#.........#
#.#.....#.#
#.........#
#.........#
#.....#...D
#.........#
#.........#
#.#.....#.#
#.........#
#####d#####

6
0
#####D#####
#.........#
#.........#
#.........#
#.........#
#.........#
#k#.#.....#
#.#.......#
#.##......#
#.........#
#####D#####
key : 0

