6
1
#####.#####
#.........#
#.........#
##...#....#
#.##.#....#
#..###.....
#.#.##....#
#.#.......#
#.........#
#X........#
###########

0
0
###########
##.#...#.##
#.........#
#.#...#.#.#
#.........#
#....#.#...
#.........#
#.#.#.#...#
#.........#
##.#.....##
#####d#####

3
0
#####d#####
#.........#
#.........#
#.........#
#...#####.#
#..........
#...##....#
#...#.#.#.#
#.....##..#
#.........#
###########

4
1
#####.#####
#.........#
#.........#
#.....##..#
#.....##..#
#e.........
#.........#
#.........#
#.........#
#.........#
#####.#####
enemies 1

2
0
#####.#####
#.#.......#
#.........#
#.#.#.#...#
#.........#
#...#.#....
#.........#
#.#.#.....#
#.........#
#.#.......#
#####d#####

3
2
#####.#####
#k........#
#.........#
#.........#
#.........#
...........
#.........#
#.........#
#.........#
#.........#
#####l#####
key : 2

3
3
###########
#.........#
#..#...#..#
#.#.....#.#
#.........#
..........#
#..#......#
#.........#
##.....#..#
#.........#
###########

0
1
###########
#........k#
#.........#
#.........#
#.........#
..........#
#.........#
#.........#
#.........#
#.........#
#####.#####
key : 1

2
1
#####.#####
#........k#
#..#.....##
#.#.......#
#.......#.#
..........l
#.........#
#.......#.#
#......#..#
#......#..#
#####l#####
key : 0

4
2
#####l#####
#..#.....##
#.........#
#.........#
#..#..#...#
..........#
#.........#
#..#......#
#.........#
#.........#
#####.#####
locked : 2

7
2
#####.#####
#.........#
#..##..#..#
#.#.....#.#
#.........#
#.........#
#.........#
#........##
##........#
#k........#
###########
key : 6

5
1
#####.#####
#.........#
#......#..#
#.......###
#....#....#
#.........d
#.........#
#.#.......#
#..#......#
#.........#
#####.#####

1
1
#####.#####
##.......##
#.........#
##.#.#.#.##
#.........#
...#.#.#..#
#.........#
##.#.#.#.##
#.........#
#..#...#..#
#####.#####

2
2
###########
#.........#
#.....#...#
#.........#
#.........#
l...#.....#
#.........#
#.........#
#..#..#..##
#.........#
#####.#####
locked : 1

6
2
#####d#####
#.........#
#.........#
##.#......#
#.##......#
.....e.....
#.........#
#.........#
#.........#
#.........#
#####.#####
boss
enemies 1

1
0
#####d#####
#.........#
#.....#...#
#.........#
#.........#
#....@.....
#.........#
#.........#
#.........#
#.........#
#####.#####

6
3
###########
#.....e#.e#
#.....##..#
#...###.#.#
#...#...#.#
..........#
#.........#
#.........#
#.........#
#........?#
###########
enemies 2
sign Many have walked this path.

3
1
#####l#####
#.........#
#......#..#
#.......#.#
#.........#
...........
#.........#
#.......#.#
#......#..#
#.........#
#####.#####
locked : 0

5
2
#####.#####
#.#.....#.#
#.........#
#.#.#...#.#
#.........#
d...#.....#
#.........#
#.....#.#.#
#.........#
#.#.....#.#
#####d#####

