0
1
###########
#.........#
#.#...#...#
#.........#
#....#.#..#
D.........#
#.#.#.#.#.#
#.........#
#..#......#
#.........#
#####D#####

2
5
###########
#.........#
#..#...#..#
#.#.....#.#
#.........#
d.........#
#.........#
#.#.....#.#
#..#...#..#
#.........#
###########

2
2
###########
##k#...#..#
#.........#
#.#.#.....#
#.........#
D.........D
#.........#
#.#.#.#.#.#
#.........#
#......#..#
#####D#####
key : 0

2
0
#####D#####
#.........#
#.........#
#.........#
#.........#
#?...@....d
#.........#
#......#..#
#.....#...#
#.........#
#####D#####
sign The dungeon remembers all who enter.

3
3
#####l#####
#.........#
#.........#
#.........#
#.........#
D.........l
#.........#
#.........#
#.........#
#.......#.#
#####D#####
locked : 1

4
4
#####D#####
#.........#
###.#.....#
##..p.....#
#.###.....#
D.........#
#.........#
#.........#
#.........#
#........X#
###########

4
3
#####D#####
#.........#
#.#.....#.#
#.........#
#.........#
#....#....D
#.........#
#.........#
#.#.......#
#k........#
###########
key : 3

1
3
#####D#####
#.#.....#.#
#.........#
#.#.#.#.#.#
#.........#
#.....#...#
#.........#
#.#...#...#
#.........#
#.#.......#
#####l#####
locked : 0

0
3
###########
#k........#
#..#......#
#.#.......#
#.........#
#.........#
#.#.......#
#.........#
#.........#
#.........#
#####D#####
key : 2

0
0
###########
#.........#
##........#
#.........#
#.........#
#....#....D
#.........#
#.........#
##.....#..#
#.........#
#####D#####

2
1
#####d#####
#.........#
#..#......#
#.#.......#
#.........#
d.........D
#.........#
#.........#
#.........#
#.........#
#####d#####

3
4
#####D#####
#.........#
#.........#
#.........#
#.........#
l....e....#
#..#......#
#...#.....#
#.##......#
#.........#
#####D#####
locked : 3
boss
enemies 1

3
2
#####D#####
#.#.......#
#.........#
#.........#
#.#..#..#.#
D.........D
#.........#
#....#..#.#
#.........#
#.........#
###########

3
0
#####D#####
#.........#
#..#......#
#.#.#.....#
#.........#
#......#..D
#.........#
#.........#
#.........#
#.#.......#
###########

2
3
#####l#####
#.........#
#.........#
#.........#
#.#k#.....#
D..##.....D
#.#.......#
#.........#
#.........#
#.........#
#####l#####
key : 1

1
0
#####D#####
#.........#
##.......##
#.........#
#..#.#.#..#
#.........D
#..#.#....#
#.........#
##.#.....##
#.........#
#####D#####

2
4
###########
#...e.?...#
#.#.#e#.#.#
#.........#
#.#...#.#.#
D.........d
#.#.#...#.#
#.........#
#.....#.#.#
#.........#
#####D#####
enemies 2
sign This door will not yield without a key.

1
1
#####D#####
#.........#
#.#.#.....#
#.#.#.....#
#.#.......#
D.........#
#.........#
#.........#
#.........#
#.........#
#####d#####

3
1
#####d#####
#..#.....##
#.........#
#..#......#
#.........#
D..#...#..D
#.........#
##...#.#.##
#.........#
##.#...#..#
###########

