5
3
#####.#####
#.........#
#.........#
#.........#
#....#.##.#
#.....##..#
#......##.#
#....####.#
#...#.###.#
#X........#
###########

1
3
###########
#..#......#
#.........#
#.........#
#...#..#..#
..........#
#.........#
#..#..#...#
#.........#
#.........#
#####l#####
locked : 2

6
0
#####.#####
#.........#
##.....#..#
#.........#
#.........#
#....#....#
#.........#
#.........#
##..#..#..#
#.........#
###########

3
3
#####d#####
#.........#
#......#..#
#.......#.#
#.........#
..........#
#......##.#
#.......#.#
#......#..#
#.........#
#####l#####

3
1
#####.#####
#.........#
#.........#
#.........#
#.........#
...........
#.........#
#.......#.#
#......#..#
#.........#
#####.#####

0
2
###########
#k........#
#.........#
#.........#
#.........#
#...##.#..#
#.##.#....#
#..#..#...#
#..##.....#
#.........#
#####.#####
key : 3

2
0
#####l#####
#.........#
#.........#
#.........#
#.........#
#.........d
#.........#
#.........#
#.........#
#.........#
#####.#####

4
1
#####.#####
#.........#
#.........#
#..#..#..##
#.........#
..........#
#..#......#
#.........#
#.........#
#..#.....##
###########

4
3
#####l#####
#.........#
#.........#
#.........#
#.........#
#....e....#
#.........#
#.........#
#..#......#
#.........#
#####.#####
locked : 3
boss
enemies 1

1
0
###########
#.........#
#.#.....#.#
#.........#
#.........#
#..#..#...#
#.........#
#.........#
#.#.....#.#
#.........#
#####l#####
locked : 0

3
0
#####.#####
#.........#
#.......#.#
#.#.##....#
#?###.#...#
#....@#....
#.........#
#.........#
#.........#
#.........#
#####.#####
sign The brave are rewarded.

1
2
#####.#####
#........e#
#..#..#..##
#.........#
#.........#
#..#..#....
#.........#
#.........#
#..#.....##
#........?#
#####.#####
enemies 1
sign This door will not yield without a key.

3
2
#####.#####
#.........#
#.........#
###.......#
#.#.......#
....#..#...
#.#...#...#
##k#....#.#
#.........#
#.........#
###########
key : 2

2
3
#####l#####
#.........#
##..#..#..#
#.........#
#.........#
l.........d
#.........#
#.........#
#...#..#..#
#.........#
#####d#####
locked : 1

2
2
#####.#####
#k........#
#.......#.#
#.........#
#.........#
...#...#..l
#.........#
#.........#
#.........#
#.........#
#####.#####
key : 1

2
1
###########
#.........#
#.........#
#.........#
#.........#
d..........
#.........#
#.......#.#
#......#..#
#.........#
#####.#####

2
4
###########
#.........#
#.........#
#.....#...#
#.........#
d.........#
#..#..#...#
#.........#
#.........#
#........##
###########

4
0
#####.#####
#.........#
#...#.....#
#...#.....#
#.........#
#k.........
#.........#
#.......###
#......#..#
#.........#
#####d#####
key : 0

5
0
#####d#####
#.........#
#.........#
#.........#
#.........#
#.........#
#.........#
#.........#
#.........#
#.........#
#####.#####

