0
0
###########
#es.....?e#
#e........#
#.........#
#.........#
#..#..#...#
#.........#
#.........#
#.#.......#
#.........#
#####.#####
enemies 3
switch 0 : 0 1
sign Beware what lurks ahead.

3
0
#####.#####
#..#......#
#...#.....#
#.........#
#.........#
#....@.....
#.........#
#.........#
#.........#
#?........#
###########
sign The brave are rewarded.

3
2
#####.#####
#.........#
#.........#
#..##..#..#
#..#e.#...#
...#.#.#...
#....#....#
#..##.....#
#.........#
#.........#
#####l#####
locked : 3
boss
enemies 1

4
3
#####.#####
#e.......?#
#.........#
#.........#
#.........#
.........e#
#.........#
#.........#
#.........#
#e........#
#####.#####
enemies 3
sign The brave are rewarded.

1
0
#####.#####
#.........#
#.........#
#.........#
#.........#
#..........
#.........#
#.#.....#.#
#..#...#..#
#.........#
#####d#####

3
3
###########
#......#X##
#.....#...#
#....##.#.#
#.....#.#.#
..........#
#..#.#....#
#...##....#
#..##.....#
#.........#
#####.#####

5
3
#####.#####
#.........#
#.........#
#.........#
#.........#
..........#
#.........#
#.........#
#.........#
#........k#
###########
key : 3

5
2
#####.#####
#.........#
#.........#
#.........#
#.........#
d..........
#.........#
#.#.......#
#..#....#.#
#.........#
#####d#####

2
0
#####d#####
#.........#
#.........#
#.........#
#.........#
#..........
#.........#
#.........#
#.........#
#.........#
#####.#####

3
1
#####.#####
#k........#
#.........#
#.........#
#.........#
....#......
#.........#
####......#
#####.....#
####......#
#####.#####
key : 0

6
2
#####d#####
#.........#
##.#.....##
#.........#
#......#..#
..........#
#..#.#.#..#
#.........#
##.....#.##
#.........#
###########

2
1
#####.#####
#.#.....#.#
#.........#
#.........#
#..#......#
..........l
#.........#
#.#..#..#.#
#.........#
#.........#
#####.#####

5
1
#####d#####
#.........#
#.........#
#.........#
#.........#
#.........d
#.........#
#.........#
#.........#
#.........#
#####.#####

4
2
#####l#####
#e........#
#.........#
#.....#...#
#....#e#..#
.......#...
#.....#e#.#
#.........#
#.........#
#.........#
#####.#####
enemies 3
door 0 : 0 1

1
1
###########
#.........#
#.........#
#.#.......#
#.........#
...........
#..#..#...#
#.........#
#.........#
#.......#.#
#####.#####

4
1
#####.#####
#.........#
#.........#
#...#.....#
#.........#
#k.........
#.........#
#.........#
#.........#
#.........#
#####d#####
key : 1

6
1
#####.#####
#.........#
#.........#
#.........#
#.........#
#..........
#.........#
#.........#
#.........#
#k........#
###########
key : 2

1
2
###########
#.........#
#......#..#
#.......#.#
#.........#
..........#
#.........#
#.........#
#.........#
#.........#
#####.#####

2
2
#####.#####
#.........#
#..#.....##
#.........#
#.........#
l......#..#
#.........#
#.........#
#..#..#..##
#.........#
#####.#####
locked : 0

