1
1
#####.#####
#.........#
#.........#
#.........#
#...##....#
....#.....#
#.#...###.#
#...#.###.#
###.#.#.#.#
#k........#
#####.#####
key : 2

0
1
###########
#?.......e#
#.....#####
#.....#.#s#
#.........#
#..#.##...#
#.##.##.#.#
###.......#
#.........#
#.........#
#####.#####
enemies 1
switch 0 : 0
sign What you seek is close.

4
2
#####.#####
#.........#
#......#..#
#.......#.#
#.........#
l.........#
#.........#
#.#.......#
#..#......#
#.........#
#####.#####
locked : 5

3
1
#####.#####
#.........#
#.........#
#..#.....##
#.........#
d..........
#.....#...#
#.........#
#.........#
#..#.....##
#####.#####

5
2
#####.#####
#?#.....#.#
#.........#
#..#.#.#.##
#.........#
....#.....#
#.........#
#..#.#.#..#
#........e#
#.#....e#e#
###########
enemies 3
door 0 : 0
sign A locked path — look elsewhere first.

4
1
#####.#####
#.........#
#..#......#
#.#.......#
#.........#
..........l
#.........#
#.....#k#.#
#......#..#
#.........#
#####d#####
key : 5

3
3
###########
#.........#
#..##.....#
#.#.##.#..#
#...###...#
l..#..#...#
#.........#
#.........#
##........#
#.........#
###########
locked : 2

1
0
###########
#k........#
#.........#
#.........#
#.........#
#..........
#.........#
#.#.....#.#
#..#......#
#.........#
#####.#####
key : 0

8
1
#####.#####
#.........#
#.........#
#.........#
#.........#
#.........#
#.........#
#.........#
#.........#
#X........#
###########

3
2
#####.#####
#.#.......#
#.........#
#.........#
#..#..#...#
..........l
#.........#
#.#.....#.#
#.........#
#.........#
#####.#####

2
0
#####.#####
#.........#
#.........#
#.........#
#.........#
#....@....l
#.........#
#.........#
#...#.....#
#..#......#
#####.#####

5
1
#####d#####
#.........#
#.........#
#.........#
#.........#
...........
#.........#
#.......#.#
#......#..#
#.........#
#####d#####

6
1
#####d#####
##.....#.##
#.........#
#...#...#.#
#.........#
#..#.#.#..#
#.........#
#.#.#.#.#.#
#.........#
##.#......#
#####d#####

4
0
#####.#####
#.#.....#.#
#.........#
#..#.#.#.##
#.........#
#...#.#....
#.........#
#..#.#.#.##
#.........#
#.#.....#.#
#####.#####

7
1
#####d#####
#.........#
#.........#
#.........#
#...e.....#
#....##...#
#..######.#
#.#.###...#
##..#.#.#.#
#.........#
#####.#####
boss
enemies 1

2
2
###########
#.........#
#.........#
#.......#.#
#.....##..#
.......#..#
#.....##..#
#......##.#
#.........#
#.........#
#####.#####

3
0
#####.#####
#.........#
#......#..#
#.......#.#
#.........#
#.........d
#.........#
#.........#
#.........#
#.........#
#####.#####

2
1
#####.#####
#.........#
#.........#
#.........#
#.........#
l..........
#.........#
#.......#.#
#......#..#
#.........#
#####.#####
locked : 0

5
0
#####.#####
#.........#
#..#.....##
#.........#
#.........#
#..#..#....
#.........#
#.........#
#..#..#..##
#k........#
###########
key : 4

