0
3
###########
#X........#
###.......#
###.......#
#.#.......#
#.........#
#.........#
#.........#
#.........#
#.........#
#####.#####

1
3
#####.#####
#.........#
#.........#
#.........#
#.......#.#
....#e....#
#.##....#.#
#.#.#.....#
#.........#
#.........#
#####d#####
boss
enemies 1

3
1
#####l#####
#.........#
#..#...#..#
#.#.....#.#
#.........#
l.........d
#.........#
#.........#
#.........#
#.........#
###########
locked : 0

4
3
#####.#####
#.........#
#..#...#..#
#.#.....#.#
#.........#
..........#
#.........#
#.#.....#.#
#..#...#..#
#.........#
###########

1
2
###########
#.........#
#..#......#
#.#.......#
#.........#
...........
#.........#
#.........#
#.........#
#.........#
#####.#####

3
2
#####.#####
#.........#
#..#......#
####......#
#..#......#
d...###...d
#.#.#.#...#
##..#.#...#
#.........#
#.##......#
#####.#####

4
0
#####.#####
#.........#
#......#..#
#.......#.#
#.........#
#.........#
#.........#
#k#.......#
#..#......#
#.........#
#####.#####
key : 0

5
2
#####.#####
#.........#
#..#......#
#..#.#....#
#..#......#
...#......#
#...#.....#
#.##......#
#.........#
#.......?e#
###########
enemies 1
sign Many have walked this path.

2
3
#####d#####
#.........#
#.#.......#
#.........#
#.....#...#
l....##....
#..##.....#
#..##.....#
##........#
#.........#
#####.#####
locked : 6

4
2
#####.#####
#.........#
#......#..#
#.......#.#
#.........#
#..........
#.........#
#.#.......#
#..#......#
#.........#
#####.#####

5
1
###########
#.........#
##.#......#
#.........#
#.#.......#
...........
#......#..#
#.........#
#...#.#.#.#
#.........#
###########

2
2
#####.#####
##.#.....##
#.........#
#..#.....##
#.........#
.....#.#..l
#.........#
##.#...#.##
#k........#
##.#...#..#
#####.#####
key : 5

3
3
#####.#####
#.........#
#.....#.#.#
#..#.####.#
#.....#...#
d..#####..#
#...#..#..#
#....#.#..#
#.........#
#.........#
#####.#####

2
4
###########
#.........#
#......#..#
#.......#.#
#.........#
..........#
#.........#
#.......#.#
#......#..#
#.........#
###########

2
0
###########
#.........#
#.......#.#
#.........#
#.........#
#..#..#....
#.........#
#.........#
#.#.....#.#
#.........#
#####.#####

1
1
###########
#k........#
#..#......#
#.#.......#
#.........#
#..........
#.........#
#.......#.#
#......#..#
#.........#
#####.#####
key : 6

5
0
#####.#####
#.........#
##..#..#..#
#.........#
#.........#
#...#..#...
#.........#
#.........#
#...#.....#
#k........#
###########
key : 1

2
1
#####.#####
#.........#
#...#..#..#
#.......#.#
#.........#
...........
#.........#
#.#.....#.#
#..#...#..#
#.........#
#####l#####
locked : 1

3
0
#####.#####
#.........#
#.........#
#.........#
#.........#
#?...@....l
#.........#
#.........#
#......#..#
#.........#
#####.#####
sign Seek the matching key before you proceed.

