0
3
###########
#.......?e#
#.#...#.#.#
#.........#
#.#.#.#...#
D.........#
#.#.#...#.#
#.........#
#.....#...#
#.........#
#####D#####
enemies 1
sign A locked path — look elsewhere first.

3
2
#####D#####
#k........#
###.#.....#
######....#
#.##......#
D...#.....D
#...##....#
#.........#
#.........#
#.........#
#####D#####
key : 1

2
1
#####D#####
#.........#
#.........#
#.........#
#.........#
D.........D
#.........#
#.........#
#.........#
#.........#
#####d#####

3
3
#####D#####
#.........#
#.....##..#
#......#..#
#...##....#
D.........D
#..#......#
####......#
#.........#
#.........#
###########

0
2
###########
#.........#
#.........#
#.........#
#...#.....#
D.........D
#.........#
#.#.....#.#
#..#...#..#
#.........#
#####l#####
locked : 1

4
0
#####l#####
#.........#
#.........#
#.........#
#.........#
#.........D
#.........#
#.........#
#.........#
#.........#
###########
locked : 0

2
0
###########
#k........#
#.........#
#.........#
#.........#
#.........D
#.........#
#.........#
#.........#
#.........#
#####D#####
key : 0

4
1
#####D#####
#.........#
#.........#
##..#.....#
#.........#
D.........D
#....#..#.#
#.........#
#.........#
##........#
###########

3
1
#####d#####
#.........#
#.........#
#.........#
#.........#
D.........D
#.........#
#.........#
#.........#
#.........#
#####D#####

2
3
#####D#####
#.........#
#...#.#.#.#
#.........#
#..#.#....#
l.........d
#.#.#.#.#.#
#.........#
#..#...#..#
#.........#
#####D#####
locked : 4

2
4
###########
###.......#
#.#...##..#
#..#.##...#
#.........#
d....e....#
#.........#
#.........#
#.........#
#.........#
#####D#####
boss
enemies 1

3
4
#####D#####
#.........#
#.........#
#.........#
#.........#
D.........#
#.........#
#.........#
#.........#
#..p.....X#
###########

1
1
#####D#####
#.........#
#.......#.#
#.........#
#.........#
#..#..#...d
#.........#
#.........#
#.#.....#.#
#.........#
#####D#####

1
2
#####l#####
#.........#
#.........#
#.........#
#.........#
d.........D
#.........#
#.........#
#.........#
#.........#
#####D#####

3
0
#####D#####
#.........#
#.........#
#.........#
#..##.....#
#..#@###..D
#.#.......#
#....#...##
##........#
#.........#
#####l#####

1
3
#####D#####
#.........#
#.........#
#.........#
#.........#
D.........#
#.........#
#.......#k#
#......#..#
#.........#
#####D#####
key : 4

4
2
#####D#####
#.........#
#.........#
#.........#
#.........#
D.........#
#.........#
#.......#.#
#......#..#
#.........#
###########

2
2
#####D#####
#k........#
#.........#
#...#.....#
#.........#
D.........l
#.........#
#.........#
#.........#
#.........#
#####D#####
key : 3

0
1
###########
#.#.....#.#
#.........#
#...#...#.#
#.........#
#.....#...D
#.........#
#.#.#...#.#
#.........#
#.......#.#
#####D#####

