4
0
#####d#####
#e.p......#
#.........#
#.....p...#
#?........#
#e........D
#.........#
#.........#
#.........#
#.........#
#####D#####
enemies 2
sign The dungeon remembers all who enter.

5
3
#####D#####
#.........#
#.........#
#.........#
#.........#
d.........d
#.........#
#.#.......#
#..#......#
#.........#
#####l#####

6
3
#####l#####
#.........#
#.........#
#.........#
#.........#
D.........#
#.........#
#.........#
#.........#
#.........#
###########
locked : 0

4
1
#####D#####
#..#...#.##
#.........#
#.#.#.#.#.#
#.........#
D..#.#....D
#.........#
#.#.#...#.#
#.........#
##.......##
#####D#####

2
1
#####l#####
#k#.......#
#..##.....#
#..#......#
#.........#
#.........#
#.........#
#.........#
#.........#
#.........#
#####D#####
key : 3

7
2
#####D#####
#......#..#
#...#.##..#
#...#..#..#
#.....#.#.#
#.....#...#
#.....###.#
#.........#
#.........#
#.........#
###########

7
0
#####D#####
#.........#
#.........#
#.#.#...#.#
#.........#
#...#.#...#
#.........#
#.#.#...#.#
#.........#
#.#.....#.#
###########

5
4
###########
#.........#
##.....#.##
#.........#
#...#...#.#
d.........#
#..#...#..#
#.........#
#.#.....#.#
#.........#
###########

6
0
#####D#####
#......#..#
#.....##..#
#....#....#
#.......#.#
#....@....#
#.........#
#.........#
#.........#
#.........#
#####D#####

5
1
#####D#####
#.........#
#.........#
#.........#
#..####...#
D.....#...D
#..#..#...#
#.#..##...#
#..##.#...#
#.........#
###########

3
0
###########
#.........#
#.........#
#..#.....##
#.........#
#.........D
#...#..#..#
#.........#
#.........#
#.........#
#####d#####

0
1
###########
#X........#
#.........#
#.........#
#.........#
#.........#
#.........#
#.........#
#.........#
#.........#
#####D#####

1
1
#####D#####
#.........#
#.........#
#####.p...#
#.####....#
#..#e#....#
#..#.#....#
#....#....#
#.........#
#.........#
#####l#####
locked : 1
boss
enemies 1

3
1
#####D#####
#.........#
#..#......#
#.#.......#
#.........#
D........k#
#.........#
#.#.......#
#..#......#
#.........#
#####D#####
key : 1

5
0
#####D#####
#......#.##
#.........#
##.#...#.##
#e........#
#..#.#....D
#e........#
##.#.#.#.##
#e........#
##.#...#.##
#####D#####
enemies 3

4
2
###########
#.........#
#.........#
##..#..#..#
#.........#
D.........D
#....#..#.#
#.........#
#.........#
##.....#..#
#####d#####

4
3
###########
#........k#
#.........#
#.........#
#...#.....#
D.........#
#.........#
#.#.....#.#
#..#...#.##
#.........#
#####D#####
key : 5

6
2
#####D#####
#.........#
#.........#
#.........#
#.......#.#
#.....#...D
#....####.#
#....###..#
#......#..#
#.........#
#####D#####

5
2
#####d#####
##k#...#..#
#.........#
#.#.#.#.#.#
#.........#
D....#....d
#.........#
#...#.#.#.#
#.........#
##.....#..#
#####D#####
key : 0

