3
1
#####d#####
#.........#
#..#......#
#.#.......#
#.........#
D.........D
#.........#
#.#.....#.#
#..#...#..#
#.........#
###########

1
3
###########
#.........#
#.........#
#.........#
#.........#
l.........#
#.........#
#.......#.#
#......#..#
#.........#
#####D#####
locked : 2

2
1
#####d#####
#k........#
#.........#
#......#..#
#.........#
D.........D
#.........#
#.........#
#.........#
#.........#
#####d#####
key : 0

0
0
###########
#e?......e#
#e........#
#.........#
#.........#
#.........#
#.........#
#.........#
#.........#
#.........#
#####D#####
enemies 3
door 0 : 0
sign Beware what lurks ahead.

4
3
###########
#e...e....#
#.........#
#.........#
#.........#
D.....#...D
#.#...#...#
#.....#.#.#
#.........#
#........##
#####d#####
enemies 2

0
2
###########
#.........#
#.........#
#....###..#
#.........#
#....#.#..#
#....#.#..#
#......#..#
#.........#
#.........#
#####d#####

1
0
#####D#####
#.........#
##.....#.##
#.........#
#..#.#.#..#
#.........D
#....#.#..#
#.........#
##.#...#.##
#.........#
#####D#####

2
2
#####D#####
#e.......s#
#.....#...#
#...#.....#
#...##....#
D.........l
#.........#
#.........#
#.........#
#e........#
#####D#####
enemies 2
switch 0 : 0

1
1
###########
#.#.....#.#
#.........#
#..#...#.##
#.........#
D...#.#...D
#.........#
#..#.#...##
#.........#
#.......#.#
#####d#####

1
2
#####d#####
#k........#
#..#...#..#
#.#.....#.#
#.........#
D.........l
#.........#
#.#.......#
#..#......#
#.........#
#####D#####
key : 2

3
0
#####D#####
#.........#
#.........#
#.........#
#.........#
#....@....D
#.........#
#.........#
#.........#
#.........#
###########

5
3
#####d#####
#.........#
#.........#
#.........#
#...e.###.#
D..###.#..#
#......#..#
#....#....#
#.........#
#.........#
#####D#####
boss
enemies 1

2
0
#####D#####
#.........#
#......#..#
#.......#.#
#.........#
#.........D
#.........#
#.......#.#
#......#..#
#.........#
#####D#####

4
2
#####D#####
#.........#
#..#...#..#
#k#.....#.#
#.........#
#.........D
#.........#
#.........#
#.........#
#.........#
#####D#####
key : 4

2
3
#####D#####
#.........#
#......#..#
#.......#.#
#.........#
l.........#
#.........#
#.#.......#
#..#......#
#.........#
###########
locked : 0

4
4
###########
#........k#
#.........#
#.........#
#.........#
D.........#
#.........#
#.........#
#.........#
#.........#
###########
key : 5

3
2
#####D#####
#.........#
#......#..#
#.......#.#
#.........#
D.........#
#.........#
#.#.......#
#..#......#
#.........#
#####D#####

6
3
#####D#####
#.........#
#.........#
#.........#
#.........#
#.........#
#.........#
#...#...#.#
#.........#
#X........#
###########

5
2
#####D#####
#..#......#
#..#...#..#
#.#....##.#
#.........#
#.....#...D
#.........#
#.........#
#.........#
#.........#
###########

