0
3
###########
#.........#
#.........#
#.........#
#.........#
D.........#
#.##......#
#...#.....#
#.##......#
#.........#
#####l#####
locked : 0

3
3
#####D#####
#.........#
#.........#
#.........#
#.........#
l.........#
#.........#
#.........#
#.........#
#.........#
#####D#####
locked : 3

6
3
#####D#####
#.........#
#.........#
#...#.#...#
#..#......#
#.........#
#.........#
#.........#
#.........#
#X........#
###########

4
3
#####D#####
#.........#
#.........#
#.........#
#.........#
D.........#
#.........#
#.#.......#
#..#......#
#.........#
#####d#####

4
2
#####d#####
#.........#
##.#...#.##
#.........#
#.#.#.#.#.#
#.........D
#..#.#.#..#
#.........#
#.#.#.....#
#.........#
###########

1
1
#####D#####
#e........#
#.........#
#.........#
#.........#
D...#.##..D
#.###.....#
#.###...#.#
#.........#
#s........#
#####D#####
enemies 1
switch 0 : 0

3
1
#####D#####
#.........#
#.#.#.#.#.#
#.........#
#..#.#.#..#
D.........d
#.#...#.#.#
#.........#
#..#...#.##
#........k#
###########
key : 2

5
3
#####d#####
#.........#
#.....###.#
#....#.##.#
#...e..#..#
#....#....#
#......##.#
#.........#
#.........#
#.........#
#####D#####
boss
enemies 1

1
3
#####l#####
#.........#
#......#..#
#.#.....#.#
#.........#
d.........#
#.........#
#.#.....#.#
#..#...#..#
#.........#
#####l#####

3
0
#####D#####
#.........#
#.........#
#.........#
#.........#
#.....##..D
#.....###.#
#.....#.#.#
#.....#...#
#k........#
###########
key : 0

0
1
###########
##e#?..#.##
#e........#
#e#.#.#.#.#
#.........#
#..#...#..D
#.........#
#.#.#.#...#
#.........#
##.#...#.##
#####D#####
enemies 3
door 0 : 0
sign Beware what lurks ahead.

1
0
###########
#.........#
#.........#
#.....#..##
#.........#
#.........D
#..#..#...#
#.........#
#.........#
#..#.....##
#####D#####

0
2
###########
#.#.....#.#
#.........#
#.........#
#..#..#...#
D.........D
#.........#
#.#..#..#.#
#.........#
#.........#
#####D#####

2
3
#####l#####
#..#...#..#
#.........#
#.#.#.#.#.#
#.........#
D..#...#..#
#.........#
#.#...#...#
#.........#
##.#...#..#
#####D#####
locked : 2

1
2
#####D#####
#k##......#
#..#......#
##.##.....#
#...##....#
D.........d
#......#..#
#.....##..#
#.........#
#.........#
#####D#####
key : 3

2
2
#####D#####
#.........#
#.........#
#.#k###...#
#..#......#
D...#.p...D
#.#.......#
#p..#.#...#
#.........#
#.........#
#####D#####
key : 4

3
2
#####D#####
#.##......#
#.#.#.....#
#.#.#.....#
#....##...#
d...###...l
#.........#
#.........#
#.........#
#.........#
#####d#####

2
0
#####D#####
#.........#
#...#.....#
#...##....#
#.........#
#....@....D
#.........#
#.........#
#.........#
#.........#
#####D#####

2
1
#####D#####
#.........#
#......#..#
#.......#.#
#.........#
D.........D
#.........#
#.#.......#
#..#......#
#.........#
#####D#####

