4
4
###########
#.........#
#.........#
#.........#
#.........#
d.........#
#.........#
#.##......#
#.#.......#
#.........#
#####.#####

5
3
#####d#####
#.........#
#.........#
##..#.....#
#.........#
#..........
#...#.....#
#.........#
#.........#
#......#..#
#####l#####

3
3
###########
#.....?.ee#
#...#.#.#e#
#...#.....#
#....###..#
.......#..#
#...#..##.#
#.....##..#
#.......#.#
#.........#
#####.#####
enemies 3
sign A useful tool lies just ahead.

7
4
#####.#####
#......#..#
#......#..#
#.....#...#
#.........#
#.........#
#.........#
#.........#
#.........#
#X........#
###########

1
0
#####.#####
#.........#
#.........#
#.........#
#.........#
#.........l
#.........#
#.........#
#.........#
#.........#
#####d#####

3
2
###########
#.#.....#.#
#.........#
#.........#
#.#.....#.#
...........
#.........#
#.#..#..#.#
#.........#
#.........#
#####.#####

2
0
#####d#####
#.........#
#.........#
#.........#
#.........#
#?...@.....
#.........#
#.........#
#.........#
#.........#
#####.#####
sign What you seek is close.

4
1
#####l#####
#.........#
#..#......#
#.#.......#
#.........#
#..........
#.........#
#.........#
#.........#
#.........#
###########
locked : 3

3
0
#####.#####
#.........#
#.........#
#.#..#..#.#
#.........#
#..........
#....#..#.#
#.........#
#.........#
#.#.....#.#
###########

3
1
#####.#####
#........k#
#..#..#..##
#.........#
#.........#
....#..#...
#.........#
#.........#
#..#..#...#
#.........#
#####l#####
key : 2

1
1
###########
#.........#
#..#......#
#.#.......#
#.........#
l..........
#.........#
#.......#.#
#......#..#
#.........#
#####.#####
locked : 0

0
0
###########
#.........#
#......#..#
#.......#.#
#.........#
#.........#
#.........#
#.#.....#.#
#..#...#..#
#.........#
#####.#####

5
4
#####.#####
#e##......#
#...#.....#
##..#.....#
#..##.....#
...#......#
#.........#
#.........#
#.........#
#.........#
#####.#####
enemies 1

6
4
#####.#####
#.........#
#.........#
#.........#
#.........#
d....e....#
#..#......#
#...#.....#
#.........#
#.........#
#####.#####
boss
enemies 1

2
1
#####.#####
#.........#
#..#...#..#
#.#.....#k#
#.........#
..........#
#.........#
#.........#
#.........#
#.........#
#####.#####
key : 0

1
2
###########
#........k#
#...#.....#
#.........#
#.#...#...#
..........#
#.#...#...#
#.........#
#.#.....#.#
#.........#
###########
key : 3

4
2
#####.#####
#.........#
##........#
####......#
#.........#
...........
#.........#
#.........#
#.........#
#.........#
###########

6
3
#####l#####
#.........#
#.........#
#.........#
#.........#
#.........d
#.........#
#.........#
#.........#
#.........#
###########
locked : 4

4
3
#####.#####
#.......#k#
#.....###.#
#...#..#..#
#...#..##.#
.......#..d
#.........#
#.........#
#.........#
#.........#
#####d#####
key : 4

