3
3
#####D#####
#.........#
#..#......#
#.#.......#
#.........#
D.........D
#.........#
#.......#.#
#......#..#
#.........#
###########

4
2
#####l#####
#.........#
#......#..#
#.......#.#
#.........#
D.........#
#.........#
#.#.......#
#..#......#
#.........#
###########
locked : 3

4
4
#####D#####
#.........#
#.........#
#.........#
#.........#
#.........#
#.........#
#.........#
#.........#
#X........#
###########

5
1
#####D#####
#..#.....##
#.........#
#.........#
#...#..#..#
#.........#
#.........#
#..#..#..##
#.........#
#e.......e#
###########
enemies 2
door 0 : 0 1

0
1
###########
#k........#
##.....#.##
#.........#
#.#.#.#.#.#
#.........#
#....#.#..#
#.........#
#.#.#.#...#
#.........#
#####D#####
key : 3

2
0
###########
#.........#
#..#......#
####......#
#..#......#
#..#.@....D
#.#.......#
#.........#
#.........#
#.........#
#####l#####

1
2
###########
#....k...##
#.........#
#.........#
#.....#...#
D.........l
#.........#
#..#..#..##
#.........#
#.........#
#####D#####
key : 2

2
4
###########
#.#.....#k#
#.........#
#.........#
#.#..#..#.#
D.........#
#.........#
#....#....#
#.........#
#.........#
#####d#####
key : 5

3
1
#####D#####
#.........#
#...#.....#
##..#.....#
#...#.....#
D..#..#...D
#...#.....#
#..##..#..#
#..##.....#
#.........#
#####D#####

2
1
#####D#####
#k........#
#......#..#
#.......#.#
#...#.....#
D.........d
#.........#
#.#.......#
#..#......#
#.........#
#####D#####
key : 0

3
4
#####d#####
#.........#
#.........#
#.........#
#..#.#....#
D..#.e....#
#.........#
#.........#
#.........#
#.........#
#####D#####
boss
enemies 1

3
2
#####d#####
#.#.....#.#
#.........#
#.#.#.#...#
#.........#
D...#.....D
#.........#
#.#...#.#.#
#.........#
#.#.....#.#
#####l#####

2
3
#####D#####
#p........#
#.........#
#.........#
#.........#
d.........D
#.........#
#.........#
#.........#
#.........#
#####D#####

4
1
#####D#####
#e........#
#.........#
#.........#
#.........#
D.........D
#.........#
#.........#
#.........#
#s........#
#####D#####
enemies 1
switch 0 : 0 1

4
0
#####D#####
####......#
#..##.....#
#.###.....#
#...#.....#
#..##.....D
#.........#
#.........#
#.........#
#.........#
###########

2
2
#####D#####
#p........#
#..#..##..#
#..###....#
#..#.###..#
d..#.###..d
#....###..#
#.....##..#
#p........#
#.........#
#####d#####

1
3
###########
#.......#.#
#.........#
#.#.#.....#
#.........#
l...#.#...#
#.........#
#.#.#.#...#
#.........#
#.#.....#.#
#####D#####
locked : 2

1
1
#####D#####
#.........#
#.........#
#.........#
#.........#
#.........D
#.........#
#.........#
#.........#
#.........#
#####D#####

3
0
#####l#####
#.........#
#......#..#
#.....#.#.#
#.........#
#.........D
#.........#
#.#.......#
#..#......#
#.........#
#####D#####
locked : 0

