1
2
###########
#k#.....#.#
#.........#
#.........#
#..#..#...#
D.........D
#.........#
#....#....#
#.........#
#.........#
#####D#####
key : 0

1
3
#####D#####
#.......#.#
#.......#.#
#...#.#.#.#
#...#.k##.#
D...####..l
#...#.###.#
#.....##..#
#.........#
#.........#
#####D#####
key : 4

2
4
#####D#####
#k........#
#..#......#
#.#.......#
#.........#
D.........D
#.........#
#.........#
#.........#
#.........#
#####d#####
key : 5

3
4
#####d#####
#.........#
#.........#
#........p#
#.........#
D....e....#
#.........#
#.........#
#.........#
#.........#
#####D#####
boss
enemies 1

2
1
#####D#####
#.##......#
#.........#
#...#.#...#
#.#..##...#
D.........d
#.........#
#.........#
#.........#
#.........#
#####D#####

1
1
###########
#.........#
#......#..#
#.......#.#
#.........#
#.........D
#.........#
#.........#
#.........#
#.........#
#####D#####

2
2
#####D#####
#......####
#...#.###.#
#..#####..#
#..###....#
d...####..D
#.........#
#.........#
#.........#
#.........#
#####D#####

4
4
#####D#####
#.........#
#.........#
#.........#
#.......#.#
#....#.#..#
#...###.#.#
#...#...#.#
#.....##..#
#X........#
###########

3
2
#####D#####
#e........#
#.........#
#.........#
#.........#
D.........D
#.........#
#..p......#
#.........#
#e...e....#
###########
enemies 3

2
3
#####D#####
#.........#
#.........#
#.........#
#.###.##..#
D..####...D
#.#e..##..#
#.##.###..#
##e#......#
#e........#
#####D#####
enemies 3

2
0
###########
#.?#......#
#.###.....#
#..##.#...#
#.#.......#
#....@....D
#.........#
#.........#
#.........#
#.........#
#####D#####
sign Beware what lurks ahead.

5
0
#####d#####
#.........#
#.........#
#.........#
#.........#
#.........#
#.........#
#.........#
#.........#
#.........#
###########

4
0
#####D#####
#.........#
#..#......#
#.#.......#
#.........#
#.........#
#.........#
#.........#
#.........#
#.........#
#####d#####

0
3
###########
#e..e....e#
#...#.#...#
#.........#
#...#.#...#
#.........#
#.#.#.#.#.#
#.........#
#.#.#.....#
#.........#
#####D#####
enemies 3

3
1
#####D#####
#.........#
#.........#
#....#...##
#....##...#
d...####..D
#......##.#
#...#######
#...#.#.#.#
#.........#
###########

3
0
#####D#####
#.........#
#..#...#..#
#.#.....#.#
#.........#
#.........d
#.........#
#.........#
#.........#
#.........#
#####D#####

1
4
###########
#.........#
#......#..#
#.......#.#
#.........#
l.........#
#.........#
#.#.......#
#..#......#
#.........#
#####D#####
locked : 5

3
3
#####D#####
#e........#
#.........#
#.........#
#.........#
D.........D
#.........#
#.........#
#.........#
#e..?e....#
###########
enemies 3
sign Beware what lurks ahead.

2
5
###########
#........k#
#......#.##
#.........#
#.#.#.....#
D.........#
#..#.#.#..#
#.........#
#.#.#.#...#
#.........#
###########
key : 7

