2
0
#####D#####
#.........#
#.........#
#.........#
#.........#
#?...@....l
#.........#
#.........#
#.........#
#.........#
#####D#####
sign This door will not yield without a key.

2
1
#####D#####
#.........#
#.........#
#.........#
#.........#
l..#......D
#.........#
#.#.......#
#.........#
#.........#
#####D#####
locked : 0

3
0
#####D#####
#.........#
#.........#
#.........#
#.........#
#.........d
#.........#
#.........#
#.........#
#.........#
###########

3
3
#####D#####
#.........#
#.........#
#.........#
#.........#
D.........#
#.........#
#.........#
#.........#
#.........#
#####d#####

5
3
#####d#####
#.........#
#.........#
#.........#
#.........#
#....e....#
#.........#
#.........#
#.........#
#.........#
#####D#####
boss
enemies 1

6
3
#####D#####
#.........#
#.........#
#.....##..#
#.........#
#....#....#
#.....###.#
#.....#.###
#.........#
#X........#
###########

3
2
#####l#####
#k........#
##.....#.##
#.........#
#..#.#.#..#
D.........D
#..#.#.#..#
#.........#
##.#.....##
#.........#
#####D#####
key : 2

1
1
#####D#####
#e.....#.e#
#.........#
#.........#
#....#..#.#
D.........D
#.........#
##..#..#..#
#?........#
#e.......s#
#####D#####
enemies 3
switch 0 : 0
sign This door will not yield without a key.

4
1
#####D#####
#.........#
#..#.....##
#.........#
#.........#
#..#..#...D
#.........#
#.........#
#..#..#...#
#k........#
###########
key : 1

3
1
#####D#####
##........#
#.........#
#.........#
#...#..#..#
d.........D
#.........#
##.....#..#
#.........#
#.........#
#####D#####

1
0
###########
#k........#
#...#.....#
#......#..#
#.........#
#....#.#..D
#...#####.#
#...#####.#
#...#..##.#
#......#..#
#####D#####
key : 0

4
2
#####D#####
#.........#
#..#......#
#.#.......#
#.........#
D.........D
#.........#
#.#.......#
#..#......#
#.........#
###########

4
3
#####d#####
#.........#
#..#...#..#
#.#.....#.#
#.........#
D.........D
#.........#
#.........#
#.........#
#.........#
#####d#####

0
2
###########
#........k#
#.........#
#.........#
#.........#
D.........#
#.........#
#.........#
#.........#
#.........#
#####D#####
key : 3

1
2
#####D#####
#.........#
#.........#
#.........#
#.....##..#
D.....#e..#
#.##......#
#...##e##.#
#.....##..#
#.........#
#####D#####
enemies 2
door 0 : 0

0
1
###########
#..#......#
#.........#
#.........#
#...#..#..#
#.........D
#.........#
#..#......#
#.........#
#.........#
#####D#####

2
3
###########
#.........#
#.........#
#.........#
#.........#
d.........#
#.........#
#.......#.#
#......#..#
#.........#
#####D#####

2
2
#####D#####
#.........#
#.........#
#.........#
#.........#
D.........d
#.........#
#.#.......#
#..#......#
#.........#
#####l#####
locked : 3

4
4
###########
#........e#
##.#...#.##
#.........#
#.#.#.#.#.#
D.........#
#..#.#....#
#.........#
#.#.#...#.#
#........?#
###########
enemies 1
sign Beware what lurks ahead.

