4
1
#####d#####
#..#......#
#.........#
#.........#
#.....#...#
d.........D
#.........#
#...#.....#
#.........#
#.........#
###########

1
4
###########
#e...e....#
#.........#
##..#..#..#
#.........#
D.........l
#.#..#..#.#
#.........#
#.........#
#?.....#..#
#####D#####
enemies 2
sign This door will not yield without a key.

3
2
#####l#####
#k........#
#..#......#
#.#.......#
#.........#
D.........d
#.........#
#.#.......#
#..#......#
#.........#
#####D#####
key : 0

4
2
#####D#####
#.........#
#........##
#.........#
#.........#
D.........D
#.........#
#.#..#..#.#
#..#...#..#
#.........#
###########

3
1
#####D#####
#.........#
#......#..#
#.......#.#
#.........#
D....#....D
#.........#
#.......#.#
##.....#..#
#.........#
#####d#####

1
5
#####D#####
#.........#
#.........#
#.........#
#...#e....#
l...##....#
#..##.#...#
#.........#
#.........#
#.........#
#####D#####
locked : 2
boss
enemies 1

1
3
###########
#e........#
#.........#
#.........#
#.........#
#.........D
#.........#
#.........#
#.........#
#.........#
#####D#####
enemies 1

2
2
###########
#.........#
#..#...#..#
#.#.....#.#
#.#.......#
D.........D
#.........#
#.#.......#
#.........#
#.........#
#####l#####
locked : 1

3
0
###########
#.........#
#.........#
#.........#
#.........#
#..#.##...D
#.........#
#..#......#
#.#.......#
#.........#
#####D#####

5
0
#####D#####
##.....#..#
#.........#
#.........#
#...#.....#
#.........#
#.........#
#...#..#..#
#.........#
#.........#
###########

4
0
#####D#####
#.........#
#.........#
#.........#
#.........#
#....@....d
#.........#
#.........#
#.........#
#.........#
#####D#####

2
5
#####D#####
#.........#
#.........#
#.........#
#.........#
d.........#
#.........#
#.........#
#.........#
#......p..#
###########

2
1
#####D#####
###.......#
###.......#
##k#......#
#..###....#
#...##....D
#.........#
#.........#
#.........#
#.........#
#####D#####
key : 1

3
3
#####D#####
#.#.....#.#
#.........#
#...#.#.#.#
#.........#
d...#.....#
#.........#
#.#.#...#.#
#.........#
#.#.......#
#####D#####

1
1
###########
#k........#
#..#......#
#.#.......#
#.........#
#.........#
#.........#
#.........#
#.........#
#.........#
#####D#####
key : 2

4
3
#####D#####
#.........#
#..#......#
#.#.......#
#.........#
D.........#
#.........#
#.......#.#
#......#..#
#........k#
###########
key : 3

2
3
#####D#####
#.........#
##.#......#
####......#
#.###.....#
D...##....D
#..#......#
##........#
#.#.......#
#.........#
#####D#####

0
5
###########
#........X#
#.....#.###
#....#..###
#......#..#
#.....##..#
#.##.####.#
##.#......#
##.#......#
#.........#
#####D#####

2
4
#####D#####
#.........#
##.#...#..#
#.........#
#.#.#...#.#
D.........d
#..#.#....#
#.........#
#...#.#.#.#
#.........#
###########

