7
1
#####.#####
#.#.......#
#..#......#
#.###.....#
#.........#
#.........#
#.....#...#
#...###...#
#...#.#...#
#X........#
###########

4
2
#####.#####
#k........#
#..#......#
#.#.......#
#.........#
...........
#.........#
#.........#
#.........#
#.........#
#####.#####
key : 3

3
2
#####.#####
#.........#
##.#...#.##
#.........#
#...#...#.#
..........d
#....#.#..#
#.........#
#.#.#.#.#.#
#.........#
#####.#####

5
1
#####d#####
#.........#
#......#..#
#.......#.#
#.........#
#..........
#.........#
#.#.......#
#.##......#
#.........#
#####l#####

2
3
###########
#......##.#
#...#.#...#
#...###...#
#....##...#
..........#
#...#...#.#
#.....###.#
#.......#.#
#......##.#
#####.#####

6
1
#####l#####
#.........#
#.........#
#.........#
#..##.....#
#..##e....#
#...###...#
#.##.##...#
#..#..#...#
#.#.......#
#####.#####
locked : 3
boss
enemies 1

0
1
###########
#.......#.#
#.........#
#..#.#.#.##
#.........#
....#.#...#
#.........#
#..#...#.##
#.........#
#.#.......#
###########

0
0
###########
#?.#......#
#.........#
#..#......#
#.........#
#...#@.....
#...#..#..#
#..###....#
#.........#
#.........#
#####.#####
sign The brave are rewarded.

3
1
#####.#####
#.........#
#..#......#
#.#.......#
#.........#
l..........
#.........#
#.......#.#
#......#..#
#.........#
#####l#####
locked : 0

1
2
###########
##s.....?e#
#e........#
#.........#
#.........#
#.........#
#.........#
#......#..#
#.........#
#.........#
#####.#####
enemies 2
switch 0 : 0 1
sign Beware what lurks ahead.

1
0
#####.#####
#.........#
#..#......#
#.........#
#.........#
#.........#
#.........#
#......##k#
#......#..#
#.........#
#####.#####
key : 0

2
1
###########
#.........#
#..#......#
#.#.......#
#.........#
d..........
#.........#
#.......#.#
#......#..#
#.........#
#####.#####

2
2
#####.#####
#.........#
#.........#
#.........#
#.........#
...........
#.........#
#.#.......#
#..#......#
#.........#
#####.#####

4
3
#####.#####
##.....#.##
#.........#
#.#.#...#.#
#.........#
..........#
#.........#
#.#.#.#...#
#.........#
##.....#e##
###########
enemies 1
door 0 : 0 1

2
0
#####.#####
#.........#
#.........#
#.........#
#.........#
#k........d
#.........#
#.........#
#.........#
#.........#
#####.#####
key : 1

3
3
#####.#####
##.....##.#
#.........#
#...#.....#
#...##....#
d.........#
#.........#
#.........#
#.........#
#.......#.#
#####.#####

4
1
#####l#####
#.........#
#......#.##
#.......#.#
#.........#
#..........
#.........#
###.......#
#..##.....#
#.........#
#####d#####
locked : 2

3
0
#####.#####
#.........#
#.........#
#..#......#
#......#..#
#.........l
#.........#
#.........#
#.........#
#k........#
###########
key : 2

5
2
#####.#####
#.........#
#..#...#..#
#.###.....#
#..##.....#
.....#....#
#.........#
#.....#..##
#.....#####
#.....?eee#
###########
enemies 3
sign A useful tool lies just ahead.

