3
0
#####.#####
#......#..#
#.....##..#
#..##.....#
#...##....#
#k..##.....
#.........#
#.........#
#.........#
#.........#
#####.#####
key : 0

4
0
#####.#####
#.......###
#.....#..##
#....##.###
#....#.##.#
#....#.#..#
#.........#
#.........#
#.#.......#
#..#......#
###########

2
1
#####.#####
#.........#
#.........#
#.........#
#.........#
...........
#.........#
#.........#
#.........#
#.........#
#####.#####

0
1
###########
#.........#
#.........#
#.........#
#.........#
...........
#.........#
#.........#
#.........#
#.........#
#####l#####
locked : 0

2
3
#####.#####
#.........#
#.#.#.#.#.#
#.........#
#...#.#.#.#
d..........
#.#.#.#...#
#.........#
#.#.#.#.#.#
#.........#
#####.#####

2
2
#####.#####
##k#...#.##
#.........#
#.#...#...#
#.........#
.....#....d
#.........#
#.#...#.#.#
#.........#
#......#.##
#####l#####
key : 3

2
4
#####.#####
#.........#
#.........#
#.........#
#.........#
..........#
#.........#
#.........#
#.........#
#........X#
###########

2
0
#####.#####
##.#......#
##........#
#.#.#.....#
#.#..#....#
#....@.....
#.....#...#
#....#....#
#.....#...#
#.........#
#####.#####

3
1
#####.#####
#.........#
#.........#
#.........#
#.........#
...........
#.........#
#.........#
#.........#
#....k....#
###########
key : 1

0
2
###########
#.#.....#.#
#.........#
#.#.#...#.#
#.........#
....#.#....
#.........#
#.#.#.....#
#.........#
#.#.....#.#
#####d#####

1
3
#####.#####
#..#.....##
#.........#
#.........#
#...#.....#
..........l
#.........#
#..#..#..##
#.........#
#.........#
#####.#####

1
1
#####l#####
#e.......e#
#..#..#..##
#.........#
#.........#
....#..#..d
#.........#
#.........#
#.........#
#e.......?#
#####.#####
enemies 3
door 0 : 0
sign A locked path — look elsewhere first.

1
0
#####.#####
#e#.......#
#.........#
#.........#
#s....#...#
#e.........
#.........#
#e#.....#.#
#.........#
#.........#
#####.#####
enemies 3
switch 0 : 0

1
2
#####d#####
##........#
#.........#
#.........#
#.........#
d..........
#.........#
#.#....#..#
#..#......#
#.........#
#####.#####

0
0
###########
#.........#
#...#..#..#
#.........#
#.........#
#...#......
#.........#
#.........#
##.....#..#
#.........#
#####.#####

3
2
#####l#####
#.........#
#.........#
#.........#
#.........#
...........
#.....##..#
#.....#.#.#
#.......#.#
#.........#
###########
locked : 3

1
4
###########
#.........#
#.........#
#.........#
#.........#
l....e....#
#.........#
#.........#
#.........#
#.........#
#####.#####
locked : 4
boss
enemies 1

3
3
#####.#####
#.#.....#.#
#.........#
#.........#
#.#..#..#.#
..........#
#.........#
#....#..#?#
#.........#
#........e#
###########
enemies 1
sign This door will not yield without a key.

0
3
###########
#........k#
#.........#
#.........#
#.........#
..........#
#.........#
#.......#.#
#......#..#
#.........#
#####.#####
key : 4

