4
2
#####.#####
#k........#
#.........#
#.###.....#
#...#.....#
....#......
#...###...#
#...###...#
#.........#
#.........#
#####.#####
key : 0

5
2
#####.#####
#k........#
##.#......#
#.........#
#.#.#...#.#
..........#
#..#.#.#..#
#.........#
#.#.#...#.#
#.........#
#####.#####
key : 2

8
2
#####.#####
#.........#
#......#..#
#.........#
#.....#...#
#.........#
#.........#
#.........#
#.........#
#X........#
###########

5
1
#####.#####
#.........#
#..#......#
#k#.......#
#.........#
#..........
#.........#
#.........#
#.........#
#.........#
#####.#####
key : 1

0
1
###########
#e......#e#
#.....#...#
#.........#
#.........#
#.........#
#.........#
#.........#
#.........#
#.........#
#####.#####
enemies 2
door 0 : 0 1

4
0
#####.#####
##.#......#
##........#
#.#.......#
#...##@...#
#..###.....
#...##....#
#.####....#
#.#.#.....#
#?#.......#
###########
sign Beware what lurks ahead.

3
2
#####.#####
#.........#
#.........#
#....###..#
#..##..#..#
#...#.....#
#.#.#.....#
##.#......#
##........#
#.........#
#####.#####

2
1
#####d#####
#.........#
#.........#
#.........#
#.........#
d..........
#.........#
#.........#
#.........#
#.........#
###########

1
1
#####.#####
#.........#
#..#......#
#.#......##
#.........#
..........#
#.........#
#....#....#
#.........#
#.#.......#
#####d#####

4
1
###########
#.......#.#
#.........#
#.........#
#.#..#..#.#
...........
#.........#
#.#..#..#.#
#.........#
#.........#
#####.#####

6
1
#####.#####
#.........#
#..#......#
#.#.......#
#.........#
#.........d
#.........#
#.#.......#
#..#......#
#.........#
#####l#####

2
0
#####.#####
#.........#
#...#.#...#
#.........#
#....#.#..#
#.........d
#.#.#.#.#.#
#.........#
#..#...#.##
#.........#
#####.#####

1
0
###########
#k........#
#.........#
#.........#
#.........#
#..........
#.........#
#.........#
#.........#
#.........#
#####.#####
key : 4

7
1
#####l#####
#.........#
#.........#
#........##
#.........#
#..........
#..#..#...#
#.........#
#.........#
#..#.....##
###########
locked : 1

6
2
#####.#####
#.........#
#.#.....#.#
#.........#
#.........#
d....#....#
#.........#
#.........#
#.......#.#
#.........#
#####d#####

7
2
#####d#####
#.......#.#
#.....###.#
#....#.#..#
#......##.#
.....e....#
#.........#
##........#
#.........#
#.........#
#####.#####
boss
enemies 1

3
0
#####.#####
#.........#
#.........#
#.........#
#.........#
#.........#
#.........#
#.........#
#.........#
#.........#
#####.#####

2
2
###########
#.......se#
#.###....?#
#..###....#
#.##......#
...###....#
#..###....#
#.........#
#.........#
#.........#
#####.#####
enemies 1
switch 0 : 0 1
sign The dungeon remembers all who enter.

4
3
###########
#.........#
#.........#
#.........#
#.........#
..........#
#.........#
#.........#
#.........#
#.........#
###########

