1
3
###########
#.......#.#
#......#..#
#.......#.#
#.........#
..........l
#.........#
#.#.......#
#..#......#
#......#..#
#####.#####

1
4
#####.#####
#......#..#
#......##.#
#.......#.#
#.........#
l....e....#
#.....##..#
#....##...#
#.....#...#
#.........#
#####.#####
locked : 1
boss
enemies 1

3
3
#####d#####
#.........#
#.........#
#.........#
#.........#
...##.....#
#..#.##...#
#....##.#.#
#......#..#
#.........#
###########

4
2
#####.#####
#.........#
#......#..#
#.......#.#
#.........#
...#......#
#.........#
#.#.......#
#..#......#
#.........#
###########

3
1
#####d#####
#.........#
#.#.#.....#
#.........#
#......#..#
...........
#.#.#.#...#
#.........#
#..#...#.##
#.........#
#####d#####

2
2
#####.#####
#.........#
#........##
#.........#
#.#.#.#.#.#
...........
#....#.#..#
#.........#
#...#.#...#
#.........#
#####.#####

3
2
#####.#####
#k........#
#.........#
#.........#
#.........#
...........
#...#.....#
#.........#
#.###.....#
#.........#
#####.#####
key : 2

2
0
#####l#####
#.........#
#.........#
#.........#
#.........#
#k.........
#.........#
#.......#.#
#......#..#
#.........#
#####.#####
key : 0

1
1
###########
#..#.....##
#.........#
#.........#
#.....#...#
...........
#.........#
#.....#...#
#.........#
#.........#
#####.#####

1
0
###########
#.........#
#.........#
#.....#.#.#
#.....#...#
#..........
#.........#
#.........#
#.........#
#.........#
#####l#####
locked : 0

2
4
#####.#####
#.........#
#.........#
#.........#
#.........#
d..#......#
#.##......#
#..##.....#
##.#......#
#.........#
###########

1
2
#####.#####
#.........#
#.........#
#.....#...#
#.........#
...........
#..#..#...#
#.........#
#.........#
#..#.....##
#####.#####

0
2
###########
##e#....e##
#e........#
#.#.#.#.#.#
#.........#
#..#.#....#
#.........#
#.#...#...#
#.........#
#..#...#..#
#####.#####
enemies 3

3
0
#####.#####
#..#...#..#
#..##.#...#
#..#..#...#
#..#..##..#
#..##@##...
#.........#
#.........#
#.........#
#?........#
###########
sign Those who search shall find.

2
1
#####.#####
#k........#
#......#..#
#..#....#.#
#.........#
...........
#.........#
#.#.......#
#..#......#
#.........#
#####d#####
key : 1

2
3
#####.#####
#?.......e#
#..#..#..##
#.........#
#.........#
......#...d
#.........#
#.........#
#..#..#...#
#.........#
#####d#####
enemies 1
sign The dungeon remembers all who enter.

0
4
###########
#X.....#..#
#.........#
#.........#
#.........#
#.........#
#.........#
#.........#
#.........#
#.........#
#####.#####

5
1
#####.#####
##.......##
#.........#
##.#.#...##
#.........#
#..#.#.#..#
#.........#
##.#.#.#.##
#.........#
#..#...#k##
###########
key : 4

4
1
#####d#####
#.........#
#.........#
#.........#
#.........#
#..........
#.........#
#.#.....#.#
#..#...#..#
#.........#
#####.#####

