4
2
#####.#####
#.........#
#.....#...#
#.....##..#
#....##...#
#.........#
#.........#
#.........#
#?........#
#e.......s#
###########
enemies 1
switch 0 : 0 1
sign Only the prepared may pass.

5
4
#####.#####
#.........#
#.........#
#.........#
#.........#
#..#......#
#...#.....#
#.###.....#
#.........#
#X........#
###########

2
1
###########
#.........#
#...#k#...#
#....#....#
#....###..#
.....#.....
#.....#.#.#
#.....###.#
#......##.#
#.........#
#####.#####
key : 2

2
0
#####.#####
##.....#..#
#.........#
#.........#
#k#..#..#.#
#..........
#.........#
##..#.....#
#.........#
#.........#
#####.#####
key : 0

0
3
###########
#.#.....#.#
#.........#
#.........#
#.....#...#
#.........#
#.........#
#.#.....#.#
#.........#
#.........#
#####l#####
locked : 2

1
0
###########
##k#...#..#
#.........#
#.#.#.#.#.#
#.........#
#..#.#....#
#.........#
#.#.#.#.#.#
#.........#
##.....#.##
#####.#####
key : 1

1
3
#####l#####
#e........#
#.........#
#.........#
#.........#
....##...e#
#...##....#
#....#....#
#.........#
#.........#
#####.#####
enemies 2

1
2
###########
#e........#
#.........#
#..#.....##
#.........#
#..........
#..#..#...#
#.........#
#.........#
#.........#
#####.#####
enemies 1
door 0 : 0 1

3
0
#####.#####
#.........#
#.........#
#.....#...#
#....#....#
#....@#....
#.........#
#.........#
#.........#
#.........#
#####.#####

3
1
#####.#####
#.........#
#.........#
#.........#
#.........#
..........l
#.........#
#.#.....#.#
#..#...#..#
#.........#
###########

3
2
#####d#####
#.........#
#..#......#
#.#.......#
#.........#
l..........
#.........#
#.........#
#.........#
#.........#
#####.#####
locked : 0

2
4
###########
#.........#
#.........#
#.........#
#.........#
d.........#
#.....#.#.#
#.#.....#.#
#..#...#..#
#.........#
#####d#####

2
2
#####.#####
#.........#
#........##
#...#.....#
#....#....#
...........
#.........#
#.#.......#
#..#......#
#.........#
#####d#####

3
5
###########
#.......#.#
#.....#...#
#.........#
#.........#
..........#
#.........#
#.........#
#.........#
#.........#
###########

3
4
#####d#####
#.........#
#..#..#..##
#.........#
#.........#
...#.......
#.........#
#.........#
#..#..#...#
#.........#
#####d#####

4
4
#####d#####
#.........#
#.........#
#.#.......#
#.........#
#....e....#
#.#.......#
#.........#
#.........#
#.........#
#####.#####
boss
enemies 1

2
3
#####.#####
#k.......##
#.........#
#.........#
#.........#
....#.....d
#.........#
#....#..#.#
#......#..#
#.........#
#####.#####
key : 4

4
0
#####.#####
#.........#
#.........#
#.........#
#.........#
#.........#
#.........#
#.........#
#.........#
#.........#
###########

3
3
#####.#####
#.........#
#..#......#
#.#.......#
#.........#
...........
#.........#
#.........#
#.........#
#.........#
###########

