3
2
###########
#.........#
#.........#
#.#####...#
#..####...#
l...#.#...#
#..##.....#
#.........#
#.........#
#.........#
###########
locked : 1

4
1
#####D#####
#.........#
#......#..#
#.......#k#
#.........#
D.........#
#.........#
#.#.....#.#
#..#...#..#
#.........#
#####l#####
key : 0

7
1
#####d#####
#.........#
#.....#...#
#.........#
#...#.....#
#.........#
#.........#
#.#.....#.#
#..#...#..#
#.........#
###########

1
0
#####D#####
#.......#e#
#......##.#
#....p##..#
#.........#
#e........D
#ep.......#
#.........#
#.........#
#.........#
#####D#####
enemies 3
door 0 : 0

6
2
#####D#####
#.........#
#.........#
#.........#
#......#..#
D.........D
#.........#
#.........#
#.........#
#.........#
###########

5
1
#####l#####
#.........#
##.#...#..#
#.........#
#...#.#.#.#
#.........d
#..#.#.#..#
#.........#
#.#.#...#.#
#.........#
#####D#####
locked : 0

2
0
#####D#####
#.........#
#..#......#
#.#.......#
#.........#
#.........D
#.........#
#..###..#.#
#......#..#
#.........#
#####D#####

7
3
#####l#####
#.........#
#.........#
#.........#
#.........#
#....e....#
#.........#
#.........#
#.........#
#.........#
#####D#####
locked : 4
boss
enemies 1

3
1
#####D#####
##e#......#
#.........#
#...#.#.#.#
#.........#
D..#...#..l
#.........#
#.#.....#.#
#.........#
##s#...#.##
#####D#####
enemies 1
switch 0 : 0

5
2
###########
#.......###
#.......###
#....#.####
#.....###.#
d.....##..#
#....##.#.#
#....#..p.#
#.......p.#
#.........#
#####D#####

6
1
#####D#####
##.#......#
#.........#
#.#.#.#.#.#
#.........#
#..#.#.#..D
#.........#
#.#.#...#.#
#.........#
#..#...#.##
#####d#####

6
3
###########
#?...e....#
#.........#
#.........#
#.###e....#
D..###....d
#.###.....#
#...#.#...#
#.........#
#.........#
#####l#####
enemies 2
sign A locked path — look elsewhere first.

1
1
###########
#........k#
#......#..#
#.......#.#
#.........#
D.........#
#.........#
#.......#.#
#......#..#
#.........#
#####D#####
key : 4

0
0
###########
#k........#
#.........#
#.........#
#.........#
#.........#
#.........#
#.........#
#.........#
#.........#
#####D#####
key : 6

2
1
#####D#####
#.........#
#......#..#
#.....#...#
#......#..#
D.........#
#.........#
#.........#
#.........#
#.........#
#####D#####

6
4
###########
#.........#
#.........#
#.#.#.#...#
#..#......#
d..##.#...#
#.##......#
#..#..#...#
#.........#
#.........#
###########

4
0
#####D#####
#.........#
#...#.....#
#.........#
#.#.#.....#
#..#.@....D
#.........#
#.........#
#.........#
#.........#
###########

3
0
#####D#####
#.........#
#..#......#
#k#.......#
#.........#
#.........D
#.........#
#.......#.#
#......#..#
#.........#
#####D#####
key : 1

8
3
#####D#####
#.........#
#.........#
#.........#
#..##.....#
#..#.##...#
#.#..##...#
#.#.#.#...#
#...#.#...#
#X........#
###########

