2
4
###########
#.........#
#.........#
#.........#
#.........#
l.........#
#.........#
#.........#
#.........#
#.........#
#####D#####
locked : 3

3
5
###########
#.........#
#.........#
#.........#
#.........#
D.........#
#.........#
#.........#
#.........#
#.........#
###########

2
0
#####D#####
#.........#
#..#..#...#
#.........#
#.........#
#...#..#..D
#.........#
#.........#
#..#.....##
#.........#
#####D#####

4
4
#####d#####
#.........#
##........#
#.........#
#...e.....#
#...##....#
#..#.#....#
####......#
#.###.....#
#.........#
#####D#####
boss
enemies 1

4
1
#####D#####
#.........#
#.........#
#..#..#...#
#.........#
#.........D
#...#.....#
#.........#
#.........#
#..#.....##
#####d#####

2
1
#####d#####
#.........#
#.........#
#.........#
#.........#
D....##...l
#...##k...#
#...###...#
#.........#
#.........#
#####D#####
key : 0

3
3
#####D#####
#.........#
#..#......#
#.#.......#
#.........#
l.........D
#.........#
#.........#
#.........#
#.........#
###########
locked : 7

1
1
###########
##.#...#.##
#.........#
#...#.#.#.#
#.........#
D....#....#
#.........#
#.#.#.#.#.#
#.........#
##.#...#.##
#####d#####

5
1
#####d#####
#.........#
#.........#
#.........#
#.........#
#.........#
#.........#
#.........#
#.........#
#.........#
###########

3
2
#####D#####
##k#...#.##
#.........#
#.#.#.#...#
#.........#
D..#.#.#..l
#.........#
#.#.#.#...#
#.........#
##.#...#.##
#####d#####
key : 3

1
0
#####D#####
#.........#
#.........#
#.........#
#..#......#
#?.#.@....D
#..#......#
#.........#
#.........#
#.........#
#####D#####
sign Many have walked this path.

3
4
#####D#####
#.........#
##.#.....##
#.........#
#.#.#.#.#.#
D.........D
#..#.#.#..#
#.........#
#.#.#.#.#.#
#.........#
#####d#####

4
2
#####d#####
#.#.....#.#
#.........#
#.........#
#.#..#..#.#
D.........#
#.........#
#.#..#..#.#
#.........#
#.........#
###########

5
4
#####D#####
#.........#
#.#.#.....#
#.#..#....#
#.........#
#..#####..#
#...####..#
#..##..#..#
#..##.....#
#X.#...#..#
###########

2
2
###########
#.........#
##.#...#.##
#.........#
#..#.#....#
l.........D
#..#.#....#
#.........#
#..#...#.##
#.........#
#####D#####
locked : 1

3
0
#####D#####
#.........#
#.#.#.#...#
#.........#
#..#.#.#..#
#.........D
#.#.#.#...#
#.........#
#..#...#.##
#.........#
###########

3
1
#####D#####
#k........#
#.........#
#.........#
#.........#
D.........D
#.........#
#.........#
#.........#
#.........#
#####D#####
key : 1

2
3
###########
#....k....#
#.........#
#.........#
#.........#
D.........l
#.........#
#.#.....#.#
#..#...#..#
#.........#
#####D#####
key : 7

0
0
###########
#e........#
#..#..#...#
#.###.....#
#....#....#
#..#.##...#
#.........#
#.........#
#.........#
#.........#
#####D#####
enemies 1

