1
2
###########
#.........#
#.........#
#.........#
#.........#
d.........#
#.........#
#.........#
#.........#
#.........#
###########

3
2
###########
#.........#
##.#...#.##
#.........#
#.#.#.#.#.#
D.........#
#......#..#
#.........#
#.#.#.#.#.#
#.........#
###########

4
1
#####D#####
#.........#
#.........#
#.........#
#.........#
D.........#
#.........#
#.........#
#.........#
#.........#
#####D#####

1
1
#####D#####
#e........#
##........#
#.........#
#...###...#
D...#.....d
#.#.......#
#.........#
#.........#
#.........#
#####D#####
enemies 1

7
0
#####d#####
#.........#
#.........#
#.........#
#.........#
#.........D
#.........#
#.........#
#.........#
#.........#
###########

2
0
#####l#####
#.........#
#.........#
#....####.#
#...#k###.#
#..##.....D
#.........#
#.........#
#.........#
#..p......#
#####D#####
key : 0

3
1
#####D#####
#k........#
#..#...#..#
#.#.....#.#
#.........#
D.........D
#.........#
#.........#
#.........#
#.........#
#####D#####
key : 1

1
0
###########
#.........#
#.........#
#.........#
#.........#
#.........D
#.........#
#.........#
#.........#
#.........#
#####l#####
locked : 1

3
0
#####D#####
#.........#
#.........#
#.#.#.....#
#.........#
#..#.@....D
#.........#
#.........#
#.........#
#.........#
#####l#####

0
1
###########
#.##......#
#.........#
#.........#
#.........#
#.........#
#.........#
#.........#
#.........#
#.........#
#####D#####

6
1
#####D#####
#e.......?#
#.........#
#.........#
#.........#
D.........d
#.........#
#.........#
#.........#
#e........#
#####d#####
enemies 2
sign Seek the matching key before you proceed.

6
2
###########
#.........#
#.........#
#.........#
#.........#
d.........#
#.........#
#.........#
#.........#
#.........#
###########

7
1
#####d#####
#.........#
#.........#
#.........#
#..#.#....#
D..#.e....#
#..#.#....#
#.........#
#.........#
#.........#
#####D#####
boss
enemies 1

5
0
#####D#####
#.........#
#.........#
#..#..#...#
#.........#
#k........l
#..#......#
#.........#
#.........#
#..#.....##
#####D#####
key : 2

4
0
#####l#####
#.#.....#.#
#.........#
#.#.#.#.#.#
#.........#
#.....#...D
#.........#
#.....#.#.#
#.........#
#.#.......#
#####D#####
locked : 0

5
1
#####D#####
#.........#
#..#......#
#.#.......#
#.........#
l.........#
#.........#
#.........#
#.........#
#.........#
#####D#####
locked : 4

6
0
#####D#####
#........k#
#..#..#..##
#.........#
#.........#
#..#..#...D
#.........#
#.........#
#..#..#...#
#.........#
#####d#####
key : 4

2
1
#####D#####
#.........#
#..#...#.##
#.........#
#..#.#.#..#
D.........#
#..#.#....#
#.........#
##.#...#.##
#.........#
#####D#####

8
1
#####D#####
#.........#
#.........#
#.........#
#...#.....#
#..#......#
#.........#
#.........#
#.........#
#X........#
###########

