3
0
#####D#####
#.........#
#...#.##..#
#..##..#..#
#..###....#
#..##@#...D
#...#.#...#
#?#.......#
#.........#
#.........#
#####D#####
sign The brave are rewarded.

1
6
#####D#####
#.........#
#...#.##..#
#..####...#
#..##.....#
D...##....#
#..#e.....#
#.........#
#.........#
#.........#
#####d#####
boss
enemies 1

4
0
#####D#####
#.........#
#......#..#
#.......#.#
#.........#
#.........#
#.........#
#.........#
#.........#
#.........#
###########

2
6
#####d#####
#.#.....#.#
#.........#
#..#.#....#
#.........#
l...#.#...#
#.........#
#....#.#..#
#.........#
#.#.....#.#
###########
locked : 0

1
4
###########
#.........#
#.........#
#.........#
#.........#
#.........D
#...#.....#
#..###....#
#.........#
#.........#
#####l#####
locked : 3

2
4
#####l#####
#.........#
#.........#
#..#..#..##
#.........#
d.........D
#.........#
#.........#
#.........#
#..#.....##
#####D#####

3
1
#####D#####
#.........#
##..#..#..#
#.........#
#.........#
D......#..#
#.........#
#.........#
##.....#..#
#........k#
###########
key : 0

1
1
###########
#.........#
#.........#
#.........#
#.........#
D.........#
#.........#
#.........#
#.........#
#.........#
#####d#####

4
3
#####l#####
####......#
####......#
#.##.#....#
#..#......#
#.........#
#.........#
#.........#
#.........#
#.........#
###########
locked : 1

0
6
###########
#X........#
#.........#
#.........#
#.........#
#.........#
#.........#
#.........#
#.........#
#.........#
#####D#####

2
5
#####D#####
#k#.....#.#
#.........#
#..#.#.#.##
#.........#
D.........l
#.........#
#..#.#...##
#.........#
#.#.....#.#
###########
key : 3

2
0
#####D#####
#.........#
#.........#
#...##....#
#.#####...#
#..###....D
#.####....#
#####.#...#
##..#.....#
###.......#
#####D#####

2
1
#####d#####
#e##......#
#.#e......#
#.###.....#
#.###.....#
D..##.....D
#.........#
#.........#
#.........#
#e........#
#####D#####
enemies 3

2
2
###########
#.........#
#.........#
#.........#
#..###....#
D..#......D
#.####....#
#....#....#
#####.....#
#.........#
###########

2
3
###########
#......k..#
#......#..#
#.......#.#
#.........#
D.........d
#.........#
#.........#
#.........#
#.........#
#####D#####
key : 1

3
4
#####D#####
#.........#
#.........#
#.........#
#...#.....#
d....#....#
#....#.#..#
#....###.##
#.....#.###
#.........#
###########

1
0
###########
#.........#
#..#...#.##
#.........#
#.#.#.#...#
#.........D
#..#...#..#
#.........#
#.....#.#.#
#.........#
#####D#####

1
5
###########
##.#...#.##
#.........#
##.#.#.#.##
#.........#
D..#...#..D
#.........#
##...#.#.##
#.........#
#..#.....##
#####D#####

3
3
#####D#####
#.........#
#..#...#..#
#k#.....#.#
#.........#
#.........d
#.........#
#.........#
#.........#
#.........#
#####l#####
key : 2

