3
1
#####D#####
#.........#
#......#..#
#.......#.#
#.........#
D.........#
#.........#
#.........#
#.........#
#........k#
###########
key : 0

4
0
#####D#####
#.........#
#.........#
#.........#
#.........#
#.........#
#.........#
#.........#
#.........#
#.........#
#####D#####

2
0
#####d#####
#.........#
#..#......#
#....#....#
#.#.......#
#..####...l
#...#.#...#
#.........#
#...#.....#
#.........#
#####D#####

1
0
#####d#####
#.........#
#......#..#
#.......#.#
#.........#
#.........D
#.........#
#.......#.#
#......#..#
#.........#
#####d#####

2
3
###########
#..k......#
#..#...#..#
#.#.....#.#
#.........#
D.........D
#.........#
#.......#.#
#......#..#
#.........#
#####l#####
key : 4

2
1
#####D#####
#.........#
##..#..#..#
#.........#
#.........#
l....#....D
#.........#
#.........#
##..#..#..#
#.........#
#####D#####
locked : 0

0
1
###########
#.........#
#.....#...#
#.........#
#.........#
D.....#...#
#.........#
#.#..#..#.#
#..#...#..#
#.........#
#####d#####

3
4
#####D#####
#.#.....#.#
#.........#
#.#...#.#.#
#.........#
D...#.#...#
#.........#
#...#.#e#e#
#.........#
#.#......e#
###########
enemies 3
door 0 : 0

4
3
#####D#####
#.........#
#.........#
#.........#
#.........#
#.........#
#.........#
#.........#
#.........#
#X........#
###########

6
0
#####D#####
#.........#
#.........#
##..#..#..#
#.........#
#.........#
#...#..#..#
#.........#
#.........#
##.....#.k#
###########
key : 2

5
1
###########
#.........#
#......#..#
#.......#.#
#.........#
l.........#
#.........#
#.......#.#
#......#..#
#.........#
###########
locked : 2

1
2
###########
#.........#
#.........#
#......#..#
#.........#
d.........#
#...#..#..#
#.........#
#.........#
##.....#..#
#####D#####

0
0
###########
#.##......#
#...#.....#
#..##.....#
#..##.....#
#..#......D
#...###...#
#...#.#...#
#...#.....#
#.........#
#####d#####

3
0
#####D#####
#.........#
#.........#
#.........#
#.........#
#?...@....D
#.........#
#.........#
#.........#
#......p..#
#####D#####
sign A useful tool lies just ahead.

3
3
#####l#####
#.........#
#.........#
#.........#
#.........#
#....e....D
#...##....#
#...#.#...#
#...#.#...#
#.........#
#####D#####
locked : 3
boss
enemies 1

2
2
#####D#####
#.........#
#.........#
#.........#
#.....#...#
D..#..#...D
#..#.##...#
#....##...#
#...#.#...#
#.........#
###########

5
0
#####D#####
#.........#
#.........#
#.........#
#.........#
#.........l
#.........#
#p........#
#.........#
#.........#
#####D#####

2
4
###########
#......eee#
##.....#.s#
#.........#
#.........#
D....#....#
#.........#
#.........#
#...#..#..#
#.........#
#####D#####
enemies 3
switch 0 : 0

1
1
#####d#####
#k........#
#.###.#...#
#.###.....#
#.........#
D.........d
#.........#
#.........#
#.........#
#.........#
#####D#####
key : 3

