2
4
#####D#####
#.........#
#.........#
#.........#
#...###...#
D...#.k...#
#...#.#...#
#.........#
#.........#
#.........#
#####l#####
key : 3

2
1
###########
#.........#
#.........#
#....#.#..#
#.........#
D.........D
#...#.....#
#..#......#
#.........#
#.........#
#####D#####

3
2
#####d#####
#.........#
#......#..#
#.......#.#
#.........#
l.........D
#.........#
#.#.......#
#..#......#
#.........#
#####l#####
locked : 0

1
3
###########
#.........#
#.........#
#.........#
#.........#
#.........d
#.......#.#
#......#..#
#.........#
#.........#
#####l#####
locked : 1

3
0
#####D#####
#.........#
#.........#
#.........#
#.........#
#k........D
#.........#
#.........#
#.........#
#.........#
#####D#####
key : 0

3
4
#####l#####
#.........#
#...#.#.#.#
#.........#
#..#.#.#..#
D.........#
#.#...#.#.#
#.........#
#..#...#.##
#.........#
###########
locked : 3

4
1
#####D#####
#.........#
#.........#
#.........#
#.........#
D.........D
#.........#
#.#.....#.#
#..#...#..#
##........#
###########

1
4
###########
#.........#
#......#..#
#.......#.#
#.....#...#
d.........D
#.....#...#
#.#..#....#
#..#......#
#.........#
#####D#####

2
2
###########
#.........#
#.#.#...#.#
#.........#
#..#.#.#..#
D.........D
#.....#...#
#.........#
#..#.....##
#.........#
#####d#####

0
5
###########
#.........#
#..#......#
#.#.......#
#.........#
#.........#
#.........#
#.#.....#.#
#..#...#..#
#.........#
#####D#####

3
1
#####D#####
#.........#
#.........#
#.........#
#.........#
D....#.#..l
#......#..#
#......#..#
#......##k#
#.......###
#####D#####
key : 1

2
0
###########
#k........#
#.........#
#....##...#
#.#####...#
#...#.#...D
#.###.#...#
#.###.#...#
#.........#
#.........#
#####D#####
key : 2

4
0
#####D#####
#.........#
#.........#
####......#
#.#.#.....#
#...#@#...D
#..#####..#
#.#######.#
#.........#
#......#..#
###########

4
2
#####l#####
#......#..#
#.........#
#.........#
#....#..#.#
D.........#
#.........#
##..#..#..#
#.........#
#.........#
###########
locked : 2

3
3
#####d#####
#.........#
##.#...#.##
#.........#
#..#.#.#..#
D.........D
#..#.#.#..#
#.........#
#..#...#.##
#.........#
###########

2
6
#####D#####
#.........#
#.........#
#.........#
#.........#
#.........#
#.........#
#.......p.#
#.........#
#X........#
###########

2
3
#####l#####
#.........#
#..#...#..#
#.#.....#.#
#.........#
D.........D
#.........#
#.......#.#
#......#..#
#.........#
#####d#####

1
6
###########
#.........#
#.........#
#.........#
#...##e...#
d...##....#
#...###...#
#....#.#..#
#......##.#
#.........#
#####D#####
boss
enemies 1

1
5
#####D#####
#.........#
#.........#
#.........#
#.........#
D.........d
#.........#
#.#.......#
#..#......#
#.........#
###########

