2
5
#####D#####
#.#.....#.#
#.........#
#.........#
#....#..#.#
d.........#
#.........#
#.#..#..#.#
#.........#
#.........#
###########

1
5
#####D#####
#.........#
#.........#
#.........#
#.........#
l....e....#
#.........#
#.........#
#.........#
#.........#
#####D#####
locked : 5
boss
enemies 1

0
5
###########
#........X#
#.........#
#.#.......#
#.#.......#
D..##.....#
#.........#
#.........#
#.........#
#.........#
#####D#####

1
0
###########
#.........#
#.........#
#.........#
#.........#
#.........D
#.........#
#.#.....#.#
#..#...#..#
#.........#
#####l#####
locked : 1

5
1
#####d#####
#.........#
#.#.#.#.#.#
#.........#
#..#.#.#..#
#.........#
#.#.#.#...#
#.........#
#..#...#.##
#.........#
###########

0
4
###########
#k##......#
#...#.....#
#.#.##....#
#.#####...#
#.........D
#.........#
#.........#
#.........#
#.........#
#####D#####
key : 5

1
1
###########
#.........#
#..#......#
#.#.......#
#.........#
D.........#
#.........#
#.#.......#
#..#......#
#.........#
#####D#####

2
0
#####l#####
##.#...#.##
#.........#
#..#.#....#
#.........#
#..#.#....D
#.........#
##.#.#.#.##
#k........#
##.....#.##
#####D#####
key : 0

4
2
#####D#####
#.........#
#..#..#..##
#.........#
#.........#
D..#..#...#
#.........#
#........e#
#..#..#..##
#.....s?.e#
###########
enemies 2
switch 0 : 0 1
sign A locked path — look elsewhere first.

2
4
#####D#####
#.........#
#.........#
#.........#
#.........#
D.........d
#.........#
#.........#
#.........#
#.........#
#####D#####

3
0
#####D#####
#.........#
#.........#
#....#....#
#.........#
#....@#...D
#.........#
#.........#
#.........#
#?........#
###########
sign A useful tool lies just ahead.

2
2
###########
#.........#
#..##.....#
#.#.......#
#.........#
l.........d
#...#.....#
#.#.......#
#..#......#
#.........#
#####D#####
locked : 2

3
4
#####D#####
#.........#
#.........#
#.........#
#.........#
#.........#
#.........#
#.........#
#?........#
#e.......e#
###########
enemies 2
door 0 : 0 1
sign Many have walked this path.

1
4
#####D#####
#e........#
#.........#
#....#....#
#?........#
#e........l
#.........#
#.........#
#.........#
#.........#
#####D#####
enemies 2
sign Only the prepared may pass.

3
1
#####D#####
#k........#
#.........#
#.........#
#.##..#...#
D..#.##...D
#....#....#
#.#.##....#
#.#.#.#...#
#.........#
#####l#####
key : 1

2
1
#####D#####
#.........#
#.....#...#
#.........#
#..#.#.#..#
D.........l
#.#.......#
#.........#
#..#.....##
#.........#
#####D#####

3
2
#####D#####
#.........#
#.........#
#.........#
#.........#
D........k#
#.........#
#.........#
#.........#
#.........#
#####D#####
key : 2

4
1
#####l#####
#.........#
#.###.....#
#...###...#
#..##..#..#
#..#.#....D
#....#.#..#
#....###..#
##........#
#.........#
#####d#####
locked : 0

2
3
###########
#.........#
#.........#
#.........#
#.........#
d.........D
#.........#
#.........#
#.........#
#.........#
###########

