3
1
#####.#####
#k#.....#.#
#.........#
#.........#
#....#..#.#
...........
#.........#
#.#..#..#.#
#.........#
#.........#
#####l#####
key : 1

1
1
###########
#.........#
#.........#
#.#.#.....#
#.##.#....#
..........#
#.##......#
##.#......#
#.........#
#.........#
#####.#####

2
2
###########
#.........#
#.........#
#.........#
#...#..#..#
l.........d
#.........#
##..#..#..#
#.........#
#.........#
#####.#####
locked : 2

5
1
#####d#####
#.........#
##.#.....##
#.........#
#..#.#.#..#
#.........#
#..#.#.#..#
#.........#
##.#.....##
#.........#
###########

3
4
#####.#####
#.........#
#.........#
#.....#...#
#....##...#
#...##....#
#.........#
#....#....#
#.........#
#e.....#?e#
###########
enemies 2
door 0 : 0 1
sign Many have walked this path.

0
4
###########
#k........#
#..#......#
#..#.#....#
#..##.....#
#..........
#.........#
#.........#
#.........#
#.........#
#####.#####
key : 5

2
4
#####.#####
#.........#
#..#...#..#
#.#.....###
#.........#
..........d
#...#.....#
#.........#
#.........#
#.........#
#####.#####

3
0
#####.#####
#.........#
#.........#
#.........#
#.........#
#....@.....
#.........#
#.........#
#.........#
#?........#
###########
sign A useful tool lies just ahead.

4
2
#####.#####
#.........#
#.........#
#.........#
#.........#
..........#
#.........#
#.........#
#........s#
#......?ee#
###########
enemies 2
switch 0 : 0 1
sign A locked path — look elsewhere first.

1
5
#####.#####
#.........#
#.........#
#...#####.#
#......##.#
l...#e##..#
#...#.###.#
#.........#
#.........#
#.........#
#####.#####
locked : 5
boss
enemies 1

4
1
#####l#####
##.#.....##
#.........#
#.#.#.#.#.#
#.........#
#..#.#.#...
#.........#
#...#.#.#.#
#.........#
##.#...#.##
#####d#####
locked : 0

0
5
###########
#........X#
#.........#
#.........#
#.........#
..........#
#.........#
#.........#
#.........#
#.........#
#####.#####

2
5
#####.#####
#.........#
#.........#
#.....#...#
#..#......#
d..#.#....#
#.#..#....#
#..#.#.#..#
#.#.......#
#.........#
###########

1
4
#####.#####
#e........#
#.........#
#.........#
#?........#
#e........l
#.........#
#.........#
#.........#
#.........#
#####.#####
enemies 2
sign Only the prepared may pass.

1
0
###########
#.........#
##.##.....#
####......#
#..#......#
#..........
#.........#
#.........#
#.........#
#.........#
#####l#####
locked : 1

2
3
###########
#..#...#..#
#..##..#..#
#...##.#..#
#..###.#..#
d....#.....
#...##....#
#..##.....#
#.........#
#.........#
###########

2
1
#####.#####
#.........#
#.........#
#.#..#....#
#.........#
..........l
#.#..#..#.#
#.........#
#.........#
#.#.......#
#####.#####

2
0
#####l#####
#.........#
#.........#
#.........#
#.........#
#..........
#.........#
#k#.....#.#
#..#...#..#
#.........#
#####.#####
key : 0

3
2
#####.#####
#.........#
#..#......#
#.#.......#
#.........#
..........#
#.........#
#.......#k#
#......#..#
#.........#
#####.#####
key : 2

