6
0
#####D#####
#e##......#
#.........#
#.........#
#?........#
#e........D
#.........#
#.........#
#.........#
#.........#
#####l#####
enemies 2
sign Only the prepared may pass.

3
2
###########
#........k#
#.........#
#.........#
#...#.###.#
D...####..#
#.....###.#
#...##..#.#
#.....#...#
#.........#
#####D#####
key : 2

0
3
###########
#.#.....#e#
#.........#
#.........#
#..#..#...#
D.........#
#.........#
#.#..#..#.#
#.........#
#........?#
###########
enemies 1
door 0 : 0 1
sign The dungeon remembers all who enter.

0
1
###########
#.........#
##..#..#..#
#.........#
#.........#
#.........d
#.........#
#.........#
##..#..#..#
#.........#
#####D#####

2
0
###########
#.........#
#.........#
#.........#
#...@.....#
#...####..D
#...#.###.#
#...#.....#
#......#..#
#......#..#
#####D#####

1
1
#####D#####
#.........#
#.......#.#
#...#.....#
#.........#
#..##.#...l
#.#.#..#..#
###...#...#
###.......#
#.........#
#####D#####

3
1
#####D#####
#.........#
#.........#
#....#..#.#
#.........#
D.........D
#..#..#...#
#.........#
#.........#
#.#.....#.#
#####d#####

1
2
#####D#####
#.........#
#.........#
#..#.....##
#.........#
l.........#
#...#..#..#
#.........#
#.........#
#..#.....##
###########
locked : 0

5
1
#####D#####
#.........#
#.........#
#.........#
#.........#
D...####..#
#.....k#..#
#...####..#
#..#..##..#
#..#...#..#
#####D#####
key : 8

8
0
#####D#####
#.........#
#........p#
#.........#
#.........#
#.........#
#.....#...#
#.......#.#
#.....##..#
#X.....p..#
###########

4
2
#####D#####
#.........#
#.........#
#.........#
#.........#
D.........#
#.........#
#.........#
#........s#
#.......ee#
###########
enemies 2
switch 0 : 0 1

4
1
#####d#####
#.........#
#.........#
#.........#
#.........#
D.....##..D
#.....#...#
#......#..#
#......#..#
#.........#
#####D#####

3
0
#####D#####
#.........#
#.........#
#.........#
#.........#
#.........D
#.........#
#.........#
#.........#
#.........#
#####d#####

0
2
###########
#.........#
#.........#
#.........#
#.........#
d.........D
#.........#
#.........#
#.........#
#.........#
#####D#####

4
0
#####d#####
##.....#..#
#.........#
#.........#
#......#..#
#.........D
#.........#
#...#..#..#
#.........#
#.........#
#####d#####

7
0
#####l#####
#.........#
#.........#
#.........#
#...e.....#
#....##...#
#...###...#
#...#.#...#
#.........#
#.........#
#####D#####
locked : 6
boss
enemies 1

5
0
#####d#####
##........#
#..#......#
#.#.......#
#.........#
#.........D
#.........#
#.#.....#.#
#..#...#..#
#..#......#
#####D#####

2
1
#####D#####
#........##
#........k#
#.........#
#..#..#...#
D.........#
#.........#
#.........#
#.........#
#.........#
#####D#####
key : 0

6
1
#####D#####
#.........#
#.........#
#.#.......#
#.##.#....#
D..#.#....#
#..#.#....#
####......#
##.#......#
#........k#
###########
key : 6

