3
0
#####D#####
#.........#
#.........#
#.........#
#.........#
#.........d
#.........#
#.#.....#.#
#..#...#..#
#.........#
#####d#####

3
2
#####D#####
#k........#
##........#
#.#.....#.#
#.........#
D.........D
#.........#
#.......#.#
#......#..#
#.........#
###########
key : 2

4
0
#####d#####
#.........#
#......#..#
#.......#.#
#.........#
#.........D
#.........#
#.........#
#.........#
#.........#
###########

1
4
###########
#.........#
#..#...#..#
#.##....#.#
#.........#
l.........#
#.........#
#.#.....#.#
#......#.##
#.........#
#####D#####
locked : 2

3
3
#####D#####
#.........#
#.........#
#...###.#.#
#....#k##.#
D.........D
#.....#...#
#...###.#.#
#.........#
#.........#
###########
key : 4

0
0
###########
#.#.....#.#
#.........#
#...#.#.#.#
#.........#
#...#.#...#
#.........#
#.#.#.#.#.#
#.........#
#.#.......#
#####l#####
locked : 0

1
1
###########
#.........#
#..#......#
#.#.......#
#.........#
D.........D
#.........#
#.......#.#
#......#..#
#.........#
#####D#####

2
4
#####D#####
#.........#
#.........#
#.........#
#.........#
d....e....#
#.........#
##.#......#
#.#.......#
#.........#
#####D#####
boss
enemies 1

2
3
#####D#####
#.........#
#.#.#.#.#.#
#.........#
#.#.#.#...#
d.........d
#.....#.#.#
#.........#
#.#.#.#...#
#.........#
#####D#####

1
3
###########
#e...e....#
#.........#
#.........#
#.........#
D.........l
#.........#
#.........#
#.........#
#?........#
#####D#####
enemies 2
sign Seek the matching key before you proceed.

2
1
#####D#####
#.........#
#.........#
#.........#
#.........#
D.........D
#.........#
#.#.....#.#
#..#...#..#
#.........#
#####D#####

3
1
#####D#####
#.........#
#.........#
#.........#
#.........#
d.........D
#....#.##.#
#.....###.#
#.....###.#
#.......#.#
#####D#####

0
2
###########
#e........#
#.........#
#......#..#
#.........#
#.........#
#...#..#..#
#.........#
#.........#
#......#..#
#####D#####
enemies 1

4
1
#####D#####
#.........#
#.........#
#.........#
#..###....#
D....##...#
#..#.###..#
#...#.#...#
#.........#
#.........#
###########

2
2
#####l#####
#.........#
#.........#
#.........#
#.........#
D.........d
#.........#
#.........#
#.........#
#.........#
#####D#####
locked : 1

2
0
#####D#####
#.........#
#.........#
#.........#
#.........#
#k........D
#.........#
#.......#.#
#......#..#
#.........#
#####D#####
key : 0

1
2
#####D#####
#k........#
#.#.....#.#
#.........#
#.........#
D..#..#...D
#.........#
#.........#
#.#.....#.#
#.........#
#####l#####
key : 1

3
4
#####D#####
#.........#
#.#.#.....#
#.##......#
#.....#...#
D...###...#
#..##.....#
#...##....#
#.........#
#........X#
###########

1
0
#####l#####
#.........#
#.........#
#.........#
#.........#
#?...@....D
#.........#
#.........#
#.........#
#.........#
#####D#####
sign A locked path — look elsewhere first.

