5
0
#####D#####
#.........#
#.#.#.##..#
#..###....#
#..####...#
#..#.@#...D
#.........#
#.........#
#.........#
#.........#
#####D#####

3
3
#####D#####
#k........#
#......#..#
#.......#.#
#.........#
D.........D
#.......#.#
#.#.......#
#..#......#
#.........#
#####d#####
key : 2

6
0
#####D#####
#.........#
#.........#
#..#..#...#
#.#.#.#...#
#...#.#...D
#.###.#...#
#.###.....#
#.........#
#.........#
###########

3
4
#####D#####
#.........#
#.......#.#
#.........#
#.........#
D.........#
#.........#
#.#.......#
#..#......#
#.......k##
###########
key : 3

2
4
###########
##.....#..#
#.........#
#.........#
#.........#
D.........#
#.........#
##.....#..#
#.........#
#.........#
#####D#####

4
3
#####d#####
#.........#
#..#...#..#
#.#.....#.#
#.........#
#.........#
#.........#
#.......#.#
#......#..#
#.........#
#####D#####

6
1
#####l#####
#.........#
##.#...#.##
#.........#
#....#.#..#
D.........#
#..#.#.#..#
#.........#
##.#...#.##
#.........#
###########
locked : 0

5
3
#####D#####
#.........#
#......#.##
#......####
#.....###?#
#....###..#
#....#....#
#.........#
#.........#
#e.......e#
###########
enemies 2
sign The dungeon remembers all who enter.

2
1
###########
#k........#
#..#...#..#
#.#.....#.#
#.........#
#.........D
#.........#
#.........#
#.........#
#.........#
#####D#####
key : 1

4
1
#####d#####
#.........#
#..#..#...#
#..###....#
#..#k#.#..#
D..#...#..#
#...####..#
#.........#
#.........#
#.........#
#####D#####
key : 0

4
0
###########
#.........#
#..#......#
#.#.......#
#.........#
#.........D
#.........#
#.........#
#.........#
#.........#
#####D#####

1
2
###########
#e........#
#.........#
#.........#
#.........#
#..#.#.#..D
#.#..##...#
#....#..#.#
#.....#.#.#
#.........#
#####D#####
enemies 1

2
2
#####D#####
#.........#
##.#...#.##
#.........#
#..#.#.#..#
D.........D
#..#......#
#.........#
##.#...#.##
#.........#
#####d#####

5
1
#####D#####
#.........#
#.........#
#...#..#..#
#.........#
D.........#
#......#..#
#.........#
#.........#
##.....#..#
#####l#####

3
1
#####D#####
#.........#
#.........#
#.........#
#.........#
#.........D
#.........#
#.........#
#.........#
#.........#
#####d#####

0
3
###########
#X.....##.#
####..##..#
##.#.###..#
#..#...##.#
#.........#
#.........#
#.........#
#.........#
#.........#
#####D#####

2
3
#####d#####
#e.......e#
##.#.....##
#.........#
#.#.#.#.#.#
D.........D
#....#....#
#.........#
#.#.....#.#
#.........#
#####D#####
enemies 2

1
3
#####D#####
#.........#
#.........#
#.........#
#.........#
D...#e....#
#.##.#....#
#.##......#
#.###.....#
####......#
#####d#####
boss
enemies 1

3
2
#####d#####
#.........#
#.........#
##.#.#.#.##
#.........#
D..#.#.#..D
#.........#
##.#.....##
#.........#
##.#...#.##
###########

