4
1
#####d#####
#.........#
#..#......#
#.#.......#
#.........#
..........l
#.........#
#.#.......#
#..#......#
#.........#
###########

3
0
#####.#####
#.........#
##..#.###.#
#.#.##....#
#.#.##..#.#
#..##@.....
#...#.....#
#.........#
#.........#
#.........#
#####.#####

4
2
#####.#####
#.........#
#.....###.#
#...#.#.#.#
#.....#...#
l...###....
#.........#
#.........#
#.........#
#.........#
###########
locked : 0

2
4
#####d#####
#........k#
#.....#..##
#.........#
#.........#
#..#..#....
#.........#
#.........#
#..#.....##
#.........#
#####.#####
key : 2

4
3
#####.#####
##.....#.##
#.........#
##.#.#.#.##
#.........#
...#.#.#...
#.........#
##.#.#.#..#
#.........#
##.#...#.##
###########

3
6
#####.#####
#.........#
#.........#
#.........#
#.........#
..........#
#.........#
#.........#
#.........#
#.......k##
###########
key : 3

2
1
###########
#.........#
#.........#
#.........#
#.........#
..........#
#.........#
#.#.......#
#..#......#
#.........#
#####d#####

2
6
###########
#......e.e#
##.#...#?##
#.........#
#..#.#.#..#
..........#
#..#.#.#..#
#.........#
##.#...#..#
#.........#
#####.#####
enemies 2
sign Something glints behind that door…

3
2
###########
#......k..#
#......#..#
#.......#.#
#.........#
..........l
#.........#
#.......#.#
#......#..#
#.........#
#####.#####
key : 1

3
1
#####d#####
#k........#
#.........#
#.........#
#.........#
...........
#.........#
#.#.....#.#
#..#...#..#
#.........#
#####d#####
key : 0

3
4
#####.#####
#.........#
#.........#
#.........#
#.........#
..........l
#.........#
#.........#
#.........#
#.........#
#####d#####

4
4
#####d#####
#.........#
#.#.#.#.#.#
#.........#
#..#.#....#
..........#
#.#.#.#.#.#
#.........#
#..#...#.##
#.........#
###########

2
5
###########
#.........#
##.....#.##
#.........#
#..#.#.#..#
...........
#..#...#..#
#.........#
##.#.....##
#.........#
#####.#####

3
5
#####.#####
#.........#
#.........#
#.........#
#.........#
l..........
#.........#
#.......#.#
#......#..#
#.........#
###########
locked : 2

4
0
#####.#####
#.........#
#.#.#...#.#
#.........#
#.#.#.#.#.#
#..........
#...#.#.#.#
#.........#
#.....#.#.#
#.........#
###########

0
4
###########
#X........#
#.........#
#.........#
#.........#
#.........#
#.........#
#.........#
#.........#
#.........#
#####.#####

2
0
###########
#.........#
#.........#
#.........#
#.........#
#..........
#.........#
#.#.....#.#
#..#...#..#
#.........#
#####.#####

3
3
###########
#.........#
#.........#
#.........#
#.........#
l..........
#.........#
#.........#
#.........#
#.........#
#####.#####
locked : 1

1
4
#####.#####
#.........#
#.........#
#.........#
#.........#
#....e....#
#.........#
#.........#
#.........#
#.........#
#####d#####
boss
enemies 1

