5
1
#####D#####
#.........#
#.........#
#.........#
#.........#
D..#..#...D
#.........#
#.........#
#.#.....#.#
#.k.......#
###########
key : 0

7
3
#####D#####
#.........#
##..#..#..#
#.........#
#.........#
#....#....#
#.........#
#.........#
##..#..#..#
#.........#
###########

4
4
#####d#####
#.........#
#..#......#
#.#.......#
#.........#
#.........d
#.........#
#.........#
#.........#
#.........#
#####d#####

6
4
#####D#####
#.........#
#.........#
##..#..#..#
#.........#
D.........#
#....#..#.#
#.........#
#.........#
##.....#..#
###########

1
4
#####D#####
#.#.......#
#..##.....#
#.##..#...#
#.#.#.#...#
#...e##...#
#.........#
#.........#
#.........#
#.........#
#####l#####
locked : 3
boss
enemies 1

3
5
#####D#####
#.........#
##.#...#.##
#.........#
#..#...#..#
l.........#
#......#..#
#.........#
#......#..#
#.........#
#####D#####
locked : 2

5
5
#####D#####
#.........#
#.........#
#.........#
#.........#
d.........#
#.........#
#.........#
#.........#
#.........#
###########

2
5
###########
#........k#
#..#...#..#
#.#.....#.#
#.........#
D.........#
#.........#
#.........#
#.........#
#.........#
#####D#####
key : 4

6
3
#####D#####
##.#.....##
#.........#
#....#.#..#
#.........#
#..#.#.#..D
#.........#
##.#.#.#.##
#.........#
##.#.....##
#####D#####

3
4
#####D#####
#.........#
##.#...#.##
#.........#
#.#.#.#.#.#
#.........l
#..#.#.#..#
#.........#
#...#.#.#.#
#.........#
#####d#####

4
0
###########
#.........#
#.........#
#.........#
#.........#
#.........D
#.........#
#.......#.#
#......#..#
#.........#
#####D#####

5
2
###########
#.......#.#
#.........#
#...#.....#
#.......#.#
D.........D
#.........#
#.#.......#
#..#......#
#.........#
###########

4
1
###########
#.......ee#
#..#.....##
#........e#
#.#...#...#
D.........#
#..#.#.#..#
#.........#
#...#.#.#.#
#.........#
#####D#####
enemies 3

5
0
#####D#####
#.........#
#.....#...#
#.....##..#
#.........#
#....@....D
#.........#
#.........#
#.........#
#?........#
###########
sign What you seek is close.

5
3
###########
#.........#
#.........#
#.........#
#.........#
D.........D
#.........#
#.........#
#.........#
#.........#
#####D#####

4
5
#####D#####
#.........#
#.........#
#..#.#....#
#..###....#
d...###...#
#...#.....#
#.....p.p.#
#.........#
#.........#
#####D#####

5
4
#####d#####
#.........#
#......#k##
#.#.....#.#
#....#....#
D.........d
#.........#
#.........#
#.........#
#.........#
#####D#####
key : 2

2
4
#####l#####
#k........#
##..#..#..#
#.........#
#.........#
#.........D
#.........#
#.........#
##..#..#..#
#.........#
#####D#####
key : 3

0
4
###########
#......##X#
#......##.#
#.........#
#..####.#.#
#.........#
#.###.....#
##..#.....#
#.#.#.....#
#.........#
#####D#####

