2
3
#####l#####
##.#...#.##
#.........#
##.#...#..#
#.........#
#..#.#.#..D
#.........#
#..#.#.#.##
#.........#
##.....#.##
###########
locked : 1

0
3
###########
#k........#
#.........#
#.........#
#.........#
#.........D
#.........#
#.........#
#.........#
#.........#
#####D#####
key : 2

3
4
#####d#####
#.........#
#.......#.#
#.....#.#.#
#......#..#
#....e....D
#.........#
#.........#
#.........#
#.........#
#####D#####
boss
enemies 1

1
6
###########
#........k#
#......#..#
#.......#.#
#.........#
D.........#
#.........#
#.......#.#
#......#..#
#.........#
###########
key : 3

1
0
###########
#k#.......#
#.........#
#...#.#.#.#
#.........#
#...#.#...D
#.........#
#.#.#.#.#.#
#.........#
#.#.....#.#
#####D#####
key : 0

4
4
#####D#####
#.........#
#.........#
#.........#
#.........#
#.........#
#.........#
#.........#
#.........#
#X........#
###########

1
2
###########
#........##
#.....k#..#
#....###.##
#.....###.#
D.....#...D
#....##...#
#....###.##
#.........#
#.........#
###########
key : 1

3
5
#####D#####
#.........#
##.....#.##
#.........#
#.#.......#
D.........#
#..#...#..#
#.........#
#.#.#...#e#
#.......ee#
###########
enemies 3

0
5
###########
#.........#
#.....#..##
#.........#
#.........#
D..#..#...#
#.........#
#.........#
#..#..#..##
#.........#
#####d#####

2
5
#####l#####
###.......#
##.##..#..#
##...#.#..#
#..##..#..#
D..#......#
#.........#
#.........#
#.........#
#.........#
#####D#####
locked : 3

2
4
#####D#####
#.........#
##.#...#.##
#.........#
#......#..#
D.........D
#..#.#.#..#
#.........#
#..#...#.##
#.........#
#####d#####

2
0
#####D#####
#.........#
#.........#
#.........#
#..#@#....#
#..#.#....D
#...##....#
#.#.......#
#.#...#...#
#?........#
###########
sign Those who search shall find.

1
5
#####d#####
#......#.##
#.........#
##...#.#.##
#.........#
d..#.#.#..D
#.........#
#....#...##
#.........#
##.#...#.##
#####l#####

1
1
#####D#####
#.........#
#.#.......#
#...#.#...#
#.##.#....#
D..#......D
#.##......#
####......#
#...#.....#
#p........#
#####l#####
locked : 0

2
1
#####l#####
#.........#
#.........#
#.###.....#
#..#......#
D..##.....#
#.........#
#.........#
#.........#
#........e#
###########
enemies 1

0
1
###########
##.#...#..#
#.........#
#.#.#.#.#.#
#.........#
#..#.#.#..#
#.........#
#.#.#.#.#.#
#.........#
##.#...#..#
#####D#####

1
3
#####D#####
#..#.....##
#.........#
#.........#
#...#..#..#
D.........l
#.........#
#..#.....##
#.........#
#.........#
#####l#####

1
4
#####D#####
#.........#
##.....#.##
#.........#
#..#.#.#..#
l.........d
#..#...#..#
#.........#
##.#.....##
#.........#
#####D#####
locked : 2

0
4
###########
#.........#
#.........#
#.........#
#.........#
D.........D
#.........#
#.........#
#.........#
#.........#
#####D#####

