0
0
###########
#k........#
#..#......#
#.#.......#
#.........#
#.........#
#.........#
#.......#.#
#......#..#
#.........#
#####D#####
key : 1

1
2
###########
#......#.##
#.........#
##.#.#.#.##
#.........#
#....#.#..D
#.........#
##.#.#.#.##
#.........#
##.#...#.##
#####l#####
locked : 1

3
2
#####D#####
#.........#
#.......#.#
#.........#
#.........#
D.........D
#.........#
#.........#
#.#.....#.#
#.........#
#####D#####

4
1
#####d#####
#.#.......#
#.........#
#.........#
#.........#
#.........d
#.........#
#.#.......#
#..#......#
#.........#
#####D#####

4
2
#####D#####
#.........#
#..#......#
#.#.......#
#.........#
d.........D
#.........#
#.#.......#
#..#......#
#.........#
#####d#####

2
2
#####l#####
#.........#
#.........#
#.........#
#.........#
D.........D
#.........#
#.p.......#
#.........#
#.........#
#####D#####

2
1
###########
#.#.....#.#
#.........#
#..#.#.#.##
#.........#
l...#.#...D
#.........#
#..#.#.#.##
#.........#
#.#.....#.#
#####D#####
locked : 0

6
2
#####D#####
#.........#
#.........#
#.........#
#.........#
#.........#
#.........#
#.........#
#.........#
#X........#
###########

1
3
###########
#.........#
##.#...#.##
#.........#
#.#.#.#.#.#
D.........#
#....#.#..#
#.........#
#.#.#.#.#.#
#.........#
#####D#####

5
1
#####D#####
##.#...#.##
#.........#
#.#.#...#.#
#.........#
#..#.#.#..D
#.........#
#.#...#...#
#e........#
##.....#.##
###########
enemies 1

2
0
#####D#####
#......#..#
#......#..#
#..#...#..#
#..##.....#
#?.#@#.#..l
#.........#
#.........#
#.........#
#.........#
#####D#####
sign A locked path — look elsewhere first.

5
2
#####d#####
#.........#
#.........#
#......#.##
#.........#
D....e....#
#.........#
#.........#
#.........#
#.........#
#####D#####
boss
enemies 1

3
0
#####D#####
#.........#
##.#...#..#
#.........#
#.#.#.#.#.#
#.........D
#..#...#..#
#.........#
#.#.#.#.#.#
#.........#
###########

2
3
#####D#####
#.........#
#......#..#
#.......#k#
#.........#
D.........#
#.........#
#.......#.#
#......#..#
#.........#
#####d#####
key : 3

4
3
#####l#####
#.#.......#
#.........#
#.........#
#.#.....#.#
D.........#
#.........#
#....#..#.#
#.........#
#.........#
###########
locked : 5

1
0
#####D#####
#.........#
#.........#
#.........#
#.........#
#k........#
#.........#
#.........#
#.........#
#.........#
#####D#####
key : 0

3
3
#####d#####
#.........#
#.........#
#.........#
#.........#
D.........D
#.........#
#.........#
#.........#
#.........#
#####l#####

3
1
#####D#####
#e........#
#.........#
#.........#
#.........#
D.........D
#.........#
#.#.......#
#.e.......#
#e#.......#
#####d#####
enemies 3

3
4
###########
#........k#
#......#..#
#.......#.#
#.........#
D.........#
#.........#
#.#.......#
#..#......#
#.........#
###########
key : 5

