4
2
#####.#####
#.........#
#.........#
#.........#
#.........#
...........
#.........#
#.........#
#.........#
#....k....#
###########
key : 4

1
3
###########
#........X#
#..##.#...#
#...##....#
#...#.....#
..........#
#.........#
#.........#
#.........#
#........##
#####.#####

3
4
###########
#.........#
#.........#
##..#..#..#
#.........#
d.........#
#...#..#..#
#.........#
#.........#
#.........#
###########

0
0
###########
#.........#
#..#......#
#.#.......#
#.........#
#.........#
#.........#
#.#.......#
#..#......#
#.........#
#####.#####

4
3
#####d#####
#.........#
#.........#
#.........#
#...##..#.#
......#...#
#....###..#
#.....#.#.#
#.....#...#
#.........#
###########

3
3
#####l#####
#.........#
#.........#
#.........#
#.........#
l.........d
#.........#
#.......#.#
#......#..#
#.........#
#####d#####
locked : 4

1
0
#####.#####
#.........#
#......#..#
#.......#k#
#.........#
#.........#
#.........#
#.......#.#
#......#..#
#.........#
#####.#####
key : 1

4
1
#####.#####
#.........#
##.#...#..#
#.........#
#..#.#.#..#
...........
#....#.#..#
#.........#
##.....#.##
#.........#
#####d#####

3
0
#####.#####
#.........#
#.........#
#.........#
#.........#
#....@....l
#.........#
#.........#
#.........#
#.........#
#####.#####

5
1
#####d#####
#.#....#..#
#......#..#
#.......#.#
#.........#
...#......#
#.........#
#.......#.#
#......#..#
#.........#
###########

5
0
#####d#####
#.........#
#...#..#..#
#.........#
#.........#
#....#.....
#.........#
#.........#
##..#.....#
#.........#
###########

2
2
#####.#####
#e##......#
#.#e#.....#
#...#.....#
#.#.......#
...........
#.........#
#.........#
#.........#
#?.#......#
#####.#####
enemies 2
sign Seek the matching key before you proceed.

4
0
#####.#####
#........##
#......#..#
#.......#.#
#.........#
#..........
#.........#
#.#.......#
#..##.....#
#.........#
#####d#####

1
2
###########
#.........#
#.........#
#.........#
#.........#
#..........
#.........#
#.........#
#.........#
#.........#
#####.#####

2
0
#####.#####
#.........#
###.#.....#
##k#......#
#.........#
#...#......
#..#......#
#.........#
#.........#
#.........#
#####.#####
key : 0

3
1
#####.#####
#.........#
#.........#
##..#..#..#
#.........#
l..........
#.#..#..#.#
#.........#
#.........#
##.....#..#
#####.#####
locked : 0

2
3
#####.#####
#.........#
#.........#
#.........#
#.........#
.....e....#
#......#..#
#.........#
#.....#...#
#.........#
#####l#####
locked : 2
boss
enemies 1

3
2
#####.#####
#k........#
#.........#
#.........#
#.........#
..........l
#.........#
#.#.....#.#
#..#...#..#
#.........#
#####.#####
key : 2

2
1
###########
#e...e....#
#.........#
#.........#
#.#..#....#
...#.......
#.#..#....#
#.#..##...#
#.........#
#.........#
#####.#####
enemies 2

