4
1
#####D#####
#.........#
#..#.....##
#.........#
#..#......#
D.........#
#..#.#.#..#
#.........#
##.#...#.##
#.........#
#####D#####

4
3
#####D#####
##.#...#.##
#.........#
#.......#.#
#.........#
#..#.#.#..#
#.........#
#.#.#...#.#
#.........#
#ee#.....##
###########
enemies 2

2
0
###########
#.........#
#.........#
#.........#
#.........#
#.........D
#.........#
#.......#.#
#......#..#
#.........#
#####D#####

1
3
#####D#####
#.........#
#.........#
#.........#
#.........#
#....e....#
#.........#
#.........#
#.........#
#.........#
#####d#####
boss
enemies 1

3
1
#####d#####
#.#.....#.#
#.........#
#.#...#.#.#
#.........#
D...#.#...D
#.........#
#.#...#.#.#
#.........#
#.#.....#.#
#####D#####

3
4
#####D#####
#.........#
#.##......#
#.#..#....#
#....#....#
l..####...#
#..#......#
#...#.....#
#.........#
#.........#
###########
locked : 0

5
2
###########
#.........#
#..#......#
#.#.......#
#.........#
d.........#
#.........#
#.#.......#
#..#......#
#.........#
###########

3
2
###########
###k......#
##.#..##..#
##..####..#
#..######.#
D...#.....d
#.........#
#.........#
#.........#
#.........#
###########
key : 0

7
1
#####D#####
#.........#
#.........#
#....#....#
#....#.#..#
#....#....#
#....#....#
#.........#
#.........#
#.........#
###########

6
1
#####D#####
#.........#
#.........#
#....#..#e#
#.........#
#.........#
#..#..#...#
#.........#
#.........#
#e#.....#e#
#####D#####
enemies 3
door 0 : 0

2
4
###########
#....k....#
#.........#
#.........#
#.........#
D.........D
#.....#...#
#......p#.#
#.......#.#
#.........#
#####D#####
key : 3

5
1
#####D#####
#k#.....#.#
#.........#
#...#.#.#.#
#.........#
#...#.#...d
#.........#
#.#.#.#.#.#
#.........#
#.........#
#####D#####
key : 1

2
1
###########
#..#.....##
#.........#
#.........#
#.........#
D.........#
#.........#
#..#..#..##
#.........#
#.........#
#####d#####

2
5
###########
#........k#
#..#......#
#.#.......#
#.........#
D.....#...#
#.......#.#
#.......#.#
#......#..#
#.........#
###########
key : 4

0
3
###########
#X.#...#..#
#..#......#
#....##...#
#...####..#
#.........#
#.........#
#.........#
#.........#
#.........#
#####D#####

3
3
#####l#####
#.#.....#.#
#.........#
#.#.#.#.#.#
#.........#
d...#.#...l
#.........#
#.#...#...#
#.........#
#.#.......#
#####D#####

2
3
#####d#####
#.........#
#.........#
#.........#
#.........#
#.........D
#.....p...#
#p........#
#.........#
#.........#
#####l#####
locked : 1

3
0
#####D#####
#......#..#
#.........#
#.........#
#.........#
#?...@....D
#.........#
#.........#
#.........#
#.........#
#####D#####
sign The dungeon remembers all who enter.

4
0
#####D#####
#.#.....#.#
#.........#
#..#.#....#
#.........#
#...#.....D
#.........#
#..#...#.##
#..?......#
#e#s....#.#
###########
enemies 1
switch 0 : 0
sign Beware what lurks ahead.

