3
1
#####l#####
#.........#
#.........#
#.........#
#.........#
D.........D
#.........#
#.#.....#.#
#..#...#..#
#.........#
#####d#####
locked : 1

1
0
#####D#####
#.........#
#.........#
#.........#
#...#.....#
#k........D
#.........#
#.........#
#.........#
#.........#
#####D#####
key : 0

4
4
#####D#####
#.........#
#.........#
#.........#
#.........#
d.........D
#..#......#
#.##......#
#.#.......#
#.........#
###########

2
5
###########
#..#.....X#
#.........#
##........#
#.........#
D..##.....#
#.........#
#...#.....#
##.#......#
#.........#
#####D#####

2
2
###########
#....k....#
#.........#
#.........#
#.........#
D.........D
#.........#
#.........#
#.........#
#.........#
#####D#####
key : 2

3
3
#####D#####
#.........#
#..#......#
#...##....#
#....###..#
d..#####..d
#.........#
#.........#
#.........#
#.........#
#####D#####

2
0
#####D#####
#.........#
#...#..#..#
#....####.#
#.......#.#
#?...@....D
#.........#
#.........#
#.........#
#.........#
#####l#####
sign Seek the matching key before you proceed.

3
4
#####D#####
#.#.......#
#.........#
#.#...#...#
#.........#
d...#.#...l
#.........#
#.#.#.....#
#.........#
#.......#.#
#####D#####

2
3
###########
##.#...#..#
#.........#
#.#.#.#.#.#
#.........#
D..#.#.#..D
#.........#
#.#.#.#.#.#
#.........#
##.#...#.##
#####D#####

1
1
###########
#........k#
#.........#
#.........#
#.........#
D..#......#
#.##......#
##........#
#.........#
#.........#
#####D#####
key : 1

3
0
#####l#####
#.........#
#.........#
#.........#
#.........#
#....#....D
#.........#
#.........#
#.........#
#.......#.#
###########
locked : 0

2
1
#####D#####
#.........#
#.........#
#....p....#
#.........#
D.........D
#.........#
#....p....#
#.........#
#.........#
#####l#####

0
0
###########
#.........#
#.........#
#.........#
#.........#
#.........#
#.........#
#.#.....#.#
#..#...#..#
#.........#
#####D#####

3
2
#####D#####
#.........#
#.........#
#.........#
#.........#
D.........d
#.........#
#p........#
#......p..#
#.........#
###########

4
1
#####d#####
#.........#
#......#..#
#.......#.#
#.........#
#.........#
#.........#
#.........#
#.........#
#.........#
###########

3
5
#####D#####
#.........#
#.........#
#.........#
#.#.#.....#
l..#.e....#
#..###....#
#...##....#
#...#.....#
#.........#
#####D#####
locked : 4
boss
enemies 1

4
5
#####D#####
#.........#
#...#.#...#
#...###...#
#....#....#
D....###..#
#...#.###.#
#...#...#.#
#.....#.#.#
#.....e##e#
###########
enemies 2

2
4
###########
#..e.?e..e#
#..#..#..##
#.........#
#.........#
D.........D
#.........#
#.........#
#..#..#...#
#.........#
#####D#####
enemies 3
sign Many have walked this path.

4
3
#####D#####
#.........#
#.........#
#.........#
#.........#
#.........d
#......#..#
#.#.....#.#
#..#...#..#
#k........#
###########
key : 4

