4
1
#####d#####
#.........#
#.........#
#.........#
#.........#
#.........#
#.........#
#.#.....#.#
#..#...#..#
#.........#
###########

3
3
#####.#####
#.........#
#.........#
#.........#
#...#.....#
d.........d
#.........#
#.........#
#.........#
#.........#
#####.#####

2
5
###########
#........X#
#.........#
#.........#
#.........#
..........#
#.........#
#.........#
#.........#
#.........#
#####.#####

4
5
#####.#####
#.#.....#.#
#.........#
#..#.#...##
#.........#
....#.....#
#.........#
#..#.#...##
#........e#
#.#.....#e#
###########
enemies 2

3
2
#####.#####
#.........#
#..#......#
#.#.......#
#.........#
..........d
#.........#
#.#.......#
#..#......#
#.........#
###########

3
1
#####l#####
#.........#
##........#
#....###.##
#...###...#
......##...
#...####..#
#....#....#
#.........#
#.........#
#####d#####
locked : 1

2
0
#####.#####
#.........#
#.........#
#.........#
#.........#
#?...@.....
#.........#
#.........#
#.........#
#.........#
#####l#####
sign Seek the matching key before you proceed.

3
0
#####l#####
#.........#
#.........#
##..#..#..#
#.........#
#..........
#...#..#..#
#.........#
#.........#
##........#
###########
locked : 0

0
0
###########
#.......#.#
#.........#
#...#.#.#.#
#.........#
#.....#...#
#.........#
#.#...#.#.#
#.........#
#.#.......#
#####.#####

1
1
###########
#........k#
#......#..#
#.......#.#
#.........#
..........#
#.........#
#.......#.#
#......#..#
#.........#
#####.#####
key : 1

3
4
#####.#####
#.........#
#..#......#
#.#.......#
#.........#
d.........l
#.........#
#.........#
#.........#
#.........#
#####.#####

4
3
#####.#####
###.......#
#.###.....#
#.##......#
#..#......#
#..#......d
#.........#
#.........#
#.........#
#k........#
###########
key : 4

4
4
#####.#####
#.........#
##.#...#.##
#.........#
#..#.#....#
d..........
#..#...#..#
#.........#
#..#...#.##
#.........#
###########

2
1
#####.#####
#.#.......#
#.........#
#.........#
#.........#
.....#.....
#.........#
#.#.....#.#
#..#...#..#
#.......#.#
#####l#####

2
3
###########
#.........#
#..#......#
#.#.......#
#.........#
...........
#.........#
#.........#
#.........#
#.........#
#####.#####

2
2
###########
#.....k...#
#.....#...#
#.........#
#.........#
...........
#.........#
#.........#
#.........#
#.......#.#
#####.#####
key : 2

3
5
#####.#####
#......#..#
#.....#...#
#....##...#
#.........#
l....e....#
#...#.#...#
#...#.#...#
#.........#
#.........#
#####.#####
locked : 4
boss
enemies 1

2
4
###########
##e#e.?#e##
#.........#
#....#.#.##
#.........#
...#.#.#...
#.........#
##.#.#.#.##
#.........#
##.#.....##
#####.#####
enemies 3
sign Many have walked this path.

1
0
#####.#####
#k#.....#.#
#.........#
#.#...#.#.#
#.........#
#...#.#....
#.........#
#.#...#.#.#
#.........#
#.#.....#.#
#####.#####
key : 0

