0
4
###########
#........k#
#..#......#
#.#.......#
#.........#
..........#
#.........#
#.........#
#.........#
#.........#
#####.#####
key : 6

0
2
###########
#X........#
#...#.#...#
#.....#...#
#.#..#....#
#....#.....
#..####...#
#.........#
#.........#
#.........#
#####.#####

2
2
#####d#####
#.........#
#.........#
#.........#
#.........#
#..........
#.........#
#.........#
#.........#
#.........#
#####d#####

3
4
###########
#.........#
#..#......#
#.#.......#
#.........#
l.........#
#..#......#
#.........#
#.........#
#.........#
###########
locked : 2

2
0
###########
#.........#
#.#...#.#.#
#.........#
#..#.#.#..#
#.........#
#...#.#.#.#
#.........#
#......#.##
#.........#
#####.#####

1
3
#####.#####
#e......?e#
#.......#.#
#.........#
#.........#
...........
#.........#
#.........#
#.........#
#e.......s#
#####.#####
enemies 3
switch 0 : 0 1
sign The dungeon remembers all who enter.

4
0
#####.#####
#.........#
#.........#
#.........#
#.........#
#?...@.....
#.........#
#.........#
#.........#
#.........#
#####.#####
sign What you seek is close.

1
4
#####.#####
#.........#
#...#.#.#.#
#.........#
#.#.#.#...#
..........#
#.#.#.#...#
#.........#
#...#.#..?#
#.....e.ee#
###########
enemies 3
door 0 : 0 1
sign A useful tool lies just ahead.

2
3
#####.#####
#.........#
#.........#
#.........#
#.........#
..........#
#.........#
#.#.......#
#..#......#
#.........#
#####d#####

4
2
#####.#####
#.........#
#.........#
#.........#
#.........#
..........#
#.........#
#.........#
#.........#
#.........#
###########

5
1
#####.#####
#.........#
#.........#
#.....###.#
#.......#.#
..........#
#.........#
#.........#
#.........#
#.........#
###########

3
2
#####d#####
#.........#
#.........#
#.........#
#.........#
l.........d
#.........#
#.........#
#.........#
#.........#
#####.#####
locked : 0

3
3
#####d#####
#.........#
#......#..#
#.......#.#
#.........#
d.........l
#.........#
#.........#
#.........#
#.........#
###########

1
2
#####.#####
#.........#
#.........#
#.........#
#...#.##..#
#...#e##...
#...##.##.#
#...#..#..#
#...#...#.#
#.........#
#####d#####
boss
enemies 1

3
1
###########
#.........#
#.........#
#.........#
#..#..#...#
...###....l
#.##k##...#
#.##..#...#
#.#.#.#...#
#.........#
#####.#####
key : 2

3
0
#####.#####
#.........#
#.....#.#.#
#.........#
#..#.#.#..#
#k.........
#...#.#.#.#
#.........#
#..#...#..#
#.........#
#####.#####
key : 0

4
1
#####.#####
###.......#
##.##.....#
##..####..#
#.#..###..#
...#.###...
#....###..#
#..#..##..#
#.........#
#.........#
#####.#####

0
3
###########
#....e....#
#.........#
#.........#
#...###e#.#
....e###...
#.#######.#
#...#.....#
#...#.....#
#.........#
#####.#####
enemies 3

5
0
#####.#####
#.........#
#.........#
#.........#
#......#..#
#..........
#.........#
#.#.......#
#..#......#
#k........#
###########
key : 1

