2
1
#####l#####
#.........#
#..#......#
#.#.......#
#.........#
...........
#.........#
#.......#.#
#......#..#
#.........#
#####l#####

3
1
#####l#####
#.........#
##..#..#..#
#.........#
#.........#
....#......
#.........#
#.........#
#.........#
#.........#
#####.#####
locked : 2

0
1
###########
#........k#
#.........#
#.........#
#.........#
..........#
#.........#
#.#.....#.#
#..#...#..#
#.........#
#####.#####
key : 1

1
2
###########
#........##
###.......#
##........#
#.###.....#
.......#..#
#.........#
#.........#
#.........#
#.........#
#####l#####
locked : 0

4
2
#####l#####
#.........#
#..#...#..#
#.#.....#.#
#.........#
..........#
#.........#
#.........#
#.........#
#.........#
###########
locked : 4

3
4
###########
#.........#
#.#.....#.#
#.........#
#.#.#.#.#.#
d.........d
#.#.#.#.#.#
#.........#
#...#.#.#.#
#.........#
#####d#####

2
3
###########
#.........#
#.........#
#.........#
#.........#
..........#
#.........#
#.#.......#
#..#......#
#.........#
#####.#####

5
4
#####.#####
#.........#
#.........#
#.........#
#.........#
#.........#
#.........#
#.........#
#.........#
#X........#
###########

1
0
#####.#####
#.........#
#......#..#
#.......#.#
#.........#
#..........
#k#.......#
#.........#
#.........#
#..#......#
#####.#####
key : 0

1
1
#####.#####
#.........#
#..#......#
#.#.......#
#.........#
...........
#.........#
#.........#
#.........#
#.........#
#####l#####
locked : 1

2
2
#####l#####
#k........#
#...#.##..#
#.....#...#
#...#.....#
...........
#.........#
#.........#
#.........#
#.........#
#####.#####
key : 2

3
5
###########
#..#......#
#..#......#
#.........#
#.........#
d.........#
#.........#
#.#.....#.#
#..#...#..#
#.........#
###########

0
0
###########
#.........#
#.........#
#.........#
#.........#
#..##@.....
#.#.......#
#..##.....#
#.........#
#.........#
#####.#####

3
2
#####.#####
#.........#
#......#.##
#.........#
#..#.#.#..#
...........
#..#.#.#..#
#.........#
##.#.....##
#.........#
#####l#####

4
1
#####.#####
#.........#
#.........#
#.........#
#.........#
#..........
#.........#
#.......#.#
#......#..#
#k........#
###########
key : 4

4
4
#####d#####
#.........#
#.........#
#.........#
#.........#
#....e....#
#.........#
#.........#
#......#..#
#.........#
#####.#####
boss
enemies 1

3
0
#####d#####
#.........#
#.........#
#.........#
#.........#
#..........
#.........#
#.#.......#
#..#......#
#.........#
###########

3
3
#####.#####
#.........#
#......#..#
#.......#.#
#.........#
..........d
#.........#
#.#.......#
#..#......#
#.........#
###########

2
0
#####.#####
#.........#
#...#.....#
#...##....#
#.........#
#e.........
#e#e#.....#
#...#.....#
#.........#
#.........#
#####d#####
enemies 3

