6
0
#####D#####
#.........#
#..#......#
#....#....#
#.........#
#.........D
#.........#
#.##....#.#
#..#...#..#
#.........#
###########

5
2
#####D#####
#.........#
#.........#
#.........#
#.........#
D.........#
#.........#
#.........#
#.........#
#.........#
#####D#####

4
0
###########
#k.....p..#
#.........#
#p...#.#..#
#....#.#..#
#....##...D
#....###..#
#.....#..##
#.........#
#......#.##
#####D#####
key : 1

6
2
#####D#####
#.........#
#.........#
#.#.......#
#.........#
l.....#...D
#.........#
#.........#
#.........#
#.........#
#####D#####
locked : 1

4
2
#####D#####
#.........#
#.........#
#..#.....##
#.........#
l.........d
#.........#
#.........#
#.........#
#..#.....##
#####D#####
locked : 2

4
3
#####D#####
#.........#
#..#...#..#
#.#.......#
#.........#
d.........#
#.#.....#.#
#.#.......#
#..#......#
#.........#
###########

2
2
#####d#####
#.........#
#.........#
#.........#
#....#....#
#....#....#
#.........#
#.#.....#.#
#..#...#..#
#.........#
#####l#####
locked : 3

1
2
#####D#####
#.........#
#...#..#..#
#....##.#.#
#...###...#
#..#e#.#..#
#....#.##.#
#p..#.....#
#........p#
#.........#
#####d#####
boss
enemies 1

7
2
#####D#####
#.........#
#.........#
#.........#
#...#####.#
D...#.....#
#....##.#.#
#.....#...#
#...#...#.#
#.........#
###########

6
1
#####l#####
#.........#
#.........#
#.........#
#.#.......#
D.........l
#.........#
#.........#
#.........#
#.........#
#####D#####
locked : 0

3
2
#####l#####
#.........#
#.........#
##.....#..#
#.........#
#.........D
#....#..#.#
#.........#
#.........#
##.....#..#
#####D#####

3
3
###########
#.........#
##.#......#
#.........#
#..#......#
D.........#
#..#.#.#..#
#.........#
#..#...#.##
#.........#
#####D#####

7
1
#####D#####
#.........#
#.........#
##..#..#..#
#k........#
#.........D
#.#.....#.#
#.........#
#.........#
##........#
#####d#####
key : 2

5
0
#####D#####
#.........#
#.........#
#.........#
#.........#
#....@#...D
#....##...#
#.....#...#
#.........#
#.........#
#####D#####

4
1
###########
#.........#
#.........#
#.........#
#.....p...#
D.........l
#.........#
#........p#
#.........#
#.........#
#####d#####

6
3
###########
#..#.....##
#.........#
#.........#
#..#..#...#
D.........#
#.........#
#..#..#..##
#.........#
#........k#
###########
key : 3

0
2
###########
#X##......#
#.#...#...#
#.##..#...#
#.##.#....#
#..#.#....#
#.........#
#.........#
#.........#
#.........#
#####D#####

5
1
#####d#####
#k........#
#.....#...#
#.........#
#.........#
D.........D
#.........#
#.........#
#.........#
#.........#
#####l#####
key : 0

8
1
#####d#####
#..#.....##
#.........#
##.#.#.#.##
#.........#
#..#......#
#.........#
#..#.#.#.##
#.........#
##.#...#.##
###########

