4
0
#####.#####
#.........#
#..#......#
###.......#
#.........#
#..........
#.........#
#.........#
#.........#
#e........#
###########
enemies 1

1
4
#####.#####
#.........#
#.........#
#.........#
#.#.......#
.....e....#
#.........#
#.........#
#...#.....#
#.........#
#####d#####
boss
enemies 1

1
2
#####.#####
#.........#
#.........#
#.........#
#.........#
#..#.......
#.##......#
#.....#...#
#.........#
#.........#
#####d#####

4
1
#####d#####
#.........#
#......#.##
#.........#
#.....#...#
...........
#..#...#..#
#.........#
#.#.#.#.#.#
#.........#
###########

3
1
#####.#####
#.........#
#.#...#.#.#
#.........#
#.#...#.#.#
...........
#...#.#.#.#
#.........#
#.#.....#.#
#.........#
#####d#####

3
2
#####l#####
#.........#
#.........#
#.........#
#.........#
....#......
#.###.....#
####......#
#.........#
#.........#
#####.#####
locked : 1

2
0
#####.#####
#.........#
#.........#
#.........#
#.........#
#..........
#.........#
#.........#
#.........#
#.........#
#####.#####

3
3
#####.#####
#.........#
#......#..#
#.......#.#
#.........#
..........d
#.........#
#.........#
#.........#
#.........#
###########

2
2
#####d#####
##........#
#.........#
#.........#
#...#..#..#
l..........
#.........#
#......#..#
#.........#
#.........#
#####l#####
locked : 2

1
0
###########
#k#.....#.#
#.........#
#.#.#.....#
#.........#
#...#.#...#
#.........#
#...#.#.#.#
#.........#
#.#.....#.#
#####.#####
key : 0

0
2
###########
#......#..#
#.......#.#
#.......#.#
#.........#
#.........#
#.........#
#.........#
#.........#
#.........#
#####.#####

1
3
###########
#.........#
#......#..#
#..#....#.#
#.........#
...........
#.........#
#.....#.#.#
#.........#
#.........#
#####l#####
locked : 0

3
4
#####.#####
#.........#
##..#.....#
#....#....#
#.###.#...#
d..#......#
#..#......#
#.........#
#..#......#
#.........#
###########

3
0
#####.#####
#.........#
#.........#
#.........#
#.........#
#....@.....
#.........#
#.........#
#.........#
#.........#
#####.#####

0
4
###########
#X........#
#.........#
#.........#
#.........#
#.........#
#.........#
#.........#
#.........#
#.........#
#####.#####

2
3
#####l#####
#e........#
#.........#
#.#..#..#.#
#.........#
...........
#.........#
#.........#
#.........#
#.......#e#
#####.#####
enemies 2

4
2
#####.#####
#.#.....#.#
#.........#
#..#.#.#.##
#.........#
....#.#...#
#.........#
#..#.#.#.##
#.........#
#.#.....#k#
###########
key : 2

2
1
###########
#....k....#
#.........#
#.........#
#.........#
..........l
#.........#
#.........#
#.........#
#.........#
#####.#####
key : 1

2
4
#####d#####
#.........#
#.........#
#.........#
#.........#
.........k#
#.........#
#.........#
#.........#
#.........#
#####.#####
key : 3

