4
4
#####D#####
#.........#
###.......#
#.#..#....#
#.........#
D.........#
#.........#
#.........#
#........?#
#.......ee#
###########
enemies 2
door 0 : 0
sign A useful tool lies just ahead.

2
0
#####D#####
#.........#
#.....##..#
#.......#.#
#.........#
#....##...D
#.........#
#.........#
#.........#
#.........#
#####l#####
locked : 0

2
2
###########
##k.......#
#.........#
#.........#
#.#..#..#.#
D.........D
#.........#
##..#..#..#
#.........#
#.........#
#####D#####
key : 2

4
0
#####D#####
#.........#
#.........#
#.........#
#.........#
#k...#.#..D
#....#..#.#
#.....#...#
#.....#..##
#......####
#####D#####
key : 0

4
3
#####D#####
#..#.....##
#.........#
#.........#
#...#..#..#
#.........D
#.........#
#..#.....##
#.........#
#k........#
###########
key : 3

1
3
#####D#####
#.........#
#.........#
#.........#
#.###.....#
#..###....#
#..#e#....#
#....#....#
###.......#
#.........#
#####d#####
boss
enemies 1

2
1
#####D#####
#e.#.....##
#.........#
#.........#
#..#..#...#
D.........D
#.........#
#..#.....##
#.........#
#.........#
#####d#####
enemies 1

1
0
#####D#####
#.........#
#.........#
#...##...p#
#.###.....#
#..#......D
#...#.....#
##..#.....#
##.#......#
#.........#
#####D#####

1
1
###########
#.........#
#......#..#
#.......#.#
#.........#
D.........#
#.........#
#.......#.#
#......#..#
#.........#
#####D#####

3
0
#####l#####
#.........#
#.........#
#.........#
#...@.....#
#....##...D
#....##...#
#....#?#..#
#.........#
#.........#
#####D#####
sign A locked path — look elsewhere first.

5
0
#####D#####
#.........#
#..#......#
#.#.......#
#.........#
#.........#
#.........#
#.........#
#.........#
#.........#
###########

3
1
#####d#####
#.........#
#.........#
#.........#
#.##......#
D..#......D
#.#.#.....#
###.#.....#
#.........#
#.........#
#####l#####

2
3
#####d#####
#.........#
#.........#
#.........#
#.........#
D.........#
#.........#
#.........#
#.........#
#.........#
#####D#####

3
2
#####D#####
#.........#
#.#...#.#.#
#.........#
#.#.#.#.#.#
D.........d
#.....#...#
#.........#
#...#.#...#
#...k.....#
###########
key : 1

3
4
###########
#.........#
###....#..#
#..#....#.#
#.........#
d.........#
#.........#
#.#.....#.#
#..#...#..#
#.........#
#####D#####

0
0
###########
#es......e#
#e#.....#.#
#.........#
#.........#
#..#..#...#
#.........#
#.........#
#.........#
#.........#
#####D#####
enemies 3
switch 0 : 0

0
3
###########
#X........#
#.........#
#.........#
#.........#
#....##...#
#.........#
#...#.....#
#.........#
#.........#
#####D#####

4
1
#####l#####
#.........#
#..#......#
#.#.......#
#.........#
D.........#
#.........#
#.......#.#
#......#..#
#.........#
###########
locked : 1

3
3
#####D#####
#.........#
#.........#
#.........#
#.........#
d..#..#...d
#.........#
#.........#
#.#.....#.#
#.........#
#####D#####

