4
1
#####d#####
#..#.....##
#.........#
#.........#
#...#..#..#
D.........#
#.........#
#..#..#..##
#.........#
#.........#
#####l#####
locked : 1

1
6
###########
#........k#
#..#...#..#
#.#.....#.#
#.........#
D.........#
#.........#
#.#.....#.#
#..#...#..#
#.........#
###########
key : 4

2
4
#####d#####
#.........#
#.........#
#.........#
#.........#
D.........D
#.........#
#.........#
#.........#
#.........#
#####D#####

3
4
#####D#####
#.........#
#.........#
#.#..#..#.#
#.........#
D.........#
#.#..#..#e#
#.........#
#........?#
#......e#e#
###########
enemies 3
sign Many have walked this path.

5
0
#####l#####
#.........#
#.........#
#.........#
#.........#
#....@....D
#....###..#
#....######
#........##
#......#.##
#####D#####

1
4
#####D#####
#.........#
#.........#
#.........#
#....#..#.#
#....e....D
#.....##..#
#.......###
#.....##.##
#.........#
#####d#####
boss
enemies 1

2
2
###########
#.........#
#......#..#
#.......#.#
#.........#
#.........D
#.........#
#.........#
#.........#
#.........#
#####d#####

5
1
#####l#####
#.........#
#......#..#
#.......#k#
#.........#
D.........#
#.........#
#.........#
#.........#
##........#
#####D#####
key : 1

6
1
#####D#####
#.#.......#
#.........#
#.........#
#..#..#...#
D.........#
#.........#
#.#.....#.#
#.........#
#.........#
###########

0
4
###########
#X........#
#.........#
#.........#
#.........#
#.........#
#.........#
#.........#
#.........#
#.........#
#####D#####

3
2
#####d#####
#..#......#
#.........#
#.........#
#..#..#...#
D.........D
#.........#
#.....#..##
#.........#
#.........#
###########

2
5
#####D#####
#.........#
#...#.....#
#...#.....#
#..#?#....#
D.........#
#.........#
#.........#
#........e#
#.......ee#
###########
enemies 3
sign Something glints behind that door…

3
3
#####D#####
#e........#
#.........#
#.........#
#...###...#
D....e##..D
#..####e..#
#...#######
#......#..#
#.........#
#####d#####
enemies 3

4
3
#####d#####
#........##
#......#..#
#.......#.#
#.........#
#.........#
#.........#
#.#.......#
#..#......#
#.........#
###########

1
5
###########
#..k......#
#..#......#
#.#.......#
#.#...##..#
D.........D
#.........#
#.........#
#.........#
#.........#
#####D#####
key : 3

6
0
#####D#####
#.........#
#......#..#
#.......#.#
#.........#
#.........D
#.........#
#.........#
#.........#
#k........#
###########
key : 0

2
3
###########
#......#..#
#......#..#
#.........#
#.........#
D.........D
#.........#
#.........#
#.........#
#.........#
#####D#####

4
0
###########
#.........#
#.#.#.#.#.#
#.........#
#...#.#.#.#
#.........D
#.#...#.#.#
#.........#
#.#...#.#.#
#.........#
#####l#####
locked : 0

3
1
###########
#.........#
#.........#
#.........#
#......#..#
#....###..D
#....####.#
#.....##..#
#.....#..##
#.........#
#####d#####

