7
2
#####d#####
#.........#
#.........#
#....#....#
#.........#
#......#..#
#.........#
##......#.#
#......#..#
#.........#
###########

2
2
#####.#####
#.........#
#.........#
#.........#
#.........#
..........#
#.........#
#.........#
#.........#
#.........#
###########

5
3
###########
#........k#
#.........#
#.........#
#......##.#
.......#..#
#.....###.#
#.....#...#
#.........#
#.........#
#####.#####
key : 5

0
1
###########
#e#.....#?#
#.........#
#..#...#.##
#.........#
#.........#
#.........#
#..#.#.#.##
#.........#
#.......#.#
#####.#####
enemies 1
door 0 : 0 1
sign The dungeon remembers all who enter.

2
1
#####d#####
#.........#
#.........#
#.........#
#.........#
#..........
#......#..#
#k#.......#
#..#....#.#
##........#
#####.#####
key : 6

1
2
###########
#........X#
#.........#
#...##....#
#.###.#...#
....#.....#
#.####....#
#.#.###...#
#.........#
#.........#
#####.#####

6
2
#####.#####
#.........#
#......#..#
#.......#.#
#.........#
...........
#.........#
#.........#
#.........#
#.........#
#####d#####

4
0
#####l#####
#......##e#
#......#..#
#....#...##
#....##...#
#?...##...d
#.........#
#.........#
#.........#
#.........#
#####.#####
enemies 1
sign Turn back; you are not yet ready.

6
0
#####.#####
#.........#
#.......#.#
#.........#
#..##.##..#
#...#@#....
#..##..#..#
#..##.##..#
#..##.##..#
#..#......#
###########

3
0
###########
#.........#
##.....#.##
#.........#
#..#.#.#..#
#..........
#..#...#..#
#.........#
##.#...#.##
#.........#
#####l#####
locked : 1

4
2
###########
#......s?e#
##.....#..#
#.........#
#.........#
..........#
#.........#
#.........#
##..#.....#
#.........#
#####l#####
enemies 1
switch 0 : 0 1
sign Only the prepared may pass.

1
1
#####.#####
#......#..#
#.....##..#
#...#..##.#
#...e####.#
#...####...
#......##.#
#....####.#
#.........#
#.........#
#####d#####
boss
enemies 1

4
1
#####d#####
#.........#
#.#.#.#.#.#
#.........#
#....#....#
d..........
#.#.#.#.#.#
#.........#
#..#...#.##
#.........#
#####.#####

6
1
#####.#####
#.........#
#.........#
#.........#
#.........#
...........
#.........#
#.........#
#.........#
#.........#
###########

5
2
#####l#####
##.....#.##
#.........#
#.#.#...#.#
#.........#
...#.#.#...
#.........#
#.#.#.#.#.#
#.........#
#..#...#.##
#####.#####
locked : 6

6
3
#####.#####
#.........#
#..#......#
#.........#
#.........#
..........#
#.........#
#.........#
#.........#
#.........#
###########

3
1
#####.#####
#........##
#.........#
#.........#
#..#..#...#
..........#
#.........#
#..#.....##
#.........#
#.........#
#####d#####

5
0
#####.#####
#.........#
#.##......#
#.#.......#
#.........#
#..........
#.....#...#
#.#.......#
#..#.....##
#........k#
#####.#####
key : 0

5
1
#####.#####
#k........#
#..#...#..#
#.#.....#.#
#.........#
...........
#.........#
#.........#
#.........#
#.........#
#####.#####
key : 1

