5
1
#####l#####
#.........#
#......#..#
#.....#.#.#
#.........#
#...#.....D
#....#....#
#.......#.#
#......#..#
#.........#
#####D#####
locked : 2

6
1
#####D#####
##.#...#..#
#.........#
#e#.#...#.#
#.........#
#..#...#..D
#.........#
#?#.#.#.#.#
#.........#
#......#.##
#####d#####
enemies 1
sign Only the prepared may pass.

4
2
#####D#####
#s........#
#.........#
#.....#...#
#.........#
D...#.....l
#...?.....#
#...#.#.#.#
#.........#
#e#.....#e#
#####D#####
enemies 2
switch 1 : 1
sign Only the prepared may pass.

8
1
#####D#####
#.........#
#.#.#...#.#
#.........#
#..#.#.#..#
#.........#
#.#.#...#.#
#.........#
#......#..#
#.........#
###########
door 0 : 0

1
2
###########
#.........#
#.......#.#
#.........#
#.........#
D.........#
#.........#
#.#.....#.#
#..#...#..#
#.........#
#####D#####

2
1
#####D#####
#.........#
#..#......#
#k##...#..#
#.........#
#..#......D
#.........#
#.......#.#
#......#..#
#.........#
#####l#####
key : 0

3
1
#####l#####
#.........#
##.#...#.##
#.........#
#..#.#....#
#.........D
#..#.#....#
#.........#
##.....#..#
#.........#
#####D#####
locked : 0

7
0
###########
#X........#
#.........#
#.........#
#.........#
#.........D
#.........#
#.........#
#.........#
#.........#
###########

4
3
###########
#.........#
#.........#
#.........#
#.........#
l.........#
#.........#
#.........#
#.........#
#.........#
#####D#####
locked : 1

3
2
#####D#####
#.........#
#.........#
#.#..#..#.#
#.........#
D.........#
#.#..#..#s#
#.........#
#.........#
#e#.......#
#####D#####
enemies 1
switch 0 : 0

7
1
#####d#####
#.........#
#.........#
#.........#
#...e.....#
D....p....D
#.........#
#.........#
#p........#
#.........#
#####D#####
boss
enemies 1

4
1
#####D#####
#.........#
#......#..#
#.......#.#
#.........#
#k........D
#.........#
#.........#
#.........#
#.........#
#####l#####
key : 2

5
2
#####D#####
#k........#
#.....##..#
#......#..#
#......#..#
D.........l
#.........#
#.........#
#.........#
#.........#
#####D#####
key : 3

1
1
#####d#####
#.........#
#.........#
#..#.###..#
#?#...#.#.#
#....@#...D
#....##...#
#..p.#.#..#
#.........#
#.........#
#####D#####
sign Those who search shall find.

2
2
#####D#####
#kpp......#
#...#.#...#
#....#....#
#..###.#..#
D.........#
#.........#
#.........#
#.........#
#.........#
#####D#####
key : 1

6
2
#####D#####
#.........#
#.........#
####......#
#.#.......#
D.........#
#.........#
#.........#
#.........#
#.........#
#####D#####

5
3
#####D#####
#.........#
#.........#
#.........#
#.##......#
l...#.....#
#.#.#.....#
#..##.....#
##.#......#
#.........#
###########
locked : 3

7
2
#####D#####
#.........#
#.........#
#.........#
#..###....#
D..#.#....#
#.........#
#.........#
#.........#
#.......ee#
###########
enemies 2
door 1 : 1

0
1
###########
#.........#
#..#......#
#.#.....#.#
#.........#
#....#....#
#.........#
#.........#
#.........#
#.........#
#####d#####

