1
3
#####.#####
#.........#
#.........#
#.........#
#.........#
.....e##..#
#..#.####.#
#....####.#
#..##.#...#
#..#......#
#####d#####
boss
enemies 1

0
3
###########
#X........#
#.........#
#.........#
#...#..#..#
#.........#
#...#...#.#
#....##...#
#.........#
#.........#
#####.#####

4
0
#####.#####
#.........#
#.........#
#.........#
#.........#
#....@.....
#.........#
#.........#
#.........#
#.........#
#####.#####

4
1
#####.#####
#k......#.#
#####.###.#
##..##..#.#
#...###.#.#
...###....l
#.##.#....#
#.........#
#.........#
#.........#
#####.#####
key : 0

4
2
#####.#####
#.........#
#.........#
#.........#
#.........#
l.........#
#.........#
#.........#
#.........#
#.........#
#####.#####
locked : 1

2
1
###########
#.......#.#
#.........#
#..#.#.#.##
#.........#
#...#.#...d
#.........#
#....#.#.##
#.........#
#.#.....#.#
#####l#####
locked : 2

2
3
#####d#####
#.........#
##.#...#.##
#.........#
#..#...#..#
d..........
#......#..#
#.........#
##.#......#
#.........#
###########

5
0
#####.#####
#.........#
#...#.....#
#.........#
#.........#
#..........
#....#....#
#.........#
#e........#
#es.......#
###########
enemies 2
switch 0 : 0 1

5
1
#####.#####
#.........#
#.........#
#......#..#
#.........#
...........
#.........#
#.........#
#.........#
#....k....#
###########
key : 2

3
2
#####.#####
#.........#
#.........#
#.........#
#.........#
..........#
#.........#
#.......#.#
#......#..#
#.........#
#####.#####

6
3
###########
#.........#
#..#...#..#
#.#.....#.#
#.........#
d..#......#
#.........#
#.#.......#
#..#......#
#.........#
###########

1
2
###########
#.........#
#......#..#
#.......#.#
#.........#
#..........
#.........#
#.......#.#
#......#..#
#.........#
#####.#####

3
0
###########
#k#.......#
#.........#
#.........#
#..#..#...#
#..........
#.........#
#....#....#
#.........#
#.........#
#####.#####
key : 1

2
2
#####.#####
##.#...#.##
#.........#
##.#.#.#.##
#.........#
d..#.#.#..d
#.........#
##...#...##
#.........#
#..#...#.##
#####.#####

6
2
#####.#####
#.........#
#......#..#
#.......#.#
#.........#
#.........d
#.........#
#.#.......#
#..#......#
#.........#
#####.#####

7
2
#####.#####
#.........#
#.........#
#.........#
#.........#
#.........#
#.........#
#.......#.#
#......#..#
#k........#
###########
key : 4

5
2
#####.#####
#.........#
##.#...#.##
#.........#
#.#.#...#.#
..........#
#....#....#
#.........#
#.#.#.#.#.#
#.........#
#####.#####

3
1
#####l#####
#.........#
#.........#
#.........#
#.........#
...##......
#.###.....#
###e......#
##e#......#
#e........#
#####.#####
enemies 3

2
4
###########
#........e#
#.###.....#
#..#.#....#
#..#.#....#
..........#
#.........#
#.........#
#.........#
#........?#
###########
enemies 1
door 0 : 0 1
sign Beware what lurks ahead.

