3
4
#####d#####
#.........#
##..#.....#
###.......#
#..#e#....#
D...##....#
#.##......#
#.........#
#.........#
#.........#
#####D#####
boss
enemies 1

1
2
#####D#####
#.........#
##.....#..#
#.........#
#.........#
#....#....D
#.........#
#.........#
#...#..#..#
#.........#
#####d#####

3
1
#####D#####
#.........#
#......#..#
#.......#.#
#.........#
D.........l
#.........#
#.......#.#
#......#..#
#.........#
#####D#####

2
3
#####D#####
#k........#
#......#..#
#.......#.#
#.........#
D.........D
#.........#
#.........#
#.........#
#.........#
#####D#####
key : 4

4
1
#####D#####
#.........#
#.........#
#.........#
#.........#
D.........D
#.........#
#.#.......#
#..#......#
#.........#
###########

2
0
#####D#####
#.........#
#..#...#..#
#.........#
#..#.#.#..#
#.........D
#..#.#.#..#
#.........#
##.#...#.##
#k........#
#####D#####
key : 0

3
3
#####D#####
#.........#
#.........#
#.........#
#...#.#...#
D...###...D
#..####...#
#..####...#
##.....#.##
#..#...#..#
###########

2
2
#####d#####
#.........#
#......#..#
#...#...#.#
#.........#
d.........D
#.........#
#.#.......#
#..#......#
#.........#
#####D#####

2
1
###########
#.....k...#
#..#..#...#
#.#.......#
#.........#
D.........d
#.........#
#.#.......#
#..#......#
#.........#
#####D#####
key : 1

3
2
#####D#####
#.#.......#
#..#......#
#.#.......#
#.........#
l.........D
#......#..#
#.........#
#.........#
#........##
#####d#####
locked : 0

2
4
#####D#####
#.........#
#.#.#.#.#.#
#.........#
#..#.#.#..#
D.........#
#...#.#...#
#.........#
#..#...#.##
#.........#
#####d#####

0
2
###########
#e.......e#
#?........#
#.........#
#.........#
#.........#
#.........#
#.........#
#.........#
#.........#
#####D#####
enemies 2
door 0 : 0 1
sign The dungeon remembers all who enter.

1
4
###########
#........k#
#..#..#..##
#.........#
#.........#
D...#..#..#
#.........#
#.........#
#..#..#..##
#.........#
#####D#####
key : 6

1
3
###########
#..e.s.e.e#
#..#...#.##
#.........#
#.#...#.#.#
D.........D
#..#.#.#..#
#.........#
#...#...#.#
#.........#
#####D#####
enemies 3
switch 0 : 0 1

3
0
#####D#####
##.#......#
#..##.....#
#.###.....#
#..##.....#
#..#@#....D
#.#..#....#
#.........#
#.........#
#.........#
#####D#####

4
0
#####D#####
#.........#
#.........#
#...#.....#
#.........#
#.........D
#.........#
#.........#
#........##
#..#......#
###########

4
2
#####d#####
##.#...#.##
#.........#
#.#.#.#.#.#
#.........#
D..#...#..#
#.........#
#...#.#.#.#
#.........#
#......#.##
###########

1
0
###########
#.........#
#.........#
#.........#
#.........#
#.........#
#.........#
##........#
#.#.......#
#.........#
#####D#####

4
4
#####D#####
#.........#
#.........#
#.........#
#....#....#
#.........#
#.........#
#......#..#
#.........#
#X........#
###########

