1
2
###########
##........#
#.........#
#.........#
#....#..#.#
d.........l
#.........#
#...#..#..#
#.........#
#.........#
#####.#####

1
3
#####.#####
#..#......#
#.........#
#.........#
#..#..#...#
l..........
#.........#
#..#......#
#.........#
#.........#
#####d#####
locked : 0

1
4
#####.#####
#........##
#.........#
##........#
#.........#
...#e###..d
#.######..#
#..e####..#
#..##.##..#
#e##...#..#
#####d#####
enemies 3

1
1
#####.#####
#.........#
#.........#
#.........#
#.........#
...##.....d
#...#.....#
#.........#
##..#.....#
#.........#
#####.#####

0
4
###########
#.........#
#.........#
#.........#
#.........#
...#......#
#.........#
#.......#.#
#......#..#
#.........#
#####.#####

0
1
###########
#.##......#
#..#......#
#.........#
#.........#
..........#
#...###...#
#...#.....#
#...#.#...#
#.........#
#####.#####

3
1
#####l#####
#.........#
#.........#
####......#
#.##......#
#..#......#
#.........#
#.........#
#.........#
#.........#
###########
locked : 1

2
4
#####d#####
#........##
#.........#
#.........#
#..#..#...#
...........
#.........#
#.....#..##
#.........#
#.........#
#####l#####

4
4
#####.#####
#.........#
#.........#
#....##.###
#....##.#.#
#.....#...#
#....##.#.#
#.....#...#
#.........#
#X........#
###########

1
6
###########
#........k#
#.........#
#.........#
#.........#
..........#
#.........#
#.........#
#.........#
#.........#
###########
key : 6

1
5
###########
#..#.....##
#.........#
#.........#
#...#..#..#
d..........
#.........#
#..#..#...#
#.........#
#.........#
#####.#####

2
3
#####d#####
#.........#
#..#......#
#.#.......#
#.........#
...........
#.........#
#.........#
#.........#
#........##
###########

1
0
#####.#####
#.........#
#.........#
#.........#
#.........#
#..##@.....
#.###.....#
#..#......#
#.###...#.#
#..#......#
###########

2
2
#####.#####
#.........#
#.........#
#.........#
#.........#
....#.#....
#.###.....#
#..#..#...#
#..#..#...#
#.....k...#
###########
key : 1

0
0
###########
#.........#
#####.....#
###.......#
#.#.......#
#...#......
#...##....#
#.........#
#.........#
#.........#
#####.#####

2
1
#####.#####
##.....#.##
#.........#
#k#.#.#.#.#
#.........#
#..#.#.#...
#.........#
#.#.#.#.#.#
#.........#
##.#...#.##
#####l#####
key : 0

2
5
#####.#####
#.........#
#.........#
#.........#
#.........#
..........#
#.........#
#.........#
#.........#
#........k#
###########
key : 7

0
3
###########
#e#e....#.#
#.........#
#..#.....##
#.........#
#...#......
#.........#
#..#.#.#.##
#.........#
#.#.....#.#
#####.#####
enemies 2

3
4
#####l#####
#.........#
#.........#
#.........#
#.....#.#.#
#....e##..#
#.....#...#
#..##.....#
#.#.......#
#.........#
#####.#####
locked : 7
boss
enemies 1

