2
1
#####.#####
#e........#
#.......#.#
#.........#
#.........#
.....#.....
#.........#
#.........#
#.#.....#.#
#e........#
#####.#####
enemies 2

2
0
#####.#####
#.........#
#.........#
#.........#
#.........#
#..........
#.........#
#.........#
#.........#
#.........#
#####l#####
locked : 0

1
0
#####d#####
#.......#.#
#.........#
#..#...#.##
#.........#
#...#.#...d
#.........#
#..#.#.#.##
#.........#
#.........#
#####.#####

3
2
#####.#####
#k........#
#.........#
#.........#
#.........#
..........d
#.........#
#.........#
#.........#
#.........#
#####d#####
key : 5

1
2
###########
#........k#
#.........#
#.........#
#.........#
..........#
#.........#
#.........#
#.........#
#.........#
#####.#####
key : 3

1
1
#####.#####
#.........#
#...#.....#
#...#.#...#
#.#.#.#...#
d..##......
#.........#
#..##.....#
###.#.....#
#.........#
#####.#####

4
0
#####.#####
#.........#
#.........#
#.........#
#.........#
#k.........
#.........#
#.........#
#.........#
#.........#
#####.#####
key : 0

5
0
#####.#####
#..#......#
#.#.#.#...#
#.#.......#
#..#.#....#
#..........
#.........#
#..#.#....#
#...#.....#
#.........#
###########

0
0
###########
#.........#
#.........#
#.#..#....#
#.........#
#.........l
#.#.....#.#
#.........#
#.........#
#.......#.#
#####d#####

3
3
###########
#.........#
#......#..#
#.......#.#
#.........#
d.........#
#.........#
#.........#
#.........#
#.........#
#####l#####

4
1
#####.#####
#......#..#
#.........#
#.#.#...#.#
#.........#
...#.#.#...
#.........#
#.#...#.#.#
#.........#
##.#...#.##
#####.#####

5
3
#####.#####
#.........#
#.......#.#
###.......#
#.........#
#.....#...#
#....#....#
#...##....#
#...#.#...#
#X........#
###########

0
1
###########
#.........#
#.........#
#.........#
#....#....#
l..####...#
#....##...#
#.........#
#.........#
#.........#
#####.#####
locked : 2

3
1
#####.#####
#.........#
#.........#
#.........#
#.........#
...........
#.........#
#.......#.#
#......#..#
#.........#
#####.#####

2
2
#####.#####
#..#......#
##........#
#.........#
#.........#
..........#
#.........#
#.........#
#.........#
#.........#
#####.#####

4
2
#####d#####
#.........#
#......#..#
#.......#.#
#.........#
.......#...
#.........#
#.........#
#.........#
#.........#
###########

3
0
#####l#####
#.........#
#.........#
#.........#
#.........#
#?.#.@.....
#..#.###..#
#..#..##..#
#..#...#..#
#......#..#
#####.#####
sign Only the prepared may pass.

5
1
#####.#####
#.........#
#...#..#..#
#.........#
#.........#
..........#
#.........#
#.........#
##.....#..#
#........k#
###########
key : 2

4
3
#####l#####
#.........#
#......#..#
#.........#
#.........#
...#.e....#
#..#......#
#.##......#
#.........#
#.........#
#####.#####
locked : 5
boss
enemies 1

