3
0
###########
#k........#
#.........#
#.........#
#.........#
#.........D
#.........#
#.........#
#.........#
#.........#
#####D#####
key : 1

6
1
#####D#####
#.........#
#.....#...#
#.....##..#
#.........#
d.........D
#.........#
#....#....#
#..#......#
#.........#
#####D#####

6
2
###########
#.........#
##.#...#.##
#.........#
#..#.#.#..#
D.........#
#....#.#..#
#.........#
#.........#
#.........#
###########

4
0
#####D#####
#.........#
#.........#
#.........#
#.........#
#....@....D
#.........#
#?#.......#
#.........#
#.........#
#####D#####
sign What you seek is close.

1
2
###########
#..#......#
#.###.....#
#.###.###.#
#.#.##....#
D.....#...d
#.........#
#.........#
#.........#
#.........#
#####D#####

6
0
#####d#####
#.........#
#......#.##
#.........#
#.....#.#.#
#.........d
#..#.#.#..#
#.........#
#.#.#.#.#.#
#.........#
#####D#####

7
1
#####D#####
#.........#
#.....#.#.#
#.........#
#..#.#.#..#
D.........#
#.#.#...#.#
#.........#
#......#..#
#......s?e#
###########
enemies 1
switch 0 : 0 1
sign Something glints behind that door…

3
1
#####D#####
#.........#
#.........#
#.........#
#.........#
D.........D
#.........#
#.........#
#.........#
#.........#
#####l#####
locked : 0

2
3
#####D#####
#.........#
#.........#
#.........#
#.........#
D.........#
#.....#...#
#.........#
#.........#
#.......X##
###########

5
0
#####D#####
#.........#
#..#......#
#.#.......#
#.........#
#.........D
#.........#
#.........#
#.........#
#.........#
#####d#####

3
2
#####D#####
#.........#
#.........#
#..#.....##
#.........#
D.........#
#..#..#...#
#.........#
#.........#
#........##
###########

2
1
#####l#####
#.........#
#.........#
#.##.#....#
#..k###...#
#..#..#...D
#....##...#
#.#.###...#
#.........#
#.........#
#####D#####
key : 2

5
1
#####D#####
#e........#
#...#.....#
#...###...#
#....##...#
D........e#
#.........#
#.........#
#.........#
#.........#
#####D#####
enemies 2
door 0 : 0 1

1
1
#####d#####
#......#..#
#.........#
#.........#
#.#.......#
#.........D
#.........#
##..#..#..#
#.........#
#.........#
#####l#####
locked : 1

2
2
#####D#####
#......#..#
#..##.....#
#..##.#...#
#.#e..#...#
D..###....D
#.#e###...#
#.#.......#
#.........#
#.........#
#####D#####
enemies 2

0
1
###########
#.........#
#.........#
#.........#
#..#......#
#.........#
#.#.......#
#.........#
#.........#
#.........#
#####d#####

1
3
###########
#.........#
#.........#
#.........#
#.........#
d..#.e....#
#.###.....#
#.#.#.....#
#.#.......#
#.........#
#####D#####
boss
enemies 1

7
0
#####D#####
#.........#
#..#......#
#.#.......#
#.........#
#.........D
#.........#
#.......#.#
#......#..#
#k........#
###########
key : 3

4
1
#####l#####
#.........#
#.........#
#.........#
#.........#
D.........#
#.........#
#.#.....#k#
#..#...#..#
#.........#
#####D#####
key : 0

