7
0
#####.#####
#......#..#
#.....#...#
#.........#
#.........#
#..........
#.........#
#.#.....#.#
#..#...#..#
#.........#
###########

4
0
#####.#####
#.........#
#.........#
#.........#
#.........#
#k.........
#.........#
#.......#.#
#......#..#
#.........#
#####.#####
key : 0

1
0
#####.#####
#........##
#.........#
#.........#
#.........#
#....e....#
#.........#
##........#
#.........#
#.........#
#####d#####
boss
enemies 1

0
0
###########
#X........#
##........#
#..##..#..#
#.##...##.#
#..#..##..#
#.###.....#
#.........#
#.........#
#.........#
#####.#####

5
0
#####.#####
#.........#
#......#..#
#..##.#...#
#.....#...#
#?...@.#...
#.........#
#.........#
#.........#
#.........#
#####.#####
sign The brave are rewarded.

6
1
#####.#####
#.........#
#.........#
#.........#
#.........#
...##.....d
#.#k#.....#
##..#.....#
#...#.....#
#.........#
#####.#####
key : 2

6
0
#####.#####
#.........#
#.........#
#...#..#..#
#.........#
#..........
#...#..#..#
#.........#
#.........#
##.....#..#
#####.#####

2
1
###########
#......see#
#........e#
#........?#
#.........#
..........#
#.........#
#.........#
#.........#
#.........#
#####.#####
enemies 3
switch 0 : 0
sign This door will not yield without a key.

6
3
###########
#..#......#
#.........#
#.........#
#.#.......#
..........#
#.........#
#.#.....#.#
#..#...#.##
#........k#
###########
key : 8

3
0
#####l#####
#........e#
#.....#..##
#.........#
#.........#
#..#.......
#.........#
#.........#
#..#..#..##
#.........#
#####.#####
enemies 1

7
2
#####.#####
#.........#
#.........#
#.........#
#.........#
..........#
#.........#
#.........#
#.........#
#........e#
###########
enemies 1
door 0 : 0

5
1
#####l#####
#k#.......#
#.........#
#..#.....##
#.........#
....#.#...d
#.........#
#....#.#.##
#.........#
#.#.....#.#
#####.#####
key : 1

5
2
#####.#####
#.........#
#.........#
#.....#.#.#
#......##.#
d......#..#
#.........#
#.........#
#.........#
#.........#
#####.#####

2
0
#####d#####
#.........#
#.....#.#.#
#.........#
#..#...#..#
#..........
#.#.#.....#
#.........#
#..#...#.##
#.........#
#####l#####
locked : 2

4
2
###########
#.......#.#
#.........#
#.........#
#.#..#..#.#
..........#
#.........#
#....#..#.#
#.........#
#.........#
#####.#####

6
2
#####.#####
##........#
#.........#
#.........#
#.........#
d..#.......
#.##......#
#.####....#
###.#.....#
###.......#
#####.#####

3
1
#####.#####
#.........#
#.#.......#
#.........#
#.........#
..........#
#.........#
#.........#
#.#.....#.#
#.........#
#####d#####

4
1
#####d#####
#......#.##
#.....#..##
#....#..#.#
#......##.#
.....##....
#.........#
#.........#
#.........#
#.........#
#####l#####
locked : 1

7
1
#####.#####
#.........#
#.#.#.#.#.#
#.........#
#..#.#.#..#
...........
#.#.#.#.#.#
#.........#
#..#...#..#
#.........#
###########

