3
5
#####l#####
#.........#
#..#......#
#.#.......#
#.........#
D.........d
#.........#
#.........#
#.........#
#.........#
###########
locked : 2

2
0
#####D#####
#.........#
#.....##.##
#........##
#...@.##..#
#..#.##...D
#....#.##.#
#.........#
#.........#
#?........#
###########
sign A useful tool lies just ahead.

1
2
#####D#####
#.........#
#......#..#
#.......#.#
#.........#
D.........#
#.........#
#.......#.#
#......#..#
#.........#
#####D#####

3
1
#####D#####
#.........#
#..#...#..#
#.#.....#.#
#.........#
#.........D
#.........#
#.........#
#.........#
#.........#
###########

2
4
#####D#####
#.........#
#.........#
#.........#
#.........#
d.........l
#.........#
#.........#
#.........#
#.........#
#####D#####

0
4
###########
#.........#
#.........#
#.........#
#.........#
#.........#
#.........#
#.#.......#
#..#......#
#.........#
#####d#####

1
1
#####l#####
#.........#
#.........#
#.........#
#.........#
D.........D
#.........#
#.........#
#.........#
#.........#
#####D#####

0
2
###########
#.........#
#.........#
#...#..#..#
#.........#
D.........#
#...#..#..#
#.........#
#.........#
##.....#..#
#####D#####

2
5
###########
#.........#
#.........#
##..#..#..#
#.........#
l.........#
#......#..#
#.........#
#.........#
##.....#..#
#####l#####
locked : 0

2
3
###########
#.........#
#.........#
#.#.#.#.#.#
#.........#
D...#.#...d
#.........#
#.#...#.#.#
#.........#
#k#.......#
###########
key : 2

4
6
#####D#####
#.........#
#.........#
#.........#
#.........#
#.........#
#.........#
#.........#
#.........#
#X........#
###########

3
2
#####d#####
#.#.......#
#.........#
#..#.#.#.##
#.........#
D...#.....#
#.........#
#......#.##
#.........#
#.#.....#.#
###########

2
1
#####D#####
#k........#
#.#.......#
#.........#
#.........#
D....#....D
#.........#
#.........#
#.#.....#.#
#.........#
#####D#####
key : 0

1
4
#####d#####
#.........#
#.........#
#.........#
#.........#
#..#......#
#.........#
#.##......#
#.........#
#.........#
#####D#####

2
2
#####D#####
#k........#
#.........#
#.........#
#.........#
D..#......D
#..##.....#
#.###.....#
#.........#
#.........#
#####d#####
key : 1

1
0
###########
#.........#
#..#......#
#.#.......#
#.........#
#.........D
#.........#
#.........#
#.........#
#.........#
#####D#####

0
1
###########
#.........#
#.........#
#..#......#
#.##......#
#..###....D
#...###...#
#...##....#
#.........#
#.........#
#####l#####
locked : 1

3
6
###########
#.........#
#.........#
#.........#
#...e.#...#
d....#.#..#
#....#....#
#.........#
#.........#
#.........#
#####D#####
boss
enemies 1

3
4
#####D#####
#.........#
#.........#
#..#..#..##
#.........#
#.........D
#..#..#...#
#.........#
#.........#
#k.#.....##
###########
key : 3

