2
1
###########
#.........#
#..#......#
#.........#
#.#...#.#.#
...........
#....#.#..#
#.........#
#.#.#.#.#.#
#.........#
#####.#####

3
5
#####.#####
#.........#
#.........#
#.....#...#
#......##.#
.......#..#
#...##....#
#....##...#
#.........#
#........X#
###########

4
3
#####.#####
#.........#
#...#.##..#
#...#.#...#
#..#k#.#..#
#......#..#
#..##..#..#
#.........#
#.........#
#.........#
#####.#####
key : 2

3
1
#####.#####
#.........#
#...#.##..#
#...##....#
#..##..#..#
...##.#....
#.##......#
#.........#
#..##.....#
#.........#
#####.#####

2
3
###########
#.........#
#......#..#
#.......#.#
#.........#
..........l
#.........#
#.........#
#.........#
#.........#
#####d#####

4
1
#####.#####
#.........#
#.........#
#.....#..##
#.........#
..........#
#......#..#
#.........#
#........s#
#..#?...ee#
###########
enemies 2
switch 0 : 0 1
sign A locked path — look elsewhere first.

2
0
###########
#k........#
#......#..#
#.......#.#
#.........#
#..........
#.........#
#.#.......#
#..#......#
#.........#
#####.#####
key : 0

1
5
###########
##....e#ee#
#.........#
#.........#
#.#.....#.#
..........#
#.........#
#...#..#..#
#.........#
#.........#
#####.#####
enemies 3

4
0
#####l#####
#.........#
#.........#
#..#..#..##
#.........#
#..........
#...#..#..#
#.........#
#.........#
#.........#
###########
locked : 0

2
4
#####d#####
#.........#
#......#..#
#.......#.#
#.........#
l.........d
#.........#
#.#.......#
#.........#
#.........#
#####d#####
locked : 2

1
4
#####.#####
#......##.#
#.........#
#....#....#
#....##.#.#
#..........
#.........#
#.........#
#.........#
#......#..#
#####d#####

3
4
#####d#####
#.........#
#......#.##
#.........#
#....#.#..#
...........
#....#....#
#.........#
##.#...#.##
#.........#
###########

3
0
#####.#####
#......#..#
#.........#
#....#.#..#
#.........#
#....@.....
#.........#
#.........#
#.........#
#.........#
#####l#####

2
5
#####.#####
#.........#
#.........#
#.........#
#.##e#....#
d...###...#
#.###.....#
#...#.#...#
#..##.#...#
#.........#
#####.#####
boss
enemies 1

3
3
#####d#####
#k#.....#.#
#.........#
#.........#
#....#....#
...........
#.........#
#.#.....#.#
#.........#
#.........#
#####.#####
key : 1

3
2
#####.#####
#..#......#
#...#..#..#
#.........#
#...###...#
...........
#.........#
#.........#
#.........#
#.........#
###########

2
2
###########
#.........#
#.........#
#.........#
#.........#
...........
#.........#
#.........#
#.........#
#.........#
#####.#####

5
3
#####.#####
#.........#
#.#.....#.#
#.........#
#.........#
#..#......#
#.........#
#.........#
#.#.....#.#
#e.......?#
###########
enemies 1
door 0 : 0 1
sign What you seek is close.

0
4
###########
#k........#
#..#......#
#.#.......#
#.........#
#.........#
#.........#
#.#.......#
#..#......#
#.........#
#####.#####
key : 4

