4
1
#####.#####
#.........#
#.........#
#.........#
#.........#
.........k#
#.........#
#.........#
#.........#
#.........#
#####.#####
key : 1

7
1
#####d#####
#.........#
#..#......#
#.#.......#
#.........#
..........#
#.........#
#.......#.#
#......#..#
#.........#
#####.#####

3
1
#####d#####
#.........#
#.........#
#.........#
#.........#
.........k#
#.........#
#.........#
#.........#
#.........#
#####.#####
key : 4

5
1
#####.#####
#.........#
#.#.#.#.#.#
#.........#
#..#.#.#..#
..........#
#.....#.#k#
#.........#
#..#...#.##
#.........#
#####.#####
key : 0

2
0
#####d#####
#..#...#..#
#..##.##..#
#...##.#..#
#...##.#..#
#......#...
#.........#
#.........#
#.........#
#.........#
#####d#####

0
0
###########
#X........#
#.........#
#.........#
#.........#
#.........#
#.........#
#.........#
#.........#
#.........#
#####.#####

9
0
#####l#####
#.........#
#......##.#
#...##.#..#
#...###...#
#......#..#
#...#...#.#
#.........#
#.........#
#.........#
###########
locked : 3

5
0
#####.#####
#.........#
#.........#
#.........#
#.........#
#?...@.....
#.........#
#.........#
#.........#
#.........#
#####.#####
sign The brave are rewarded.

8
1
#####.#####
#.........#
#.......#.#
#.........#
#.........#
.....#....#
#.........#
#.........#
#.#.......#
#.........#
###########

3
0
#####d#####
#.......#.#
#.........#
#.#.#.....#
#.........#
#...#......
#.........#
#...#.....#
#.........#
#k#.....#.#
#####.#####
key : 3

1
1
###########
#........e#
#.......#.#
#.........#
#.........#
..........#
#.........#
#.........#
#.#.....#.#
#.........#
#####.#####
enemies 1
door 0 : 0 1

6
1
#####.#####
#.........#
#......#..#
#.......#.#
#.........#
..........l
#.........#
#.#.......#
#..#......#
#.........#
#####d#####

7
0
#####.#####
#e........#
#.........#
#.........#
#s........#
#e.........
#?.#..#...#
#.........#
#.........#
#........##
#####.#####
enemies 2
switch 0 : 0 1
sign Many have walked this path.

8
0
#####.#####
#.........#
#.........#
#.........#
#.........#
#..........
#.........#
#.........#
#.........#
#.........#
#####l#####

6
2
###########
#.........#
#..#...#..#
#.#.....#.#
#.........#
l...#.#...#
#.........#
#.........#
#.........#
#.........#
###########
locked : 1

1
0
#####.#####
#.........#
#.........#
#.........#
#.........#
#..##e.....
#...#.....#
#...#.....#
#.........#
#.........#
#####d#####
boss
enemies 1

6
0
#####.#####
#.........#
##.....#.##
#.........#
#....#.#..#
#..........
#..#.#.#..#
#.........#
##.#...#..#
#.........#
#####.#####

4
0
#####.#####
#.........#
#.........#
#..#......#
#.........#
#..........
#...#..#..#
#.........#
#.........#
#..#.....##
#####.#####

2
1
#####.#####
#.........#
#...#.#...#
#...###...#
#...###...#
..........#
#.........#
#.........#
#.........#
#.........#
#####d#####

