4
3
#####D#####
#.........#
#.......p.#
#...p.....#
#.........#
D.........#
#.........#
#.........#
#.........#
#........X#
###########

3
1
#####D#####
#.........#
#.#...#.#.#
#.........#
#.#...#.#.#
D.........d
#.#...#.#.#
#.........#
#.#.#.#.#.#
#.........#
#####l#####

2
0
#####D#####
#.........#
#.........#
#.........#
#.........#
#?...@....D
#.........#
#.........#
#.........#
#.........#
#####D#####
sign What you seek is close.

3
0
#####D#####
#.........#
#.........#
#.........#
#.........#
#.........D
#.#..#..#.#
#.........#
#.........#
#k#.....#.#
###########
key : 0

1
0
#####D#####
#.........#
#..#......#
#k#.......#
#.........#
#.........D
#.........#
#.......#.#
#......#..#
#.........#
#####D#####
key : 1

4
2
#####D#####
#?.......e#
#..#..#..##
#.........#
#.........#
D.....#...D
#.........#
#.........#
#..#......#
#..e.e....#
###########
enemies 3
sign This door will not yield without a key.

0
3
###########
#........k#
#.........#
#.........#
#.........#
D.........#
#.........#
#.........#
#.........#
#.........#
#####D#####
key : 2

4
1
#####l#####
#.........#
#..#...#..#
#.#.....#.#
#.....#...#
#.........D
#.........#
#.#.......#
#..#...#.##
#.........#
###########
locked : 1

1
2
#####D#####
####......#
##..#.....#
#.#.##....#
#.........#
d...#.#...d
#.........#
#.........#
#.........#
#.........#
#####D#####

0
0
###########
#.........#
#.........#
#p........#
#.........#
#..####...D
#..#.#.#..#
#....#....#
#......####
#........##
#####D#####

2
2
#####D#####
#.........#
#.........#
#.........#
#.........#
l.........#
#.........#
#.#.......#
#..#......#
#.........#
#####D#####
locked : 0

3
2
#####D#####
#.........#
#.#.....#.#
#.........#
#.........#
d.........l
#.........#
#.........#
#.........#
#.........#
#####D#####

1
3
#####D#####
#.........#
#.#...#.#.#
#.........#
#...#.#...#
d.........D
#.#.#.#.#.#
#.........#
#.#.#.....#
#.........#
###########

0
2
###########
#.........#
#.........#
#...p.....#
#.........#
d.........D
#.........#
#.........#
#.........#
#.........#
#####D#####

1
1
#####D#####
#.........#
#..#......#
#.........#
#.........#
D.....#...d
#.........#
#.......#.#
##.....#..#
#.........#
#####D#####

3
3
###########
#.........#
#.........#
#.........#
#.........#
l....e....#
#.........#
#.........#
#.........#
#.........#
#####D#####
locked : 3
boss
enemies 1

0
1
###########
#....k....#
#.........#
#.........#
#...#.....#
D..##.....d
#..#......#
#.........#
#.........#
#.........#
#####D#####
key : 3

2
1
#####D#####
#.........#
#.........#
#.........#
#.........#
D.........l
#..#......#
#.........#
#........##
#.........#
#####D#####

1
4
###########
#.......ee#
#.........#
#.........#
#.........#
D.........#
#.........#
#.........#
#.........#
#........e#
###########
enemies 3

