1
3
###########
#.#.......#
#.........#
#....#.#..#
#.........#
l...#.#...#
#.........#
#....#...##
#.........#
#.#.....#.#
#####.#####
locked : 2

2
1
#####l#####
#e.......s#
##.....#.##
#?........#
#....#.#..#
#..........
#..#.#....#
#.........#
##.#...#..#
#e........#
#####.#####
enemies 2
switch 0 : 0 1
sign This door will not yield without a key.

4
4
#####.#####
#.........#
##.##.....#
#.#.##....#
#....#....#
.....#....#
#...#.....#
#.........#
#.........#
#........X#
###########

0
2
###########
#........e#
#..#..#..##
#........e#
#.........#
...#..#...#
#.........#
#.........#
#..#..#..##
#.........#
#####.#####
enemies 2
door 0 : 0 1

4
3
#####.#####
#.........#
#..#......#
#.#.......#
#.........#
...........
#.........#
#.......#.#
#......#..#
#......k..#
###########
key : 5

1
2
#####.#####
#k........#
#.........#
#.........#
#.........#
..........l
#.........#
#.........#
#.........#
#.........#
#####.#####
key : 2

1
1
#####d#####
#.#.....#.#
#.........#
#.........#
#.....#...#
#..........
#.........#
#.#..#..#.#
#.........#
#.........#
#####l#####
locked : 0

0
1
###########
#.........#
#.........#
#.........#
#.........#
#..........
#..#..#...#
#.........#
#.........#
#.#.......#
#####d#####

3
0
###########
#?.......##
#.......#.#
#.........#
#...@.#...#
#....##....
#.#.##....#
#..##.#...#
#..##.....#
#.........#
#####.#####
sign Many have walked this path.

3
1
#####.#####
#.........#
#...#.##..#
#...####..#
#.....##..#
....#.#....
#..###.#..#
#.........#
#.........#
#.........#
#####.#####

4
1
#####.#####
#.........#
#...#.#.#.#
#.........#
#..#.#.#..#
...........
#.#.#.#.#.#
#.........#
#......#..#
#.........#
#####d#####

2
2
#####.#####
#.........#
#..#...#.##
#.........#
#..#.#.#..#
...........
#..#...#..#
#.........#
##.#...#.##
#k........#
#####.#####
key : 0

3
2
#####.#####
#.........#
#.........#
#.........#
#.........#
..........d
#.........#
#.........#
#.........#
#.........#
#####.#####

4
2
#####.#####
#e.......##
#.........#
#.........#
#...#..#..#
...........
#.........#
#..#..#..##
#.........#
#e...e....#
###########
enemies 3

3
4
###########
#.........#
#.........#
#.........#
#.........#
d....e....#
#.........#
#.........#
#.........#
#.........#
#####.#####
boss
enemies 1

2
3
#####.#####
#.........#
#..#...#..#
#.#.....#k#
#.........#
..........#
#.........#
#.......#.#
#......#..#
#.........#
#####.#####
key : 1

4
0
#####.#####
#.........#
#.#.#.#...#
#.........#
#.#.#...#.#
#..........
#.#.#.#.#.#
#.........#
#.#.#.#.#.#
#.........#
###########

3
3
#####.#####
#.........#
#.........#
#.....#...#
#.........#
d.........d
#.........#
#.#.......#
##.#......#
#.........#
#####.#####

5
1
#####d#####
#.........#
#.........#
#.........#
#.........#
#.........#
#.........#
#.........#
#...#.....#
#.........#
###########

