4
1
#####D#####
#.#.....#.#
#.........#
#.........#
#....#..#.#
D.........d
#.........#
#....#....#
#.........#
#.........#
#####D#####

2
0
###########
#k........#
##........#
##........#
#.........#
#...#.##..d
#..#......#
#..#..##..#
#..#......#
#.........#
#####D#####
key : 4

3
2
###########
#.........#
#.........#
#.........#
#.....#.#.#
D.....##..#
#..###....#
#...##....#
#.........#
#.........#
#####D#####

2
1
#####l#####
#.#.......#
#.........#
#...#.#.#.#
#.........#
d...#.#...#
#.........#
#.#.#.#.#.#
#.........#
#.#.....#.#
#####D#####

5
0
#####D#####
#.........#
#.........#
#.........#
#...@.....#
#?..##....D
#.........#
#.....#...#
#.........#
#.........#
#####D#####
sign The walls are warm to the touch.

6
0
#####D#####
##.#...#.##
#.........#
#k#.#.....#
#.........#
#..#.#.#..D
#.........#
#.#...#.#.#
#.........#
##.#...#.##
#####D#####
key : 1

7
0
#####D#####
#.........#
#.........#
#.........#
#.........#
#.........l
#.........#
#.......#.#
#......#..#
#.........#
###########

0
1
###########
#X........#
#...#..##.#
#...#.#.#.#
#...##..#.#
#...#..#..#
#...#.....#
#.p.......#
#.........#
#.........#
#####D#####

5
2
#####D#####
#.........#
#..##.....#
##........#
#...#.....#
D..#......#
#.##......#
#.........#
#.........#
#.........#
#####D#####

6
2
#####D#####
#..#......#
#.........#
#.....#.#.#
#.........#
d..#.#.#..#
#.........#
#.#.#.#.#.#
#.........#
##.....#.##
###########

4
3
###########
#........e#
#.#.#...#.#
#.........#
#..#.#.#..#
D.........#
#...#...#.#
#.........#
#..#.....##
#........e#
###########
enemies 2

5
1
#####D#####
#.........#
#.........#
#.........#
#....##.#.#
D...##k#..D
#...##.##.#
#....#...##
#......##.#
#.........#
#####l#####
key : 0

3
1
#####D#####
#.........#
#..#......#
#.#.......#
#......#..#
D.........D
#.........#
#.#.....#.#
#..#...#..#
#.........#
#####D#####

6
1
#####l#####
#.#.....#.#
#.........#
#.#.#.#...#
#.........#
D.....#...d
#.........#
#...#.#.#.#
#.........#
#.#.......#
#####D#####
locked : 1

3
0
#####D#####
#.........#
#..#......#
#.#.....###
#.........#
#.........D
#..#......#
#.#.......#
#..#......#
#.........#
#####d#####

4
0
#####d#####
#.........#
#..#......#
#k#.......#
#.........#
#.........D
#.........#
#.........#
#.........#
#.........#
#####D#####
key : 2

4
2
#####D#####
#.........#
#.........#
#..#..#..##
#.........#
d.........D
#.....#...#
#.........#
#.........#
#..#.....##
#####D#####

7
1
#####D#####
#.........#
#..#...#..#
#.#.....#.#
#.........#
l.........#
#.........#
#.........#
#.........#
#.........#
###########
locked : 0

1
1
#####D#####
#.##......#
#.........#
#..##.....#
#.###.#...#
#....e....#
#.........#
#.........#
#.........#
#.........#
#####l#####
locked : 2
boss
enemies 1

