2
5
###########
#.........#
#.........#
#.........#
#.........#
l.........#
#.........#
#.........#
#.........#
#.........#
#####.#####
locked : 4

3
0
#####.#####
#.........#
#.........#
#.........#
#.........#
#?...@....l
#.........#
#.........#
#.........#
#.........#
#####.#####
sign Only the prepared may pass.

2
1
###########
#.........#
#......##.#
#...###.#.#
#...#...#.#
...........
#...##.##.#
#.........#
#.........#
#.........#
#####.#####

2
3
###########
#.e.......#
#.#.....#.#
#.........#
#.........#
.....#.....
#.........#
#.........#
#.........#
#.........#
#####.#####
enemies 1

3
4
#####d#####
#k........#
#.........#
#.........#
#.........#
..........d
#.........#
#...#.....#
#.........#
#.........#
#####.#####
key : 4

4
4
#####.#####
#.........#
#.........#
#....##...#
#....##...#
.....#....#
#......##.#
#....###.##
#.........#
#.........#
###########

3
1
#####.#####
#.........#
#.........#
#.........#
#.......#.#
l......#...
#.....##..#
#...#.....#
#.........#
#.........#
#####.#####
locked : 0

4
1
#####.#####
#.........#
#.........#
#.........#
#.#.......#
..........#
#.........#
#......#..#
#........e#
#.......ee#
###########
enemies 3

3
3
#####.#####
#.........#
#..#...#..#
#.#.....#.#
#.........#
l..........
#.........#
#.......#.#
#......#..#
#.........#
#####.#####
locked : 1

3
5
#####.#####
#.........#
#.........#
#....###..#
#....##...#
d.........#
#.........#
#.........#
#.........#
#.........#
###########

1
2
###########
#.........#
#.........#
#.###.....#
#.#.......#
#.........#
#.........#
#.........#
#.........#
#.........#
#####.#####

2
0
###########
#k........#
#..#...#..#
#.#.....#.#
#.........#
#..........
#.........#
#.#.....#.#
#..#...#..#
#.........#
#####.#####
key : 0

4
0
#####.#####
#.........#
#......#..#
#.......#.#
#.........#
#..........
#.........#
#.#.....#.#
#..#...#..#
#k........#
###########
key : 1

3
2
#####d#####
##........#
#..##.....#
####......#
#.####....#
...#.#....l
#.#..#....#
##.#......#
##.#......#
#k........#
###########
key : 3

2
2
#####.#####
#.........#
#......#..#
#.......#.#
#.........#
...........
#...#.....#
#.#.......#
#..#......#
#.........#
#####d#####

2
4
#####l#####
##.....#..#
#.........#
#.........#
#......#..#
..........l
#.........#
#......#..#
#.........#
#.........#
#####d#####

4
3
#####.#####
#.........#
#.........#
#.........#
#.........#
#..........
#.........#
#.........#
#.........#
#.........#
###########

1
4
#####.#####
#..#......#
#.........#
#.........#
#.........#
#....e....#
#.........#
#.........#
#.........#
#.........#
#####l#####
locked : 3
boss
enemies 1

0
4
###########
#X.#......#
##.#......#
#...#.....#
#.........#
#...#.....#
#.........#
#.........#
#.........#
#.........#
#####.#####

