2
5
###########
#......s.e#
##.#...#.##
#.........#
#..#.#.#..#
..........#
#......#..#
#.........#
#..#...#.##
#........e#
###########
enemies 2
switch 0 : 0 1

1
1
#####l#####
#k........#
#.#...#.#.#
#.........#
#.#...#.#.#
...........
#.#.#...#.#
#.........#
#...#.#.#.#
#.........#
#####l#####
key : 0

0
0
###########
#.........#
#.........#
#.........#
#.........#
#..........
#.........#
#.#.......#
#..#......#
#.........#
#####.#####

3
0
#####d#####
#.........#
#.........#
#.........#
#.........#
#.........#
#.........#
#.......#.#
#......#..#
#.........#
#####d#####

1
4
###########
#.......ee#
#........e#
#.........#
#.........#
..........#
#.........#
#.........#
#.........#
#.........#
#####.#####
enemies 3
door 0 : 0 1

3
2
#####.#####
#.........#
#...#.....#
#...#.#...#
#...#.#...#
#..........
#.........#
#..#......#
#...#.....#
#e........#
###########
enemies 1

1
0
#####.#####
#.........#
#.........#
#.........#
#.........#
#..##@.....
#..##.#...#
#..##.....#
#.....#...#
#.........#
#####.#####

3
3
#####d#####
#..#......#
#.###.....#
#..#......#
#.#.#.....#
.....e.....
#.........#
#.........#
#.........#
#.........#
#####.#####
boss
enemies 1

0
1
###########
#.........#
#......#..#
#.......#.#
#.........#
..........#
#.........#
#.#.....#.#
#..#...#..#
#.........#
#####l#####
locked : 0

1
3
###########
#.........#
#.........#
#.....#..##
#.........#
...........
#..#..#...#
#.........#
#.........#
#..#.....##
#####.#####

2
4
#####.#####
#.........#
#.........#
#.........#
#.........#
...........
#.........#
#.#.......#
#..#....#.#
#.........#
#####.#####

2
1
#####l#####
#.........#
#.........#
######....#
#..#.#....#
.....#.....
#.####....#
#.###.....#
#.........#
#.........#
###########
locked : 1

1
2
###########
#......k..#
#......#..#
#.......#.#
#.........#
...........
#.........#
#.........#
#.........#
#.........#
#####.#####
key : 1

3
4
#####.#####
#.........#
#..#......#
#.#.......#
#.........#
..........#
#.........#
#.#.......#
#..#......#
#........k#
###########
key : 3

4
0
#####d#####
#.........#
#......#..#
#.......#.#
#.........#
#.........#
#.........#
#.........#
#.........#
#.........#
###########

2
3
#####.#####
#.........#
#.........#
#.........#
#.........#
l.....##...
#..#####..#
#....#.##.#
#...#..#..#
#.......#.#
#####d#####
locked : 2

4
3
#####.#####
#.........#
#.....##..#
#....#....#
#.........#
#.........#
#.........#
#.........#
#.........#
#X........#
###########

2
0
#####.#####
#.........#
#.........#
#.........#
#.........#
#.....#....
#.........#
#.....#...#
#.........#
#.........#
#####d#####

2
2
#####.#####
#k........#
#.........#
#...#..#..#
#.........#
..........l
#.........#
#.........#
#.........#
##.....#..#
#####.#####
key : 2

