2
0
#####d#####
#.........#
#.........#
#.........#
#.....#...#
#...#.##...
#...##....#
#...##.#..#
#.....#...#
#.........#
#####.#####

6
1
#####l#####
#.........#
#.........#
#.........#
#.........#
..........d
#.........#
#.........#
#.#.....#.#
#.k.......#
###########
key : 3

1
1
#####l#####
#.........#
#.........#
#.........#
#.........#
.........k#
#.........#
#.#.......#
#..#......#
#.........#
#####.#####
key : 0

2
1
#####.#####
#..#......#
#..##..#..#
#..##.....#
#..#...#..#
.........k#
#.........#
#.........#
#.........#
#.........#
#####l#####
key : 1

5
1
#####.#####
#.........#
#.........#
#.........#
#.........#
...........
#..#.#....#
#...#.....#
#...#.....#
#.........#
#####l#####
locked : 3

6
2
#####d#####
#.........#
#.........#
#.#..#..#.#
#.........#
d.........#
#....#..#.#
#.........#
#.........#
#.#.....#.#
#####.#####

4
1
#####.#####
#k........#
#.........#
#.........#
#.........#
...........
#.........#
#.#.......#
#..#......#
#.........#
#####.#####
key : 2

5
0
#####.#####
#s.......e#
#..#..#..##
#.........#
#.........#
#e..#......
#.........#
#.........#
#..#..#..##
#........e#
#####.#####
enemies 3
switch 0 : 0 1

3
1
#####l#####
##........#
#.........#
#.........#
#.#.......#
..........#
#.........#
#...#.....#
#.........#
#.........#
#####.#####
locked : 1

4
2
###########
#.......#X#
#.......#.#
#.....###.#
#.....###.#
..........#
#.........#
#.........#
#.........#
#.........#
#####.#####

0
1
###########
#.........#
#......##.#
#......##.#
#.........#
..........#
#.........#
#.#.#.....#
#..#......#
#.........#
#####l#####
locked : 0

0
0
###########
#.........#
#.........#
#.###.....#
#.#.#.....#
#..........
#.........#
#.........#
#.........#
#.........#
#####.#####

7
0
#####d#####
#.........#
#.........#
#.........#
#.........#
#....###..#
#..#..##..#
#...##....#
#...#.##..#
#......#..#
###########

6
0
#####.#####
#.......#.#
#.........#
#.....#...#
#.........#
#..........
#.........#
#.........#
#.........#
#.........#
#####d#####

5
2
#####.#####
#.........#
#.........#
#.##.#....#
#...#.....#
....#e#...#
#.#.#.....#
#.##......#
#.........#
#.........#
#####d#####
boss
enemies 1

7
2
#####.#####
#.........#
##..#..#..#
#.........#
#.........#
#...#..#..#
#.........#
#.........#
#...#..#..#
#e..?..e.e#
###########
enemies 3
door 0 : 0 1
sign The dungeon remembers all who enter.

4
0
#####.#####
#.........#
#.........#
#.........#
#.........#
#..........
#.........#
#.......#.#
#......#..#
#.........#
#####.#####

3
0
#####.#####
#.........#
#.........#
#.........#
#.........#
#..........
#.........#
#.........#
#.........#
#.........#
#####.#####

1
0
#####.#####
#.........#
#.........#
#.........#
#.........#
#?...@.....
#.........#
#.........#
#.........#
#.........#
#####d#####
sign A faint humming emanates from the walls.

