2
1
#####D#####
#k........#
#......#..#
#.......#.#
#.........#
D.........D
#..#......#
#.........#
#.#.......#
#.........#
#####D#####
key : 0

4
2
#####D#####
#k#.....#.#
#.........#
#.#.#.....#
#.........#
D.....#...D
#.........#
#.#.#.#.#.#
#.........#
#.........#
###########
key : 6

0
1
###########
#k........#
#.........#
##..#.....#
#.........#
#.........#
#.........#
#.........#
#.........#
##.....#..#
#####D#####
key : 3

2
3
###########
#.........#
#.........#
#...###...#
#....##...#
D...##.#..#
#.........#
#.........#
#.........#
#.........#
#####D#####

5
3
#####d#####
#.........#
#.........#
#.........#
#...e.....#
#....#p...#
#....#.#..#
#......#..#
#.........#
#.........#
#####D#####
boss
enemies 1

2
2
#####D#####
#.......#.#
#.........#
#.#.#.#.#.#
#.........#
D...#.#...D
#.........#
#.#.#.....#
#.........#
#.........#
#####D#####

3
2
#####D#####
#......####
#.........#
#p....###.#
#....#.p..#
d....#.#..D
#.........#
#.........#
#.........#
#.........#
#####D#####

2
0
#####D#####
#.........#
#.........#
#.........#
#.........#
#?...@....D
#.........#
#.........#
#.........#
#.........#
#####d#####
sign A useful tool lies just ahead.

1
2
###########
#.........#
#.........#
#.........#
#.........#
D.........#
#.........#
#.........#
#.........#
#.........#
#####D#####

4
1
#####l#####
#.........#
#......#..#
#.......#.#
#.........#
#.........D
#.........#
#.........#
#.........#
#.........#
###########
locked : 3

3
1
#####D#####
#ep......e#
#.........#
#.........#
#.....p...#
D.........d
#.........#
#.........#
#.........#
#e........#
#####l#####
enemies 3

1
1
#####D#####
#k........#
#.........#
#.........#
#.........#
D.........D
#.........#
#.#.......#
#..#......#
#.........#
#####D#####
key : 1

3
4
###########
#.........#
##.#...#.##
#.........#
#...#...#.#
l.........#
#..#.#.#..#
#.........#
#.#.#.#.#.#
#.........#
#####D#####
locked : 1

6
3
#####D#####
#.........#
#.........#
#.........#
#.........#
#.........#
#.........#
#.........#
#.........#
#X........#
###########

3
3
#####D#####
#.##......#
#.##......#
#.##...##.#
#.........#
D.........l
#.........#
#.........#
#.........#
#.........#
#####D#####

4
3
#####D#####
#.........#
#......#..#
#.......#.#
#.........#
D.........d
#.........#
#.........#
#.........#
#.........#
#####d#####

3
0
#####d#####
#.........#
##..#.....#
#.........#
#.........#
#....#....D
#.........#
#.........#
##.....#..#
#.........#
###########

4
4
#####D#####
#.........#
#.........#
#.........#
#.........#
d.........#
#.........#
#.###.....#
#.#.......#
####......#
###########

1
0
###########
#.........#
#.........#
#...#.....#
#.........#
#.........D
#.........#
#.......#.#
#......##.#
#.#.......#
#####D#####

