3
1
#####d#####
#......##.#
#.....###.#
#....##.#.#
#....##...#
D....##...D
#.........#
#.........#
#.........#
#.........#
###########

1
5
#####D#####
#.........#
#.........#
#.........#
#.........#
d....e....#
#.........#
#.........#
#.........#
#.........#
#####D#####
boss
enemies 1

1
2
###########
#.........#
#......#..#
#.......#.#
#.........#
D.........D
#.........#
#.......#.#
#......#..#
#.........#
#####D#####

1
4
#####d#####
#.........#
#..#..#...#
#.........#
#.........#
D......#..d
#.........#
#.........#
#..#.....##
#........k#
#####D#####
key : 3

2
2
#####D#####
#k........#
#......#..#
#.......#.#
#.........#
D.........D
#.........#
#.........#
#.........#
#.........#
#####l#####
key : 1

3
4
#####D#####
#.......#.#
#.........#
#.........#
#.#..#....#
#.........#
#.........#
#....#..#.#
#.........#
#.........#
###########

2
1
#####D#####
#.........#
#.........#
#.........#
#.........#
l.........D
#.........#
#.#.......#
#..#......#
#.........#
#####d#####
locked : 0

1
0
###########
#?........#
#.........#
#.........#
#.........#
#....@....D
#.........#
#.........#
#.........#
#.........#
#####D#####
sign Those who search shall find.

1
1
#####D#####
#k........#
#..#......#
#.#.......#
#.........#
D.........D
#.........#
#.........#
#.........#
#.........#
#####D#####
key : 2

2
0
#####D#####
#.........#
#..#......#
#k#.......#
#.........#
#.........l
#.........#
#.#.....#.#
#..#...#..#
#.........#
#####D#####
key : 0

3
0
#####D#####
#.........#
#.........#
#.........#
#.#..#....#
#.........D
#.........#
#.#.....#.#
#.........#
#.........#
###########

3
2
#####l#####
#.........#
#..#...#..#
#.........#
#....#.#..#
D.........#
#..#...#..#
#.........#
##.#.....##
#.........#
###########
locked : 1

2
3
#####l#####
#.........#
#......#..#
#.........#
#.........#
D....#....D
#.........#
#.........#
##..#..#..#
#.........#
###########

1
3
###########
#.........#
#.........#
#.........#
#.........#
D.........D
#.........#
#.#.....#.#
#..#...#..#
#.........#
#####l#####
locked : 2

2
4
#####D#####
##.....#.?#
#.........#
#.........#
#.#..#..#.#
D.........l
#.........#
#...#..#..#
#.........#
#e........#
#####D#####
enemies 1
door 0 : 0
sign Turn back; you are not yet ready.

2
5
#####D#####
#.........#
##.....#..#
#.........#
#.........#
l...#.....#
#.........#
#.........#
#......#..#
#.........#
###########
locked : 3

0
4
###########
##.#......#
#.........#
##.#.#...##
#.........#
#......#..D
#.........#
##...#.#.##
#.........#
##.#...#.##
#####d#####

0
5
###########
####.....X#
###.......#
#...#.....#
#..##.....#
D....##...#
#.........#
#.........#
#.........#
#.........#
#####D#####

0
1
###########
#s.....#e##
#........##
#.....#.###
#.##..#...#
#...#.....#
#...#.....#
####......#
###.#.....#
#.........#
#####D#####
enemies 1
switch 0 : 0

