0
0
###########
#k........#
#.....#...#
#.....#...#
#.........#
#.........l
#.........#
#.........#
#.........#
#.........#
#####D#####
key : 0

3
1
#####D#####
#.........#
#..#...#..#
#.#.....#k#
#.........#
D.........#
#.........#
#.........#
#.........#
#.........#
#####D#####
key : 3

4
4
#####D#####
#.........#
##........#
#........##
#.........#
d....e....#
#.........#
#.........#
#.........#
#.........#
#####D#####
boss
enemies 1

5
4
#####D#####
#.##......#
#..#......#
#...###...#
#.#..##...#
D.........#
#.........#
#.........#
#.........#
#........X#
###########

3
3
#####D#####
#.........#
##.#...#..#
#.........#
#..#.#.#..#
#.........d
#..#.#.#..#
#.........#
##.....#.##
#.........#
#####d#####

0
1
###########
#.........#
#.......#.#
#.........#
#.........#
l..#..#...#
#.........#
#.........#
#.#.....#.#
#.........#
###########
locked : 0

2
0
#####D#####
#.........#
#...#..#..#
#.........#
#.........#
#....#....D
#.........#
#.........#
##..#..#..#
#k........#
#####D#####
key : 1

2
3
#####D#####
#.........#
#......#..#
#.......#.#
#.........#
d.........#
#.........#
#.......#.#
#......#..#
#.........#
#####D#####

1
0
#####D#####
#.........#
#.........#
#....###..#
#.....#...#
#....@?#..#
#....###..#
#....##..##
#.........#
#.........#
#####D#####
sign The brave are rewarded.

3
0
#####D#####
#e#.......#
#.........#
#?........#
#s.#..#...#
#e........D
#.........#
#e#..#....#
#.........#
#.........#
#####D#####
enemies 3
switch 0 : 0
sign Something glints behind that door…

2
1
###########
#......#..#
#.......#.#
#.#..###..#
#..#......#
D...#.....l
#.##......#
#..###....#
#.........#
#.........#
#####D#####

1
3
###########
#.......ee#
#.........#
#.........#
#.........#
D.........#
#.........#
#.........#
#.........#
#.........#
#####D#####
enemies 2
door 0 : 0

4
0
#####D#####
#.......#.#
#...#...#.#
#.....#.#.#
#......#..#
#.........D
#....#....#
#.........#
#.........#
#.........#
###########

4
3
#####d#####
#.........#
#...#..#..#
#.......#.#
#.........#
#.....#...d
#.........#
#.#.......#
#..#......#
#.........#
#####D#####

2
2
#####D#####
#.........#
#..#...#..#
#.#.....#.#
#.........#
l.........d
#.........#
#.........#
#.........#
#.........#
###########
locked : 3

5
3
#####D#####
#.........#
##.#.....##
#.........#
#...#.#.#.#
#.........D
#..#.#.#..#
#.........#
#e#...#.#.#
#e?.......#
###########
enemies 2
sign Beware what lurks ahead.

1
2
###########
#k........#
#..#......#
#.#.......#
#.........#
#.........D
#.........#
#.........#
#.........#
#.........#
#####D#####
key : 4

4
1
#####D#####
#.........#
#.........#
#.........#
#.........#
D.........#
#.........#
#.........#
#.........#
#.........#
###########

3
4
###########
#.........#
#.........#
#.........#
#.........#
d..#......#
#.#.......#
#.##......#
#.........#
#.........#
#####D#####

