5
2
#####D#####
#.........#
#..#......#
#.#.......#
#.........#
D.........#
#.........#
#.....#k#.#
#......#..#
#........##
###########
key : 2

3
1
#####D#####
##........#
##..#..#..#
#...#...#.#
#.##..#...#
D..#......D
#.........#
#.........#
#.........#
#e........#
#####d#####
enemies 1

4
0
#####d#####
#.........#
#.........#
#.........#
#.........#
#.........D
#.........#
#.........#
#.........#
#.........#
#####D#####

2
1
###########
#.........#
#.........#
#.#.#.....#
#.##......#
D..####...D
#...#.#...#
#..#..#...#
#.##..#...#
#.........#
#####D#####

4
2
#####D#####
##.....#..#
#.........#
#.........#
#.#..#..#.#
d.........D
#.........#
##..#.....#
#.........#
#.........#
#####D#####

3
3
#####l#####
#.........#
#.........#
#.........#
#.........#
D....e....#
#.........#
#.........#
#.........#
#.........#
#####D#####
locked : 4
boss
enemies 1

0
2
###########
#k........#
#.........#
#.........#
#.........#
#.........#
#.........#
#.#.....#.#
#..#...#..#
#.........#
#####D#####
key : 6

1
0
###########
#.........#
#.........#
#.........#
#.........#
#....@....#
#.........#
#.........#
#.........#
#.........#
#####D#####

2
0
#####D#####
#k........#
##.....#..#
#.........#
#.........#
#...#..#..D
#.........#
#.........#
#...#..#..#
#.........#
#####l#####
key : 0

4
1
#####d#####
#.........#
#..#......#
#.#.......#
#.........#
D.........d
#.........#
#.........#
#.........#
#.........#
#####D#####

3
0
#####l#####
#.........#
#.....#...#
#..#......#
#.........#
#.........D
#.........#
#.#.......#
#..#......#
#.........#
#####d#####
locked : 0

3
2
#####D#####
#.........#
#.........#
#.........#
#.........#
D.........D
#.........#
#.........#
#.........#
#.........#
#####D#####

6
1
#####d#####
#.........#
#.........#
#.........#
#.........#
#..#.#....#
#..#...##.#
#..###..#.#
#.........#
#.........#
###########

2
3
###########
#.....e#?e#
#.....#e..#
#.p##.##..#
#.###.....#
D..###.#..#
#..p......#
#.........#
#.........#
#.........#
#####l#####
enemies 3
sign Turn back; you are not yet ready.

4
3
#####D#####
#.........#
#.........#
#.........#
#.........#
D.........#
#.##......#
#..###....#
##.#......#
#........X#
###########

5
0
#####D#####
#.........#
#..#...#..#
#.#.....#.#
#.........#
#.........D
#.........#
#.........#
#.........#
#.........#
###########

5
1
#####D#####
#e.#......#
#..##.....#
#.........#
#.........#
D.........D
#.........#
#.........#
#.........#
#?........#
#####d#####
enemies 1
sign Something glints behind that door…

2
2
#####D#####
#.........#
#.........#
#.........#
#..#......#
D...##....D
#..###....#
#.........#
#.........#
#.........#
#####D#####

1
2
#####D#####
#.........#
#.........#
#.........#
#.........#
#k........#
#.........#
#.........#
#.........#
#.........#
#####D#####
key : 4

