1
1
#####D#####
#.........#
#......#..#
#.......#.#
#.........#
D.........d
#.........#
#.......#.#
#......#..#
#.........#
#####D#####

2
4
###########
#.......ee#
#........e#
#.........#
#.........#
D.........#
#.#.......#
#.........#
#.#.......#
#.........#
#####D#####
enemies 3

0
2
###########
####......#
#.##.....p#
#..#......#
#..#......#
D.........#
#.........#
#.........#
#.........#
#.........#
#####d#####

2
2
#####D#####
#..p......#
#........p#
#......#..#
#..##.#.#.#
D..#..#...l
#...##k##.#
#..##.....#
#.........#
#.........#
#####D#####
key : 2

3
1
#####l#####
#........##
#.........#
#.........#
#...#..#..#
#.........D
#.........#
#..#..#...#
#.........#
#.........#
###########
locked : 1

3
3
#####D#####
#.........#
#..#......#
#.#.......#
#.........#
D.........d
#.........#
#.......#.#
#......#..#
#.........#
#####D#####

0
1
###########
#......k..#
#......#..#
#.......#.#
#.........#
D.........D
#.........#
#.#.......#
#..#......#
#.........#
#####D#####
key : 0

1
2
#####d#####
#.........#
#.........#
#......##.#
#.....#...#
d.........l
#..p...#..#
#....#....#
#.....##..#
#.........#
#####D#####

1
3
###########
#.........#
#.........#
#.........#
#.........#
l.........#
#.........#
#.#.......#
#..#......#
#.........#
#####D#####
locked : 7

2
3
#####D#####
#.........#
#.........#
#.........#
#.........#
l.........D
#.........#
#.........#
#.........#
#.........#
#####D#####
locked : 2

1
0
#####D#####
#..#......#
#..#...#..#
#..#..##..#
#....##...#
#...###...D
#.........#
#.........#
#.........#
#.........#
#####D#####

2
0
#####D#####
#.........#
#.#.#.#.#.#
#.........#
#.#.#...#.#
#.........D
#.#.#...#.#
#.........#
#.#.#.#.#.#
#k........#
###########
key : 7

4
3
#####D#####
#.........#
#.........#
#....#..#.#
#.........#
D.........D
#..#..#...#
#.........#
#.........#
#....e.e#e#
###########
enemies 3

3
4
#####D#####
#.##......#
#..##.....#
#.##......#
#.###.....#
d....e....#
#.........#
#.........#
#.........#
#.........#
#####D#####
boss
enemies 1

3
2
#####D#####
#.........#
#.......#.#
#.........#
#.........#
D....#....D
#.........#
#.........#
#.#.....#.#
#.........#
#####D#####

0
0
###########
#.........#
#.........#
#.........#
#.........#
#....@....D
#.........#
#.........#
#.........#
#.........#
#####D#####

4
4
#####D#####
#.........#
#......p..#
#.........#
#.........#
D.........#
#.........#
#.........#
#.........#
#........X#
###########

2
1
#####D#####
#k........#
#.........#
#.........#
#.........#
D.........D
#.p.......#
#.........#
#.........#
#.........#
#####l#####
key : 1

4
2
#####D#####
#.........#
##........#
#.........#
#.........#
#......#..D
#.........#
#.#.......#
#..#......#
#.........#
###########

