2
0
#####.#####
#.........#
#......#..#
#.......#.#
#.........#
#..........
#.........#
#.......#.#
#......#..#
#k........#
###########
key : 7

1
0
#####.#####
#.........#
#.........#
##........#
#.........#
#..........
#....#..#.#
#.........#
#.........#
##.....#..#
#####.#####

1
3
###########
#.........#
#.#.#...#.#
#.........#
#.....#.#.#
l.........#
#.#.#.#.#.#
#.........#
#.#.#.#.#.#
#.........#
#####.#####
locked : 7

3
2
#####.#####
#.#.......#
#.........#
#.........#
#.#.....#.#
...........
#.........#
#.#.....#.#
#.........#
#.........#
#####.#####

4
4
#####.#####
#.........#
#.........#
#.........#
#.........#
.....#....#
#...#.....#
#.....#...#
#.........#
#..#.....X#
###########

3
4
#####.#####
#.......#.#
#...#.#...#
#......#..#
#....##...#
d....e....#
#.........#
#.........#
#.........#
#.........#
#####.#####
boss
enemies 1

3
1
#####l#####
##.#...#..#
#.........#
#...#.#.#.#
#.........#
#..#.#.....
#.........#
#...#...#.#
#.........#
##.....#..#
###########
locked : 1

4
2
#####.#####
#.........#
#......#..#
#.......#.#
#.........#
#..........
#.........#
#.#.......#
#..#......#
#.........#
###########

0
0
###########
#.........#
#.........#
#.........#
#.........#
#....@.....
#.........#
#.........#
#.........#
#.........#
#####.#####

2
4
###########
#......e.e#
##.#...#e##
#.........#
#..#.#....#
..........#
#....#.#..#
#.........#
#..#.....##
#.........#
#####.#####
enemies 3

1
1
#####.#####
#.........#
#.........#
#.#.....#.#
#.........#
..........d
#..#..#...#
#.........#
#.........#
#.#.....#.#
#####.#####

0
2
###########
#......#..#
#..##.#...#
#..#.##...#
#..#.####.#
.......#..#
#..##.#...#
#.........#
#.........#
#.........#
#####d#####

3
3
#####.#####
#.##......#
#.#.......#
#.###.....#
#..###....#
...##.....d
#.....#...#
#.........#
#.........#
#.........#
#####.#####

0
1
###########
#k........#
##.....#.##
#.........#
#.#.#...#.#
...........
#....#.#..#
#.........#
#.#.#.#...#
#.........#
#####.#####
key : 0

4
3
#####.#####
#e........#
#.........#
#.........#
#.........#
...........
#.........#
#.........#
#.........#
#e...e....#
###########
enemies 3

2
1
#####.#####
#.........#
#.........#
#.........#
#.........#
....#......
#.##......#
#.#k#.....#
#.........#
#.........#
#####l#####
key : 1

2
3
#####.#####
#.........#
#.........#
#.........#
#.##......#
l..##......
#.###.....#
###..#....#
#.##..#...#
#.........#
#####.#####
locked : 2

1
2
#####d#####
#.........#
#..#......#
#.#.......#
#.........#
d.........l
#.........#
#.#.......#
#..#......#
#.........#
#####.#####

2
2
#####.#####
#k........#
#.........#
#.........#
#.........#
..........l
#...##....#
#.........#
#...#.....#
#.........#
#####.#####
key : 2

