4
2
#####.#####
#e#.....#e#
#.........#
#.#...#.#.#
#.........#
....#.#....
#.........#
#.#.#.#.#.#
#.........#
#e#.....#s#
###########
enemies 3
switch 0 : 0

2
2
#####d#####
#.#.......#
#.........#
#.........#
#..#..#...#
..........#
#.........#
#.......#.#
#.........#
#.........#
#####.#####

3
1
#####.#####
#.........#
#.........#
#.#.#.....#
#.......#.#
....#......
#..#......#
#.........#
#.........#
#.........#
#####l#####

1
3
###########
#..#.....k#
#.......#.#
#......##.#
#.......#.#
..........#
#.........#
#.........#
#.........#
#.........#
###########
key : 3

5
1
#####l#####
#.........#
#.....#...#
#...#...#.#
#...#.#...#
#...e###..#
#....##.#.#
##....#.#.#
#.....#..##
#........##
#####.#####
locked : 3
boss
enemies 1

0
1
###########
#.........#
#...#.#...#
#....##...#
#......#..#
d......#..#
#...###...#
#...#..##.#
#...#.##..#
#.........#
#####.#####

4
4
###########
#........e#
#.........#
#.........#
#.........#
..........#
#.#.......#
#.##......#
#...#.....#
#........e#
###########
enemies 2
door 0 : 0

6
1
#####.#####
#.........#
#.........#
#.........#
#.........#
#.........#
#.........#
#.........#
#.........#
#X........#
###########

2
0
#####.#####
#.........#
####......#
##........#
#?#.......#
#....@.....
#.........#
#.........#
#.........#
#.........#
#####l#####
sign A locked path — look elsewhere first.

4
1
#####l#####
#.........#
#.........#
#.........#
#.........#
...........
#.........#
#.........#
#.........#
#.........#
#####l#####
locked : 2

3
0
#####l#####
#.........#
#.........#
#....##...#
#.#..##...#
#...###....
#..###....#
#.#.##....#
#.........#
#.........#
#####.#####
locked : 0

1
0
#####d#####
#.........#
#.........#
#.........#
#.........#
#k.........
#.........#
#.........#
#.........#
#.........#
#####.#####
key : 0

1
1
#####.#####
#.........#
#......#..#
#.......#.#
#.........#
..........d
#.........#
#.......#.#
#......#..#
#.........#
#####.#####

0
0
###########
#......#..#
#.........#
#.#...#...#
#.........#
#..#.#.#..d
#.........#
#.#.#.#...#
#.........#
##.#...#.##
#####d#####

4
0
#####.#####
#.........#
#.#...##..#
#....#.#..#
#.###..#..#
#.....##...
#..#..#...#
#.........#
#.........#
#.........#
###########

3
2
#####.#####
#.........#
#.........#
#...#.....#
#.........#
.........k#
#.........#
#.........#
#.........#
#.........#
#####.#####
key : 2

4
3
###########
##k.......#
#.........#
#.........#
#.#..#..#.#
...........
#.........#
##..#..#..#
#.........#
#.........#
###########
key : 4

2
1
#####.#####
#.........#
#.........#
#..#......#
#.........#
...........
#....#....#
#.......#.#
#......#..#
#.........#
#####.#####

1
2
###########
#.........#
#.........#
#.........#
#.##......#
d..#.......
#.#...#...#
#..####...#
#.....#...#
#.........#
#####d#####

