3
4
###########
#.........#
#.........#
#.........#
#.........#
d....e....#
#.........#
#.........#
#.........#
#.........#
#####.#####
boss
enemies 1

1
1
#####.#####
#.........#
#......#..#
#.......#.#
#.........#
..........d
#.........#
#.........#
#.........#
#.........#
#####.#####

3
0
#####d#####
#.........#
#.........#
#..#.....##
#.........#
#..........
#..#..#...#
#.........#
#.........#
#........##
#####.#####

0
1
###########
#.........#
#.....#####
#....###..#
#......##.#
...#.###..#
#..####...#
#.##......#
#.........#
#.........#
#####.#####

1
0
#####.#####
#.........#
#.........#
#.........#
#.........#
#.....#....
#....##...#
#....##.#.#
#.....#..##
#......#..#
#####.#####

4
2
#####.#####
#.........#
#.........#
#.........#
#.####....#
...###....#
#.###.....#
####.#....#
###.......#
#........k#
###########
key : 2

3
3
#####.#####
#......#..#
#.........#
#..#..#...#
#..##.#...#
.....##...d
#.........#
#.........#
#.........#
#.....k#..#
###########
key : 3

4
1
#####.#####
##.......##
#.........#
##.#...#.##
#.........#
l..#.#.#...
#.........#
##...#.#.##
#.........#
##.#...#.##
###########
locked : 1

4
4
#####.#####
#.........#
#.........#
#.........#
#.........#
#.........#
#.........#
#.........#
#.........#
#X........#
###########

4
0
#####.#####
#.........#
#.........#
#.........#
#.........#
#.........l
#.........#
#.......#.#
#......#..#
#.........#
#####.#####

0
0
###########
#e?.......#
#e........#
##s#......#
#e........#
#..........
#.........#
#....#....#
#.........#
#.........#
#####.#####
enemies 3
switch 0 : 0
sign Beware what lurks ahead.

2
0
#####.#####
#......#..#
#...#..#..#
#.....##..#
#...@#.#..#
#...##.....
#...#.#...#
#...#.#...#
#.........#
#.........#
#####d#####

1
2
###########
#.........#
#..#..##..#
#.#.....#.#
#.........#
d.........#
#.........#
#.#.......#
#..#......#
#.........#
#####.#####

3
2
#####.#####
#k........#
#.........#
#.........#
#.........#
...........
#.........#
#.........#
#.........#
#.........#
#####.#####
key : 1

2
3
###########
#.........#
#..#......#
#.........#
#.#...#...#
d..####...#
#...#.#...#
#...#.....#
#.....#...#
#.........#
#####.#####

3
1
#####.#####
#?........#
#...#..#..#
#....####.#
#....###..#
.....e##...
#....#e##.#
#.........#
#..#......#
#.........#
#####.#####
enemies 2
sign A locked path — look elsewhere first.

2
2
#####.#####
#.......#.#
#..#......#
#.#.......#
#.........#
..........d
#.........#
#...#.....#
##........#
#k........#
#####.#####
key : 0

2
1
#####.#####
#.........#
#.........#
#..#..#..##
#.........#
...........
#...#.....#
#.........#
#.........#
#..#.....##
#####.#####

5
0
#####.#####
#.........#
#.........#
#.........#
#.........#
#.........#
#.........#
#.........#
#.........#
#e........#
###########
enemies 1
door 0 : 0

