1
0
#####.#####
#.........#
#.........#
#.........#
#.........#
#k........l
#.........#
#.........#
#.........#
#.........#
#####.#####
key : 1

1
2
###########
#.........#
#.........#
#.........#
#.........#
...........
#.........#
#.........#
#.........#
#.........#
#####.#####

2
0
#####.#####
#.........#
#.........#
#.........#
#.........#
#....@.....
#.........#
#.........#
#.........#
#.........#
#####.#####

5
0
#####d#####
#.#.......#
#...#.....#
####......#
#.####....#
#..###....l
#..###....#
##........#
#.........#
#.........#
#####d#####

6
1
#####.#####
#.........#
#.........#
#.........#
#.........#
d....e.....
#.........#
#.........#
#.........#
#.........#
#####.#####
boss
enemies 1

3
0
#####.#####
#.........#
#...#.....#
#..##.....#
#k##.#....#
#..........
#.........#
#.........#
#.........#
#.........#
#####l#####
key : 0

6
0
#####d#####
#.........#
#.#.....#.#
#.........#
#.........#
#..#..#...d
#.........#
#.........#
#.#.....#.#
#.........#
###########

2
3
#####.#####
#.........#
#.##......#
#.#.......#
#.........#
d.........#
#.........#
#.#.......#
#..#......#
#.........#
###########

5
1
###########
#........##
#.........#
#.........#
#...#..#..#
l.........#
#.........#
#..#..#..##
#.........#
#.........#
#####.#####
locked : 4

2
2
#####.#####
#k........#
#......#..#
#.......#.#
#.........#
..........d
#.........#
#.#.......#
#..#......#
#.........#
#####.#####
key : 4

1
1
###########
#......#..#
#.....##.##
#...####.##
#...##....#
l.....##...
#....#....#
#.........#
#.......#.#
#.........#
#####.#####
locked : 1

2
1
#####.#####
#.......#.#
##........#
#.......#.#
#.........#
...........
#.........#
#.........#
#.........#
#.........#
#####.#####

4
0
#####l#####
#.........#
#.....#...#
#....###..#
#.....#...#
#.........#
#.........#
#.........#
#.........#
#.........#
#####d#####
locked : 0

6
2
###########
#........k#
#......#..#
#.......#.#
#.........#
..........#
#.........#
#.........#
#.........#
#.........#
###########
key : 8

1
3
###########
#.........#
#.#.......#
#..#......#
#..#......#
..........#
#..#......#
##.#......#
#..#......#
#.........#
#####.#####

7
1
#####.#####
#.........#
#.........#
#.........#
#.........#
#.........#
#.........#
#.........#
#.........#
#X........#
###########

3
2
#####.#####
#.........#
##.....#.##
#.........#
#..#.#.#..#
..........#
#....#.#..#
#.........#
##.#...#.##
#.........#
###########

0
0
###########
#..#......#
#.........#
#.........#
#..#..#...#
#.........#
#.........#
#.....#..##
#.........#
#.........#
#####.#####

3
1
#####.#####
#.......#e#
#..#..#.#.#
#.##...##.#
#.........#
.......#...
#.........#
#.........#
#.........#
#.........#
###########
enemies 1

