0
0
###########
#......#k.#
#.......#.#
#....####.#
#......##.#
#.........#
#.........#
#.........#
#.........#
#.........#
#####D#####
key : 3

4
2
###########
#.##e.....#
#.###.....#
#...#.....#
#...#.....#
D.........D
#.........#
#.........#
#.........#
#.........#
#####D#####
enemies 1

1
1
###########
#........k#
#.........#
#.........#
#.........#
D.........#
#.........#
#.........#
#.........#
#.........#
###########
key : 2

6
0
#####D#####
#.........#
#.#.#.#.#.#
#.........#
#.#.....#.#
#.........D
#e#.#...#.#
#.........#
#...#.#...#
#e........#
###########
enemies 2
door 0 : 0

5
2
#####D#####
#.........#
#.#.#.#.#.#
#.........#
#....#.#..#
d.........d
#...#.#.#.#
#.........#
#..#...#.##
#.........#
#####D#####

5
4
###########
#.........#
#.........#
#......#..#
#.....#...#
d.........#
#.........#
#.........#
#...#.....#
#.........#
#####l#####

5
0
#####D#####
#.........#
#......#..#
#.......#.#
#.........#
#.........d
#.........#
#.#.......#
#..#......#
#.........#
#####D#####

5
1
#####l#####
#.........#
#..#......#
#.#.......#
#.........#
d.........d
#.........#
#.........#
#.........#
#.........#
#####D#####

5
3
#####D#####
#..#......#
#.........#
#.........#
#.........#
d.........d
#......#..#
#.#.#.....#
#..#......#
#.........#
###########

4
0
#####D#####
#.........#
#.........#
#.........#
#.........#
#k........D
#.........#
#.......#.#
#......#..#
#.........#
#####D#####
key : 0

3
0
#####D#####
#.........#
#.........#
#.........#
#.........#
#?...@....#
#.........#
#.........#
#.........#
#.........#
#####D#####
sign A useful tool lies just ahead.

4
3
###########
#........k#
#.........#
#.........#
#.........#
D.........#
#.........#
#.#.......#
#..#......#
#.........#
#####D#####
key : 8

4
1
###########
#.........#
#.........#
#....##...#
#.##......#
D....##...D
#.........#
#.........#
#.........#
#.........#
#####l#####
locked : 2

6
1
#####D#####
#.........#
#......#..#
#.......#.#
#.........#
D.........D
#.........#
#.#.....#.#
#..#...#..#
#.........#
###########

7
4
#####D#####
#.........#
#.##..#...#
#.#.......#
#..#.##...#
#...#.#...#
#.#...#...#
#.........#
#.........#
#X........#
###########

6
4
#####l#####
#.........#
#.........#
#.........#
#.........#
#....e....#
#.........#
#.........#
#.........#
#.........#
#####D#####
locked : 0
boss
enemies 1

2
0
#####D#####
#.........#
#.........#
#.........#
#e###.....#
#.s.......#
#e#.......#
#####.....#
##.#......#
#e........#
#####D#####
enemies 3
switch 0 : 0

6
2
#####D#####
#.#.......#
#..##.....#
##.##.....#
#.........#
D..##.....#
#.##......#
#........##
#.........#
#.........#
###########

1
0
#####D#####
##.....#..#
#.........#
#.........#
#...#.....#
#.........D
#.........#
#.........#
#.........#
#.........#
#####D#####

