3
3
#####D#####
#k#.......#
#......#..#
#.......#.#
#......#..#
D.........D
#.........#
#.......#.#
#......##.#
#.........#
#####l#####
key : 4

2
2
###########
#.........#
#...#.#.#.#
#...###.#.#
#.........#
D.........l
#.........#
#.........#
#.........#
#.........#
#####D#####

2
1
#####D#####
##........#
#k##......#
#.##.#....#
#.#....#..#
D.........D
#......#..#
#.........#
#.........#
#.........#
#####D#####
key : 0

0
0
###########
#.........#
#.........#
#.....###.#
#...##.##.#
#...#.....#
#...#.....#
#...##..#.#
#.........#
#.........#
#####d#####

2
0
#####D#####
##........#
#.........#
#.........#
#.#..#..#.#
#.........D
#.........#
##........#
#.........#
#.........#
#####D#####

3
1
#####D#####
#k........#
##.##.....#
#..#......#
#.#.......#
D..##.....D
#..#......#
#.........#
#.........#
#.........#
###########
key : 2

3
4
#####D#####
#.......p.#
#.........#
#.........#
#.....#p..#
D...##....#
#.........#
#.........#
#.........#
#.........#
###########

3
2
#####D#####
#k#.....#.#
#.........#
#......#..#
#.........#
D...#.#...D
#.........#
#..#...#.##
#.........#
#.......#.#
###########
key : 3

1
0
#####d#####
#.........#
#.........#
#.........#
#.........#
#.........D
#.........#
#.........#
#.........#
#.........#
#####D#####

4
3
#####l#####
#.........#
#......#..#
#.......#.#
#.........#
#.........#
#.........#
#.........#
#.........#
#.........#
###########
locked : 4

2
4
#####D#####
#.........#
#.....##..#
#......#..#
#....###..#
l.........d
#.........#
#.........#
#.........#
#.........#
#####D#####
locked : 3

2
3
#####l#####
#.........#
#.........#
#.........#
#.........#
l.........l
#.........#
#.........#
#.........#
#.........#
#####D#####
locked : 2

0
4
###########
#........X#
#.........#
#....#.##.#
#....#.#..#
D...#..#..#
#....#.##.#
#...##.##.#
#.........#
#.........#
#####D#####

2
5
###########
#.........#
#......#..#
#.......#.#
#.........#
d.........#
#.........#
#.........#
#.........#
#.........#
###########

1
4
#####D#####
#.........#
#.........#
#.........#
#.........#
d....e....#
#.........#
#.........#
#........##
#.........#
#####D#####
boss
enemies 1

1
1
###########
#......e.e#
##.....#?##
#.........#
#.#.#.#...#
D.........#
#..#.#.#..#
#.........#
#.#.#.#...#
#.........#
#####D#####
enemies 2
sign Something glints behind that door…

1
3
#####d#####
#.........#
#......#..#
#.......#.#
#.........#
#.........d
#.........#
#.#.......#
#.##......#
#.........#
#####l#####
locked : 0

3
0
#####D#####
#.........#
#.........#
#.....#.#.#
#.........#
#..##@#...D
#..##.....#
##.#.#....#
#?........#
##........#
###########
sign Something glints behind that door…

0
3
###########
#.........#
#..#...#..#
#.#.....#.#
#.........#
#.........D
#.........#
#.........#
#.........#
#.........#
#####d#####

