3
0
#####.#####
#.........#
#.........#
#.........#
#.........#
#.....#....
#.........#
#.......#.#
#......#..#
#.........#
#####.#####

5
3
###########
#.#.....#.#
#.........#
#.#.#.#.#.#
#.........#
d...#.#...d
#.........#
#.#.#...#.#
#.........#
#.......#.#
#####.#####

2
1
#####.#####
#.........#
#.#.....#.#
#.........#
#.........#
.....#....#
#.........#
#.........#
#.#.....#.#
#.........#
#####.#####

1
1
###########
#........k#
#.........#
#.........#
#.........#
..........#
#.........#
#.#.......#
#..#......#
#.........#
#####.#####
key : 7

4
1
#####.#####
#.........#
#.........#
#.........#
#.........#
...#.......
#.##......#
#...###...#
#.........#
#....k....#
###########
key : 0

0
0
###########
#k........#
#.........#
#.........#
#.........#
#.........#
#.........#
#.........#
#.........#
#.........#
#####.#####
key : 6

3
1
#####.#####
#.........#
#.........#
#.........#
#.........#
...........
#.........#
#.........#
#.........#
#.........#
#####.#####

5
0
#####.#####
#.........#
#.........#
#.........#
#.........#
#.........#
#.........#
#.........#
#e........#
#e.......e#
###########
enemies 3

4
0
#####.#####
#.........#
#..##.##..#
#..##.##..#
#..#?#....#
#..#.@##...
#...#..#..#
#....#....#
#.......#.#
#.........#
#####.#####
sign A useful tool lies just ahead.

2
0
#####.#####
#......##k#
#.....#.#.#
#....##...#
#....####.#
#....###...
#.........#
#.........#
#.........#
#.........#
#####.#####
key : 1

6
3
#####.#####
#.........#
#.....#..##
#.........#
#.........#
...#......#
#.........#
#.........#
#..#..#..##
#.........#
###########

1
0
#####.#####
#.........#
#.........#
#.....##..#
#....###..#
#....#.#...
#.........#
#.........#
#.........#
#.........#
#####.#####

6
2
#####d#####
#..#......#
#..#..##..#
#..#####..#
#..####...#
#..#.###...
#..#.###..#
#.........#
#.........#
#.........#
#####l#####

7
2
#####l#####
#.........#
#.........#
#.........#
#.........#
#....e....#
#.........#
#.........#
#.........#
#.........#
#####.#####
locked : 1
boss
enemies 1

8
2
#####.#####
#.........#
#.........#
#.........#
#.........#
#.........#
#.........#
#.........#
#.........#
#X........#
###########

4
2
#####.#####
#.........#
#.........#
##........#
#.........#
..........#
#.#.....#e#
#.........#
#.........#
##.....#..#
#####d#####
enemies 1

5
2
#####d#####
#.........#
#.........#
#.........#
#.........#
#.........d
#.........#
#.#.....#.#
#..#...#..#
#.........#
#####d#####

3
2
###########
#.........#
#.........#
#.........#
#.#.#.#.#.#
..........#
#.#...#.#.#
#.........#
#.#.#.#.#.#
#.........#
#####.#####

5
4
###########
#.........#
#..#......#
#.#.......#
#.........#
d.........#
#.........#
#.#.......#
#..#......#
#.........#
###########

