4
0
#####D#####
#.........#
#.........#
#.........#
#.........#
#...#.....D
#....#....#
#...#.....#
#.........#
#k........#
###########
key : 1

5
2
#####d#####
#.........#
#.........#
#.........#
#...e.....#
D....#....D
#.........#
#.....#...#
#.........#
#.........#
#####D#####
boss
enemies 1

2
0
#####D#####
#.........#
#.........#
#......##.#
#.........#
#?...@....D
#.........#
#.........#
#.........#
#.........#
#####D#####
sign The torches flicker in a sourceless wind.

5
1
#####d#####
#.........#
#..#...#..#
#.#.....#.#
#.........#
#.........D
#.........#
#.........#
#.........#
#.........#
###########

4
2
#####D#####
#.........#
#.#.....#k#
#.........#
#.........#
D....#....#
#.........#
#.........#
#.......#.#
#.........#
#####d#####
key : 2

3
2
#####D#####
#.........#
#.........#
#.........#
#.........#
D.........#
#.........#
#.........#
#.........#
#.........#
#####D#####

2
1
#####D#####
#.........#
###.......#
##..#.....#
#..##.....#
D..#...#..D
#...#..#..#
#.........#
#.........#
#.........#
#####d#####

2
3
###########
#.........#
##.#...#.##
#.........#
#.#.#.#.#.#
d.........l
#....#.#..#
#.........#
#...#...#.#
#.........#
###########

5
3
###########
#........X#
#.........#
#.........#
#.........#
D...#.....#
#..##.....#
#.###.....#
#.........#
#.........#
###########

3
1
#####d#####
#.........#
#.........#
#....#.####
#.....###.#
D.....##..D
#....####.#
#....#..#.#
#.........#
#.........#
#####l#####

2
4
###########
#.........#
#.........#
#.........#
#.........#
l..#.#....#
#..#.#....#
#.#.##....#
#.#.#.....#
#.#.......#
###########
locked : 0

6
2
#####D#####
#.........#
#.........#
#.........#
#.........#
#..##.....#
#...#.#...#
#...#.#...#
#####.....#
##k.......#
###########
key : 3

1
1
###########
#.........#
#.........#
#.........#
#.....###.#
D....##...D
#.........#
#....#..#.#
#..p...####
#.........#
#####D#####

1
0
###########
#.........#
####......#
##.#......#
#..#......#
#...#.....D
#...##....#
#..###....#
#.........#
#.........#
#####D#####

4
1
#####l#####
##.#...#..#
#.........#
#.#.#.#.#.#
#.........#
D..#.#.#..D
#.........#
#.#.#...#.#
#.........#
##.#......#
#####d#####
locked : 1

0
2
###########
#.........#
#.....#..##
#.........#
#.........#
#..#..#...#
#.........#
#.........#
#........##
#.........#
#####l#####
locked : 2

3
0
#####D#####
#.........#
#.........#
#.........#
#.#.......#
#..#......D
#..#......#
#.........#
#.........#
#.........#
#####D#####

2
2
#####D#####
#k........#
#.........#
#...#..#..#
#.........#
D.........d
#...#..#..#
#.........#
#.........#
##.....#..#
#####D#####
key : 0

1
2
#####l#####
#.........#
#.........#
#.........#
#.........#
D.........#
#.........#
#.........#
#.........#
#.........#
#####D#####

