2
3
#####d#####
#.........#
#..#...#..#
#.#.....#.#
#.........#
d.........d
#.........#
#.........#
#.........#
#.........#
###########

1
2
###########
#.........#
#.........#
#..#......#
#....#....#
....##.....
#..##.....#
##.##.....#
#...#.....#
###.......#
#####.#####

1
1
###########
#.........#
#..##.....#
#....#....#
#..###....#
......#....
#..#......#
#.........#
#.........#
#.........#
#####.#####

3
0
#####.#####
#.........#
#..#......#
#k#.......#
#.........#
#..........
#.........#
#.........#
#.........#
#.........#
#####.#####
key : 0

2
0
#####l#####
#.........#
#.........#
#.........#
#.........#
#?..#@.....
#.........#
#.........#
#.........#
#.........#
#####.#####
sign Seek the matching key before you proceed.

2
1
#####.#####
#.........#
#.........#
#.........#
#.........#
...........
#.........#
#.........#
#.........#
#.........#
#####.#####

5
1
#####.#####
#.........#
#...#.#.#.#
#.........#
#......#..#
..........#
#.#.#...#.#
#.........#
#..#......#
#.........#
###########

4
1
#####.#####
#k........#
#.........#
#.........#
#.........#
..........l
#.........#
#.........#
#.........#
#.........#
#####.#####
key : 3

3
1
#####.#####
#k........#
#..#...#..#
#.#.....#.#
#.........#
...........
#.........#
#.#.......#
#..#......#
#.........#
#####.#####
key : 1

4
2
#####.#####
#.........#
#.#.....#.#
#.........#
#.........#
l..#..#...#
#.........#
#.........#
#.#.....#.#
#.........#
###########
locked : 2

3
2
#####d#####
#.........#
#..#...#..#
#.#.....#.#
#.........#
..........#
#.........#
#.#.......#
#.........#
#.........#
#####.#####

1
3
#####.#####
#.##......#
#..##....##
#.#..######
#.##.####.#
.....e.#..#
#.....#.#.#
#....##...#
#.........#
#.........#
#####d#####
boss
enemies 1

0
3
###########
#X#.......#
#.#...#...#
#....#....#
#....##...#
#..##.#...#
#.........#
#.........#
#.........#
#.........#
#####.#####

1
0
#####.#####
#.........#
#.........#
#.#.......#
#.........#
#..........
#.........#
#.........#
#...#.....#
#.........#
#####l#####
locked : 0

2
4
###########
#.........#
#.........#
#.........#
#.........#
d.........#
#.........#
#.........#
#.........#
#.........#
###########

0
0
###########
#.......#.#
#...#.....#
#.........#
#.........#
#.........#
#.........#
#.........#
#.........#
#........##
#####.#####

4
0
#####.#####
##........#
#k##......#
#..##.....#
#.##......#
#...##.#...
#...#...#.#
#...#.#.#.#
#...#.....#
#.......#.#
#####.#####
key : 2

2
2
#####.#####
#.........#
#..##..#.##
#.#.....#.#
#...#.....#
..........d
#.........#
#.#.......#
#..#......#
#.........#
#####d#####

5
0
#####.#####
#.......#.#
#.........#
#.........#
#..#..#...#
#..........
#.........#
#e#..#..#.#
#?........#
#e........#
###########
enemies 2
sign Something glints behind that door…

