2
4
#####D#####
#.........#
#.#...#.#.#
#.........#
#..#.#.#..#
d.........#
#.#.#...#.#
#.........#
#..#......#
#.........#
#####D#####

4
3
#####d#####
#.........#
#.........#
#.p.......#
#.........#
#....#....D
#..#...##.#
#..#.#..#.#
#..#...#p##
#.........#
###########

3
3
#####l#####
#.........#
#.........#
#.........#
#.........#
D.........D
#.........#
#.........#
#.........#
#.........#
#####d#####
locked : 3

6
4
#####D#####
#.p.......#
#.........#
#.........#
#.........#
#.........#
#.........#
#.p.......#
#.........#
#X........#
###########

1
2
###########
#.........#
#...#.....#
#.........#
#.........#
D.........D
#.........#
#.#.....#.#
#..#...#..#
#.##......#
#####D#####

0
0
###########
#k........#
#..#......#
#.#.......#
#.........#
#.........#
#.........#
#.#.......#
#..#......#
#.........#
#####D#####
key : 1

5
4
#####d#####
#.........#
#.........#
#.........#
#.........#
#....e....#
#.........#
#.........#
#.........#
#.........#
#####D#####
boss
enemies 1

2
3
#####D#####
#.........#
#.#.....#.#
#.........#
#.........#
D....#....d
#.........#
#.........#
#.#.....#.#
#.........#
#####l#####

2
2
#####D#####
##.....#.##
#.........#
#....#.#..#
#.........#
D..#...#..D
#.........#
##.#.#.#.##
#.........#
##.#...#.##
#####D#####

2
0
#####d#####
#.........#
#.........#
#.........#
#...##....#
#?...@#...D
#...#.....#
#.........#
#.........#
#.........#
#####D#####
sign Beware what lurks ahead.

3
0
#####D#####
#..#.....##
#.........#
#.........#
#.....#...#
#.........#
#.........#
#.....#..##
#.........#
#e.......s#
###########
enemies 1
switch 0 : 0

3
4
#####D#####
#.......#e#
#......#..#
#.....##..#
#..#.####e#
D..#......#
#..#......#
#.........#
#.........#
#.........#
#####l#####
enemies 2

1
0
#####D#####
#.........#
#......#.##
#.......#.#
#.........#
#.........D
#.........#
#.#.......#
#..#......#
#.........#
#####d#####

1
4
###########
#........e#
#..##..#..#
#....##e..#
#..#####..#
D...#..#..#
#..###....#
#.........#
#.........#
#.........#
#####D#####
enemies 2
door 0 : 0

3
2
#####D#####
#.........#
#.#...#.#.#
#.........#
#..#...#..#
#.........D
#.#.#.#.#.#
#.........#
#........##
#k........#
###########
key : 2

4
4
#####l#####
#.........#
#.........#
#.........#
#.........#
D.........#
#.........#
#.......#.#
#......#..#
#.........#
#####d#####
locked : 0

2
1
#####D#####
#.........#
##.....#..#
#.........#
#.#.#...#.#
D.........D
#..#.#....#
#.........#
#.#...#.#.#
#.........#
###########

1
1
###########
#....k....#
#.........#
#.........#
#.........#
D.........D
#.........#
#.#.....#.#
#..#...#..#
#.........#
#####D#####
key : 0

1
3
###########
#....k....#
#.........#
#.........#
#.........#
D.........D
#.........#
#.........#
#.........#
#.........#
#####D#####
key : 3

