2
4
###########
#.........#
#......#..#
#.......#.#
#.#....#..#
d.........#
#.........#
#.#.......#
#..#......#
#..#......#
#####.#####

3
2
#####.#####
#.........#
#.........#
#....#....#
#..#.#....#
l...##.....
#.....##..#
#.........#
#.....#...#
#.........#
#####.#####
locked : 1

1
0
###########
#.........#
###.......#
####......#
#.##......#
#.........#
#.........#
#.........#
#.........#
#.........#
#####.#####

2
1
###########
#.........#
#.........#
#.###.....#
#.........#
...........
#.#.#.....#
##k#......#
#.........#
#.........#
#####.#####
key : 2

4
2
#####.#####
#.........#
#...#..#..#
#.........#
#.........#
...........
#.........#
#.........#
##.....#..#
#e........#
#####d#####
enemies 1

5
0
#####d#####
#.........#
#.........#
#.........#
#.........#
#.........#
#.........#
#.........#
#.........#
#......#..#
###########

3
3
#####.#####
#.........#
#.........#
#.........#
#....#....#
.....##....
#.....#...#
#.........#
#.........#
#.........#
#####.#####

4
3
#####.#####
##.#...#.##
#.........#
#.#.....#.#
#.........#
.....#.#..#
#.........#
#.....#.#.#
#.........#
#..#...#..#
###########

1
3
#####.#####
####......#
###.......#
#.####....#
#..#......#
#....e....#
#.........#
#.........#
#.........#
#.........#
#####l#####
locked : 2
boss
enemies 1

4
1
#####.#####
##.#.....##
#.........#
#.#.#.#.#.#
#.........#
...#...#...
#.........#
#.#.#.#.#.#
#.........#
##k#.....##
###########
key : 1

2
3
#####l#####
#.........#
#..#......#
#.#.......#
#.........#
d.........d
#.........#
#.#.......#
#..#......#
#.........#
#####.#####

3
0
#####.#####
#......#..#
#.........#
#....###..#
#.........#
#?...@....l
#.........#
#.........#
#.........#
#......#..#
#####.#####
sign Only the prepared may pass.

4
0
#####.#####
#.........#
#..#...#..#
#k#.....#.#
#.........#
#..........
#...#.....#
#.........#
#.........#
##........#
#####d#####
key : 0

5
2
#####d#####
#.........#
#.........#
##.....#..#
#.........#
#.........#
#...#..#..#
#.........#
#.........#
##.....#..#
###########

2
0
#####.#####
#.......#.#
#......#..#
#.........#
#.........#
#..........
#...#.....#
#...#.....#
#.........#
#.........#
#####.#####

3
1
#####.#####
#.........#
#..#...#..#
#.#.....#.#
#.........#
l.........l
#.........#
#.........#
#.........#
#.........#
#####.#####
locked : 0

2
2
###########
#.........#
#..##..#..#
#.#..##...#
#...#..#..#
...###.#..d
#..##.....#
#.........#
#.........#
#.........#
#####.#####

3
4
#####.#####
##.#...#.##
#.........#
##.#.#.#.##
#.........#
...#.#....#
#.........#
##.#.#.#.##
#.........#
##.....#.k#
###########
key : 3

0
3
###########
#X.....#..#
#..#..##..#
#..#.#....#
#..#.#.#..#
#...####..#
#.........#
#.........#
#.........#
#.........#
#####.#####

