3
4
###########
#.........#
#.........#
#.........#
#.........#
#.........#
#.......#.#
#.......#.#
#.....#...#
#.........#
#####d#####

3
2
#####.#####
#.........#
#..#...#..#
#.#.....#k#
#.........#
..........#
#.........#
#.........#
#.........#
#.........#
#####.#####
key : 2

1
1
#####d#####
#.........#
#..#......#
#.#.......#
#.........#
#.........d
#.........#
#.........#
#.........#
#.........#
#####.#####

5
2
#####.#####
#.........#
#.........#
##..#..#..#
#.........#
#..........
#...#..#..#
#.........#
#.........#
#.........#
#####l#####

6
2
#####l#####
#.........#
#.........#
#.........#
#.........#
#.........#
#.........#
#.........#
#.........#
#.........#
###########
locked : 3

4
5
###########
#.........#
#.........#
#....##...#
#.#.###...#
l..###....#
#.#.#.....#
#...#.....#
#.........#
#.........#
###########
locked : 2

2
3
###########
#........X#
#.........#
#.........#
#....#....#
....##....#
#..##...#.#
#.....#.#.#
#.........#
#.........#
###########

0
1
###########
#..#......#
#.........#
#.........#
#.#.......#
#......#..#
#..#......#
#.........#
#.........#
#.........#
#####d#####

4
2
#####.#####
#.........#
#.........#
#........##
#.........#
...........
#..#......#
#.........#
#.........#
#..#.....##
#####.#####

3
1
#####d#####
#.........#
###.......#
#k#..##...#
#..#.##...#
#..#..#....
#.#.#.....#
#.#.......#
#.........#
#.........#
#####.#####
key : 0

4
3
###########
#....k....#
#.........#
#.........#
#.........#
..........l
#.........#
##........#
#.........#
#.........#
#####.#####
key : 1

2
1
#####.#####
#.........#
#..#...#..#
#.#.....#.#
#.........#
#..........
#.........#
#.........#
#.........#
#.........#
#####d#####

4
4
#####d#####
#.........#
#.........#
#...##....#
#...###...#
l...###...l
#.........#
#.........#
#.........#
#.........#
#####.#####
locked : 0

4
0
###########
#.........#
#.........#
#.........#
#...@.....#
#....###...
#....#....#
#....###..#
#.........#
#.........#
###########

5
3
#####.#####
#.........#
#.#.....#.#
#.........#
#.........#
...#.......
#.........#
#.........#
#.......#.#
#....k....#
###########
key : 3

4
1
#####.#####
#.........#
#...#....##
#.........#
#.........#
...........
#...#.....#
#.........#
#.........#
#.........#
###########

2
2
#####l#####
#......#..#
#.....#...#
#....#....#
#.........#
.....e.....
#.........#
#.........#
#.........#
#.........#
#####.#####
locked : 1
boss
enemies 1

5
4
#####.#####
#.........#
#.........#
#.........#
#.........#
..........#
#.........#
#.........#
#.........#
#.........#
###########

1
2
###########
#.........#
#..#...#..#
#.#.....#.#
#.#.......#
d.........#
#.........#
#.........#
#......#..#
#.........#
#####l#####

