3
1
#####D#####
#e........#
#.........#
#.#..#..#.#
#.#e#...#.#
D.?##.##..D
#.###..#..#
#..###.##.#
#.........#
#e........#
#####D#####
enemies 3
sign Those who search shall find.

2
1
###########
#....k....#
#.........#
#........##
#.........#
D.........D
#......#..#
#.........#
#.........#
#........##
#####D#####
key : 2

3
2
#####D#####
#.........#
#.....#..##
#.........#
#.........#
D.........D
#.........#
#.........#
#.........#
#.........#
#####d#####

1
3
#####D#####
#.........#
##.#.....##
#.........#
#.#.#.#.#.#
D.........D
#..#.#....#
#.........#
#.#.#.#...#
#.........#
#####d#####

3
0
#####D#####
#.........#
#......#..#
#.......#.#
#.........#
#.........D
#.........#
#k#.....#.#
#..#..##..#
#.........#
#####l#####
key : 0

4
3
#####d#####
#.......#.#
#..#......#
#.#.......#
#.........#
D.........#
#.........#
#.........#
#.........#
#.........#
###########

2
4
#####D#####
#.........#
#.#.......#
#.###.....#
#.##e.#...#
l....#....#
#.........#
#.........#
#.........#
#.........#
#####D#####
locked : 3
boss
enemies 1

2
2
#####d#####
#.........#
#.........#
#.........#
#.........#
D....##...D
#......##.#
#.p..#.#..#
#.....##..#
#.......#.#
#####D#####

4
2
#####d#####
#.........#
#.....#..##
#.........#
#.........#
D...#..#..D
#.........#
#.........#
#.....#..##
#.........#
#####D#####

3
4
#####D#####
#.........#
#.........#
#.........#
#.........#
l.........#
#.........#
#.......#.#
#......#..#
#.........#
###########
locked : 2

0
3
###########
#.........#
#.........#
#.........#
#.....#...#
#.........#
#.........#
#.........#
#.#.#.....#
#.........#
#####D#####

1
2
###########
#.........#
#..#......#
#.#.......#
#.........#
#.........D
#.........#
#.#.......#
#..#......#
#.........#
#####d#####

2
0
###########
#?........#
#.........#
#.##.#....#
#.###.#...#
#..#.@#...D
#..#.##...#
#.#...#...#
#.........#
#.........#
#####D#####
sign Those who search shall find.

1
4
###########
#......##X#
#.....#.#.#
#.........#
#....#....#
D....#....#
#.........#
#.........#
#.........#
#.........#
#####D#####

2
3
#####d#####
#k........#
#......#..#
#.......#.#
#.........#
D.........l
#.........#
#.........#
#.........#
#.........#
#####D#####
key : 3

4
1
#####D#####
#.........#
#......#..#
#.......#.#
#.........#
D.........D
#.......#.#
#.#.....#.#
#..#...#..#
#..k......#
###########
key : 1

4
0
#####l#####
#.........#
#.........#
#.........#
#.........#
#..#......D
#.........#
#.........#
#.........#
#.........#
###########
locked : 0

3
3
#####D#####
#.........#
#.#.#...#.#
#.........#
#.#.#.#.#.#
D.........l
#.#.#.#.#.#
#.........#
#.#.#.#.#.#
#.........#
#####d#####

5
2
#####D#####
#.........#
#...#.....#
#.##......#
#.###.....#
#.........#
#.........#
#.........#
#.........#
#.........#
###########

