2
0
#####d#####
#.........#
#.....#...#
#....#....#
#....#....#
#..........
#.........#
#.........#
#.........#
#.........#
#####.#####

4
1
#####.#####
#.......#.#
#.........#
#.#.#.#.#.#
#.........#
l...#.#....
#.........#
#.#...#.#.#
#.........#
#.........#
###########
locked : 0

4
0
#####.#####
#.........#
#........##
#.....#...#
#.....#...#
#.........l
#.........#
#.........#
#.........#
#.........#
###########

5
3
#####l#####
#.........#
#.#...#.#.#
#.........#
#..#.#....#
#.........#
#.#.......#
#.........#
#..#.....##
#.........#
###########
locked : 3

0
1
###########
#.......#.#
#.........#
#.........#
#..#..#...#
#.........#
#.........#
#.#.....#.#
#.........#
#.........#
#####l#####
locked : 2

1
0
###########
#.........#
#.........#
#.........#
#.........#
#.........d
#.........#
#.......#.#
#......#..#
#.........#
#####d#####

3
3
#####d#####
#.........#
#.##......#
#.#e#.....#
#.........#
#..........
#.........#
#.........#
#.........#
#.........#
#####.#####
enemies 1
door 0 : 0

2
3
#####.#####
#..#......#
#..#..#...#
#...####..#
#...#.#...#
#..#.e.#..#
#.........#
#.........#
#.........#
#.........#
#####d#####
boss
enemies 1

3
4
###########
#........k#
#.........#
##..#..#..#
#.........#
..........#
#.#..#..#.#
#.........#
#.........#
##........#
#####.#####
key : 5

1
3
###########
#........X#
#.........#
#.........#
#.........#
..........#
#.........#
#.........#
#.........#
#.........#
#####.#####

2
1
#####.#####
##........#
#.........#
#.........#
#.#..#..#.#
..........#
#.........#
##..#..#..#
#.........#
#.........#
#####.#####

3
1
#####.#####
#.........#
#..#......#
#.#.......#
#.........#
.........k#
#.........#
#.#.......#
#..#......#
#.........#
#####.#####
key : 0

3
0
#####.#####
#.........#
#.........#
#.........#
#.........#
#?...@.....
#.........#
#.........#
#.........#
#.........#
#####.#####
sign The brave are rewarded.

4
5
###########
#.........#
#..#......#
#.#.......#
#.........#
...#......#
#.........#
#.........#
#.........#
#.........#
###########

4
2
###########
#........e#
#..#.....##
#.........#
#.........#
...#..#....
#.........#
#.........#
#..#..#..##
#.....e..s#
###########
enemies 2
switch 0 : 0

1
1
#####l#####
#.........#
#.........#
#.....#..##
#.........#
d..........
#.....#...#
#.........#
#.........#
#..#.....##
#####.#####

4
3
#####.#####
#k........#
#.........#
#.........#
#.........#
..........d
#.........#
#.........#
#.........#
#.........#
#####l#####
key : 2

1
2
###########
#..k......#
#..#...#..#
#.#.....#.#
#.........#
...........
#.........#
#.........#
#.........#
#.........#
###########
key : 3

4
4
#####.#####
#.........#
#.........#
#.........#
#.........#
d..........
#.........#
#.........#
#.........#
#.........#
###########

