1
1
###########
#.........#
#.........#
#.##......#
#..#......#
#..#......l
#.........#
#.........#
#.........#
#.........#
#####D#####

1
2
#####D#####
#.......###
#.#.#.##.##
#.##.##...#
#.....#...#
l...##....d
#.#.#.....#
#.........#
#.........#
#.........#
#####D#####
locked : 0

3
1
#####D#####
#k#.....#.#
#.........#
#.#.#...#.#
#.........#
D...#.#...l
#.........#
#...#.#...#
#.........#
#.#.......#
#####d#####
key : 1

0
4
###########
#.........#
#.........#
#.........#
#.........#
D.........#
#.........#
#.........#
#.........#
#.........#
#####D#####

2
4
#####d#####
#.........#
#.........#
#.........#
#.........#
D....e....#
#.........#
#.........#
#.........#
#.........#
#####D#####
boss
enemies 1

2
1
#####D#####
##........#
####......#
###.......#
#.#.......#
D...#.....D
#.........#
#.........#
#.........#
#.........#
#####D#####

4
2
#####D#####
#.........#
#..#......#
#.#.......#
#.....#...#
D.........#
#...#.....#
#.........#
#.....#...#
#........k#
###########
key : 4

1
3
#####d#####
#.........#
#.........#
#..##.....#
#.###.....#
d..#......l
#.##......#
###.#.....#
#.#.......#
#.........#
#####D#####

3
0
#####D#####
#.........#
#..p..##..#
#....###..#
#.........#
#....@....D
#....p....#
#.........#
#.........#
#.........#
###########

3
2
#####D#####
#.......#.#
#.....#.#.#
#...##....#
#...##..#.#
l.........#
#.........#
#.........#
#.........#
#.........#
#####D#####
locked : 1

1
4
#####D#####
#.##......#
#.#.#.....#
#...##....#
#.#..#....#
l..##.....#
#.........#
#.#.......#
##........#
##........#
#####d#####
locked : 4

0
3
###########
#.........#
#.........#
#.........#
#.....#...#
D.........D
#.........#
#.#..#..#.#
#.........#
#.........#
#####d#####

3
4
#####D#####
#.........#
#.........#
#.........#
#.........#
#.........#
#.........#
#.........#
#.........#
#X........#
###########

2
0
###########
#k........#
#.........#
#.........#
#.........#
#.........D
#.........#
#.#.......#
#..#......#
#.........#
#####D#####
key : 0

0
2
###########
#.........#
#..#......#
#.#.......#
#.........#
#.........D
#.........#
#.........#
#.........#
#.........#
#####D#####

2
2
#####D#####
#k........#
#.........#
#....##..##
#...#####.#
D....#....D
#......##.#
#....##..##
#.........#
#.........#
#####D#####
key : 2

5
1
#####l#####
#.........#
#.........#
#.........#
#.........#
#.........#
#.........#
#.......#.#
#.#....#..#
#.........#
###########
locked : 2

4
1
#####d#####
#.#.....#.#
#.........#
#.........#
#..#..#...#
#.........D
#.........#
#.#..#....#
#.........#
#.........#
#####l#####

2
3
#####D#####
#......p..#
#......#..#
#....##...#
#.........#
D.........D
#.........#
#.........#
#p........#
#e........#
###########
enemies 1

