8
1
#####D#####
#.........#
#.........#
#..#..#..##
#.........#
#.........#
#...#..#..#
#.........#
#.........#
#es#....?##
###########
enemies 1
switch 0 : 0
sign The dungeon remembers all who enter.

1
2
###########
#......e?e#
##..#..#..#
#.........#
#.........#
D......#..#
#.........#
#.........#
##..#..#..#
#.........#
#####D#####
enemies 2
door 0 : 0
sign Only the prepared may pass.

3
0
#####d#####
#.#.....#.#
#.........#
#..#.#.#..#
#.........#
#...#.#...D
#.........#
#..#.#.#.##
#.........#
#.#.....#.#
#####D#####

2
0
#####D#####
#.........#
#.........#
#.........#
#.........#
#.........D
#.........#
#.........#
#.........#
#.........#
#####d#####

3
2
#####D#####
#.#.......#
#.........#
#.........#
#.........#
D.........#
#.........#
#.#.......#
#..#......#
#.........#
###########

6
1
#####D#####
#.........#
#.........#
##..#..#..#
#.........#
l.........D
#...#.....#
#.........#
#.........#
##........#
#####d#####
locked : 2

4
0
#####D#####
#.........#
#.....##..#
#.....##..#
#.....##..#
#..#.@....D
#?##......#
#.#.#.....#
#.........#
##.#......#
#####D#####
sign Something glints behind that door…

1
1
#####D#####
#.........#
#.........#
#.......#.#
#.........#
D....e....D
#.........#
#.........#
#...#.....#
#.........#
#####l#####
locked : 4
boss
enemies 1

0
1
###########
#.........#
##.......##
#.........#
#....#....#
#.........#
#..#...#..#
#.........#
##.....#.##
#.........#
#####D#####

3
1
#####l#####
#k........#
#.........#
#.....#...#
#....#....#
D.........D
#.##......#
#.........#
#.........#
#.........#
#####D#####
key : 2

2
2
#####D#####
#.........#
#.........#
#.........#
#.........#
D........e#
#.........#
#.........#
#.........#
#.........#
#####D#####
enemies 1

4
1
#####D#####
#k........#
##.....#..#
#.........#
#....#.#..#
D.........#
#..#.#.#..#
#.........#
#......#..#
#.........#
#####D#####
key : 1

1
0
###########
#X........#
#.........#
#.........#
#.........#
#...###...D
#...#.##..#
#.......#.#
#...#.....#
#.........#
#####D#####

6
2
###########
#........k#
#.........#
#.........#
#.........#
D.........#
#.........#
#.........#
#.........#
#.........#
###########
key : 4

6
0
#####d#####
#.........#
#.....#.#.#
#.........#
#..#.#....#
#.........l
#.#...#...#
#.........#
#......#.##
#.........#
###########

5
1
#####D#####
#.........#
###.......#
#..#......#
#..#......#
D.........#
#.........#
#.........#
#.........#
#.........#
#####D#####

2
1
#####l#####
#.........#
#...#..#..#
#.........#
#.........#
D...#..#..D
#.........#
#.........#
##..#..#..#
#.........#
#####l#####
locked : 1

5
0
#####D#####
#.........#
##........#
##........#
#k##......#
#.........D
#.........#
#.........#
#.........#
#.........#
#####d#####
key : 0

7
1
#####d#####
#..#.....##
#.........#
#.........#
#..#..#...#
#.........#
#.........#
#..#..#..##
#.........#
#.........#
#####D#####

