0
1
###########
#e#e.....e#
#.........#
#.........#
#.#..#..#.#
#.........#
#.........#
#.#..#....#
#.........#
#.........#
#####.#####
enemies 3
door 0 : 0 1

3
1
#####.#####
#k........#
#......#..#
#.......#.#
#.........#
...........
#.........#
#.........#
#.........#
#.........#
#####.#####
key : 0

7
3
#####.#####
#.........#
#.....#..##
#....#.##.#
#.......#.#
#.....#...#
#.......#.#
#..#......#
#.........#
#X........#
###########

1
2
###########
#..#....ee#
#........s#
#.........#
#...#..#..#
..........#
#.........#
#..#..#..##
#.........#
#.........#
#####.#####
enemies 2
switch 0 : 0 1

5
1
#####.#####
#e........#
#.........#
#.........#
#.........#
...........
#.........#
#.........#
#.........#
#....e....#
###########
enemies 2

2
1
#####l#####
#.......#.#
#.........#
#..#.#....#
#.........#
#...#.#....
#.........#
#....#...##
#.........#
#k#.....#.#
#####.#####
key : 2

5
3
#####.#####
#..#.....##
#.........#
#.........#
#..#..#...#
d.........#
#.........#
#..#..#..##
#.........#
#.........#
#####d#####

6
3
#####d#####
#.........#
#...#..##.#
#....###..#
#...#e....#
....####..#
#...#.....#
#.........#
#.........#
#.........#
#####.#####
boss
enemies 1

3
0
###########
#.........#
#.........#
#.........#
#..#....#.#
#..........
#.....#...#
#.........#
#.........#
#.........#
#####.#####

3
2
#####.#####
#.........#
#.........#
#.........#
#.........#
.........k#
#.........#
#.........#
#.........#
#.........#
#####.#####
key : 1

5
2
#####d#####
#.........#
#.........#
#.........#
#.........#
......#...d
#.........#
#.........#
#.........#
#......#..#
#####.#####

1
1
#####.#####
#.........#
#..#...#..#
#.#.....#.#
#.........#
#..........
#.........#
#.........#
#.........#
#.........#
#####l#####
locked : 2

4
2
#####.#####
#.........#
#.........#
#.........#
#.........#
d..........
#.........#
#.........#
#.........#
#.........#
#####d#####

6
2
#####.#####
#.........#
#.........#
#####.....#
#.##......#
#..........
#...##....#
#.........#
#.........#
#k........#
###########
key : 3

4
1
#####.#####
#e.....#.e#
#.........#
#.......###
#.......#?#
..........d
#.........#
#.........#
#.........#
#e........#
#####.#####
enemies 3
sign Those who search shall find.

2
2
#####.#####
#.........#
#.........#
##..#.....#
#.........#
..........#
#...#..#..#
#.........#
#.........#
##.....#..#
#####.#####

5
0
#####.#####
#.........#
#......#..#
#.........#
#....#....#
#..........
#.........#
#.........#
##.....#..#
#.........#
###########

4
0
#####.#####
#.........#
#.........#
#.........#
#...@.....#
#....#.....
#....##...#
#...##....#
#.........#
#.........#
#####.#####

4
3
###########
#.........#
#......#..#
#.......#.#
#.........#
..........#
#.........#
#.#.....#.#
#..#...#..#
#.........#
#####.#####

