3
3
#####D#####
#.........#
#.........#
#.........#
#...#..#..#
D.........#
#.........#
#..#..#..##
#.........#
#........k#
###########
key : 5

2
2
#####D#####
#.........#
#..#......#
#.#.......#
#.........#
D.........D
#.........#
#.......#.#
#......#..#
#.........#
#####D#####

2
0
#####D#####
#.........#
####......#
####......#
#.........#
#....@....D
#.........#
#.........#
#.........#
#.........#
#####d#####

1
0
#####D#####
#.........#
#..##.....#
#..#....p.#
#.p###....#
#..###....D
#.#.......#
#.###.....#
#..#......#
#.........#
#####D#####

0
3
###########
#.........#
#.........#
#.....##..#
#.....##..#
D.........d
#.........#
#.........#
#.........#
#.........#
#####D#####

0
4
###########
#.........#
##..#.....#
#.##......#
#.#.e.#...#
d...##....#
#.....#.#.#
#...#..##.#
#.......#.#
#.........#
#####D#####
boss
enemies 1

3
2
#####D#####
#.........#
#.........#
#.........#
#.........#
D...#.....D
#....##...#
#...#.#...#
#...#.....#
#kp.......#
#####D#####
key : 1

2
1
#####D#####
#.........#
#.........#
#.........#
#.........#
D.........D
#.........#
#.........#
#.........#
#.........#
#####d#####

1
1
#####d#####
#.........#
#.....#...#
#.###.....#
#.###.#...#
D.........D
#.##.##...#
#..?##....#
#####.....#
#e........#
#####D#####
enemies 1
sign What you seek is close.

3
1
#####d#####
#........##
#.....#...#
#....#.####
#....#.#..#
D.........D
#.........#
#.........#
#.........#
#.........#
###########

4
2
#####D#####
#..#......#
#..#......#
#..#......#
#..##.....#
#...##....#
#..##.....#
#.........#
####......#
#ee......e#
###########
enemies 3

1
3
#####D#####
#e........#
#.........#
#.....#..##
#.........#
D.........D
#..#..#...#
#.........#
#.........#
#........##
#####D#####
enemies 1

0
2
###########
#.........#
##..#..#..#
#.........#
#.........#
D...#..#..D
#.........#
#.........#
##..#..#..#
#.........#
#####l#####
locked : 1

1
4
#####D#####
#.........#
##.#......#
#...#...p.#
#.#.#.....#
D..##..p..#
#.###.....#
#.........#
#.........#
#........X#
###########

3
0
#####d#####
#........p#
#.........#
#.........#
#.........#
#.........D
#.........#
#.........#
#........p#
#.........#
###########

0
0
###########
#.........#
#..#......#
#.#.......#
#.........#
#.........D
#.#.......#
#..#......#
##........#
#.........#
#####D#####

2
3
#####D#####
#.........#
#...#.#...#
#...###...#
#.###.....#
D..#......#
#.......#k#
#..#......#
#.........#
#.........#
#####D#####
key : 2

0
1
###########
#.........#
#.....#..##
#.........#
#.........#
D...#.....D
#.........#
#.........#
#.....#...#
#.........#
#####d#####

1
2
#####l#####
#k........#
#.........#
#.........#
#.........#
D.........D
#.........#
#.#.......#
#..#......#
#.........#
#####D#####
key : 0

