2
0
#####.#####
#.........#
#.........#
#.........#
#.....#...#
#....@.....
#.........#
#.........#
#.....#...#
#?........#
###########
sign Those who search shall find.

0
2
###########
#.........#
#........##
#.........#
#.........#
..........#
#.........#
#.#....##.#
#..#...#..#
#.........#
#####l#####
locked : 1

3
4
#####.#####
#.........#
#.........#
#.........#
#.........#
#k........#
#.........#
#.........#
#.........#
#.........#
#####l#####
key : 3

1
5
###########
##.....#.##
#.........#
#.#...#...#
#.........#
.....#....#
#.........#
#.#.#.#...#
#.........#
##.#.....##
#####.#####

0
0
###########
#.........#
#.........#
#...#..#..#
#.........#
#..........
#...#..#..#
#.........#
#.........#
##.....#..#
#####.#####

2
2
#####d#####
##.....#..#
#.........#
#.........#
#...#..#..#
...........
#.........#
##.....#..#
#.........#
#.........#
#####l#####

1
4
###########
#.......#.#
#.....##..#
#...#e#...#
#...#####.#
....#..#...
#.........#
#.........#
#.........#
#.........#
#####.#####
enemies 1

3
2
#####l#####
#.........#
#..#.....##
#.........#
#.........#
#.....#...#
#.........#
#.........#
#..#..#..##
#.........#
###########
locked : 0

2
1
#####.#####
#.........#
#.........#
#.........#
#...#.....#
...........
#.........#
###.......#
#..#......#
#..k......#
###########
key : 1

2
5
#####.#####
#.........#
##.....#.##
#.........#
#.#.#.#...#
..........#
#..#.#.#..#
#.........#
#.#.......#
#........e#
###########
enemies 1
door 0 : 0

0
1
###########
#......k..#
#......#..#
#.......#.#
#.........#
...........
#.........#
#.........#
#.........#
#.........#
#####.#####
key : 0

1
2
#####l#####
#.........#
#.........#
#.........#
#.........#
..........d
#.........#
#.........#
#.........#
#.........#
#####d#####

5
4
#####.#####
#.........#
#...#.#.#.#
#...####..#
#....##.#.#
#...#.#...#
#...#.##..#
#.##......#
#..#..#...#
#X##......#
###########

1
3
###########
#........##
#.........#
#.........#
#...#..#..#
d..........
#.........#
#..#..#..##
#.........#
#.........#
#####d#####

1
0
#####.#####
##s#...#.##
#e........#
##.#...#.##
#e........#
#..#.#.....
#.........#
#....#.#.##
#.........#
##?#.....##
#####.#####
enemies 2
switch 0 : 0
sign The dungeon remembers all who enter.

2
4
#####.#####
#k.....#..#
#..#...#..#
#.#.....#.#
#.........#
...........
#.........#
#.........#
#..#......#
#.........#
#####.#####
key : 2

4
4
#####l#####
#.........#
#.........#
#.........#
#.........#
#....e....#
#.#.......#
#.........#
#.......#.#
#.........#
#####.#####
locked : 3
boss
enemies 1

1
1
#####.#####
#.........#
#...#.....#
#.........#
#.........#
...........
#.#.......#
#.......#.#
#......#..#
#.........#
#####.#####

2
3
#####d#####
#.........#
#.........#
#.......#.#
#.........#
...........
#.#..#..#.#
#.........#
#.........#
#.#.....#.#
###########

