3
0
#####D#####
#.........#
#......#..#
#.......#.#
#.........#
#.........D
#.........#
#.#.......#
#..#......#
#k........#
###########
key : 0

3
3
#####D#####
#.........#
#.........#
#.........#
#.........#
D.........D
#.........#
#.........#
#.........#
#....k....#
###########
key : 2

4
4
#####D#####
#..#.....##
#.........#
#.........#
#..#..#...#
#.........#
#.........#
#..#..#...#
#e........#
#e.......e#
###########
enemies 3
door 0 : 0

4
2
#####D#####
#.........#
#.........#
#.........#
#.........#
D.........#
#.........#
#.........#
#........e#
#.....?see#
###########
enemies 3
switch 0 : 0
sign What you seek is close.

0
3
###########
#.........#
#..#......#
#.#.......#
#.........#
#.........d
#.........#
#.........#
#.........#
#.........#
#####l#####
locked : 2

0
4
###########
#.........#
#.........#
#p........#
#.........#
d..#.e....#
#.........#
####......#
#.........#
#.........#
#####D#####
boss
enemies 1

1
4
#####D#####
#.........#
#.........#
#..#......#
#.........#
D.........#
#..###.#..#
#..#X.....#
#...#.#...#
#......#..#
#####D#####

2
1
###########
#.........#
#.........#
#.........#
#.........#
D.........#
#.........#
#.#.....#.#
#..#...#..#
#.........#
#####l#####
locked : 1

2
3
#####l#####
#.........#
#.........#
#.#..#....#
#.........#
#.........d
#.#..#..#.#
#.........#
#.........#
#.#.......#
#####D#####

3
2
###########
#..#...#.##
#.........#
#........##
#.........#
D.........D
#.........#
##...#.#..#
#.........#
#..#......#
#####D#####

4
1
#####D#####
#........k#
#.....#..##
#.........#
#.........#
#.....#...D
#.........#
#.........#
#..#..#..##
#.........#
#####D#####
key : 1

6
1
#####D#####
#.........#
#.........#
#.........#
#.........#
#.........#
#.......p.#
#.........#
#p........#
#.........#
###########

2
0
###########
#?........#
#.........#
#.........#
#.......#.#
#...#@##..D
#...##....#
#....#....#
#.....###.#
#.........#
#####D#####
sign Seek the matching key before you proceed.

1
3
#####l#####
#.........#
#.#.....#.#
#.........#
#.........#
#..#..#...D
#.........#
#.........#
#.#.....#.#
#.........#
#####l#####
locked : 3

3
4
#####d#####
#.........#
#......#..#
#.......#.#
#.........#
D.........d
#.........#
#.........#
#.........#
#.........#
#####D#####

2
4
#####D#####
#.........#
#.........#
#.........#
#.........#
d.........#
#.........#
#.........#
#.........#
#.........#
#####d#####

3
5
###########
#.........#
#..#...#..#
#.#.....#.#
#.........#
d.........#
#.........#
#.#.......#
#..#......#
#.........#
###########

3
1
#####l#####
#.........#
#.........#
#.........#
#.........#
D.........D
#.........#
#.#.......#
#..#......#
#.........#
#####D#####

5
1
#####D#####
#..#.....##
#.........#
#.........#
#...#..#..#
#.........#
#........k#
#..#.....##
#.........#
#.........#
#####D#####
key : 3

