3
2
#####l#####
#k........#
#.........#
#.........#
#.........#
D..#......D
#.........#
#.#.......#
#.........#
#.........#
#####D#####
key : 1

2
4
#####d#####
#.........#
#..#...#..#
#.#.....#.#
#.........#
l.........D
#.........#
#.........#
#.........#
#.........#
#####d#####
locked : 3

3
0
###########
##.#......#
#?....##..#
###.#..##.#
#..#..##..#
#....@....D
#.....##..#
#.........#
#.........#
#.........#
#####D#####
sign Something glints behind that door…

1
4
#####D#####
#.........#
#.........#
#.........#
#.........#
#....e....#
#.........#
#.........#
#.........#
#.........#
#####d#####
boss
enemies 1

5
0
#####D#####
##.#...#.##
#.........#
#.#.#.#.#.#
#.........#
#..#.#.#..#
#.........#
#.....#...#
#.........#
##.#...#..#
###########

0
4
###########
#X........#
#.........#
#...#.....#
#.###.....#
#..#......#
#.........#
#.........#
#.........#
#.........#
#####D#####

2
2
#####d#####
#.........#
#p#.......#
####..p...#
#.##......#
D....#....D
#.....#.#.#
#....#.#..#
#.........#
#......#..#
#####l#####
locked : 1

4
1
#####D#####
##.....#..#
#.........#
#.........#
#...#.....#
D.........D
#.........#
#.........#
#.........#
#e.?se....#
###########
enemies 2
switch 0 : 0 1
sign A useful tool lies just ahead.

1
1
###########
#e........#
##........#
#?........#
#.........#
#....#....D
#.........#
#.........#
#...#..#..#
#.........#
#####D#####
enemies 1
door 0 : 0 1
sign Beware what lurks ahead.

3
3
#####d#####
#.........#
#...#.#.#.#
#.........#
#....#.#..#
D.........D
#.#.#.#.#.#
#.........#
#..#...#.##
#.........#
###########

1
2
#####D#####
##.....#..#
#.........#
#.........#
#.#..#....#
D.........#
#.........#
##..#..#..#
#.........#
#.........#
#####d#####

3
1
#####D#####
#e........#
##.#...#.##
#.........#
#..#......#
D.........D
#..#.#.#..#
#.........#
#......#..#
#.........#
#####D#####
enemies 1

2
5
###########
##.#...#..#
#.........#
##.#.#.#.##
#.........#
D..#...#..#
#.........#
##.#.#...##
#.........#
##.#...#k##
###########
key : 4

0
2
###########
#.........#
#..#...#..#
#.#.....#.#
#.........#
#.........#
#.........#
#.......#.#
#......#..#
#.........#
#####D#####

2
3
###########
#k#.......#
#......#..#
#.......#.#
#.........#
D.....#...l
#.........#
#.#.......#
#..#......#
#.......#.#
#####d#####
key : 3

2
1
#####D#####
#.........#
#......#..#
#.......#.#
#.........#
#.........D
#.........#
#.#.......#
#..#......#
#.........#
#####D#####

4
2
#####D#####
#.........#
#......#.##
#.........#
#..#.#....#
D.........#
#..#.#....#
#.........#
##.#...#..#
#.........#
###########

4
0
#####D#####
#......#..#
#......#..#
#....###..#
#......#..#
#k........D
#.........#
#.........#
#.........#
#.........#
#####D#####
key : 0

3
4
#####d#####
#.........#
#.........#
#..#.....##
#.........#
D.........#
#.........#
#.........#
#.........#
#..#.....##
###########

