3
3
#####D#####
#.........#
#.........#
#.........#
#.........#
D........k#
#.........#
#.........#
#.........#
#.........#
#####D#####
key : 2

2
0
#####d#####
#e........#
##.....#..#
#s........#
#..#.#.#..#
#.........D
#..#.#....#
#.........#
##.#...#.##
#e.......e#
#####D#####
enemies 3
switch 0 : 0

4
3
#####D#####
#.........#
#..#...#..#
#.#.....#.#
#.........#
d.........#
#.........#
#.......#.#
#......#..#
#.........#
#####l#####

1
1
###########
#.........#
#...#.....#
#.....#...#
#..##.#...#
D...##....#
#..#......#
#.........#
#.........#
#.........#
#####D#####

0
0
###########
#.........#
#......#..#
#.......#.#
#......#..#
#.........#
#.........#
#.......#.#
#......#..#
#........##
#####d#####

3
1
#####D#####
##.....#.##
#.........#
#.#.#.#.#.#
#.........#
D..#.#.#..l
#.........#
#...#...#.#
#.........#
#..#...#..#
#####D#####

4
1
#####D#####
#.........#
#.........#
#.........#
#.#.#.....#
D...#.....D
#.........#
#.........#
#.........#
#.........#
###########

5
3
#####l#####
#.........#
#.........#
#.........#
#.........#
#....e....#
#.........#
#.........#
#.........#
#.........#
#####D#####
locked : 4
boss
enemies 1

2
2
###########
#.........#
#..#......#
#.#.......#
#.........#
D.........D
#.........#
#.#.......#
#..#......#
#.........#
#####D#####

4
0
#####D#####
#e.....##e#
#.........#
#.........#
#.........#
#e........D
#.........#
#.........#
#.........#
#.........#
#####D#####
enemies 3

2
3
#####D#####
##.#...#..#
#.........#
##.#.#.#.##
#........k#
D..#.#.#..#
#.........#
#....#.#.##
#.........#
#..#...#..#
#####D#####
key : 4

6
3
#####D#####
#.........#
#.........#
#.........#
#.........#
#.........#
#.........#
#.........#
#.........#
#X........#
###########

3
0
#####D#####
#......#..#
#...#.##..#
#...#.#?#.#
#..#..#...#
#....@....D
#.........#
#.........#
#.........#
#.........#
#####D#####
sign Many have walked this path.

5
0
#####D#####
#.........#
#.#.#...#.#
#.........#
#..#...#..#
#.........#
#.#...#.#.#
#.........#
#..#.....##
#........k#
###########
key : 1

1
0
#####d#####
#.........#
#.........#
#.........#
#.........#
#..#####..D
#..#.##...#
#......#..#
#...#.##..#
#......#..#
#####d#####

4
2
#####d#####
#.........#
#.......#.#
#.........#
#....###..#
D.....##..d
#.........#
#.........#
#.........#
#.........#
###########

2
1
#####D#####
#.........#
#.........#
#....#..#.#
#.........#
D.........D
#..#......#
#.........#
#.........#
#k#.......#
#####D#####
key : 0

3
2
#####D#####
#.#.......#
#.........#
#..#.#.#.##
#.........#
l...#.#...D
#.........#
#......#.##
#.........#
#.........#
#####d#####
locked : 0

1
3
###########
##?....#.e#
#e........#
#.........#
#.#..#..#.#
#.........#
#.........#
##..#.....#
#.........#
#.........#
#####D#####
enemies 2
door 0 : 0
sign A useful tool lies just ahead.

