3
0
#####D#####
#.........#
#.........#
#.........#
#.........#
#?...@....#
#.........#
#.........#
#.....p...#
#.........#
#####D#####
sign Something glints behind that door…

5
0
#####D#####
#e.......##
#.........#
#.........#
#e.....#..#
#e........d
#s........#
#........##
#.........#
#.........#
#####D#####
enemies 3
switch 0 : 0 1

4
1
###########
#........k#
#.........#
#.........#
#.........#
D.........#
#.........#
#.......#.#
#......#..#
#.........#
#####D#####
key : 1

7
0
#####D#####
#.........#
#.........#
#.........#
#.........#
#.........D
#.........#
#.........#
#.......p.#
#.p.......#
###########

2
4
#####D#####
#........##
#.........#
#.........#
#...#..#..#
D.........#
#.........#
#..#..#..##
#.........#
#........e#
###########
enemies 1

4
0
#####D#####
#.........#
#.........#
#.........#
#.........#
#.........D
#.........#
#.......#.#
#......#..#
#.........#
#####D#####

2
0
###########
#k........#
#.........#
#.........#
#.........#
#.........l
#.........#
#.#.......#
#..#......#
#.........#
#####D#####
key : 0

2
2
###########
#..k......#
#..#......#
#.#.......#
#.....#...#
D.........D
#.........#
#.........#
#.........#
#.........#
###########
key : 3

0
4
###########
#........X#
#.........#
#....p....#
#.........#
D.........#
#......#..#
#.....###.#
#......#..#
#.p.......#
#####D#####

2
1
###########
#.........#
#####.p...#
#.##.#....#
#..#.#....#
l.........D
#.........#
#.........#
#.........#
#.........#
###########
locked : 0

0
3
###########
#.........#
#.........#
#.........#
#.........#
#.........D
#.........#
#.....p..p#
#.........#
#.........#
#####d#####

6
1
#####d#####
#.........#
#..#...#..#
#.#.....#.#
#.........#
D.........#
#.........#
#.........#
#.........#
#.........#
#####D#####

6
0
#####D#####
#.#.......#
#..#......#
#.#.......#
#.........#
#.........D
#.........#
#.#.......#
##.#......#
#.........#
#####D#####

1
4
#####D#####
#.........#
#.........#
#.........#
#.........#
d..##e....#
#..##.....#
#.........#
##.##.....#
##.#......#
#####D#####
boss
enemies 1

1
3
#####d#####
#.........#
#.........#
#.........#
#......#..#
#.........d
#.........#
#..#..#..##
#.........#
#.........#
#####l#####
locked : 4

7
1
#####D#####
#.........#
#..#...#.##
#.........#
#..#.#....#
D.........#
#..#.#.#..#
#.........#
##.#...#.##
#.........#
###########

2
3
#####l#####
##........#
#.........#
#.........#
#......#..#
D.........D
#.........#
##..#..#..#
#.........#
#....k....#
###########
key : 4

5
1
#####D#####
#.........#
#.#.#.#...#
#.........#
#....#.#..#
d.........D
#.#...#.#.#
#.........#
#......#..#
#.........#
#####d#####

5
2
###########
#........e#
#..#......#
#...###...#
#...##....#
D..#..#...#
#.....##..#
#.....#...#
#.........#
#.........#
###########
enemies 1
door 0 : 0 1

