3
6
#####D#####
#.........#
#.....##..#
#..#..#...#
#..#.###..#
#...###...#
#.....##..#
#.........#
#.........#
#X........#
###########

1
5
###########
#......?ee#
#........e#
#.........#
#.........#
D.........#
#.........#
#.........#
#.........#
#.........#
#####D#####
enemies 3
sign Those who search shall find.

2
4
#####D#####
#.........#
#.........#
#.........#
#.........#
d...#.....D
#.........#
#.#.....#.#
#..#...#..#
#.........#
###########

1
2
###########
#........p#
#.........#
#.........#
#....p.#..#
D.....#...#
#....##.#.#
#....####.#
#...#.##..#
#.........#
#####l#####
locked : 2

0
4
###########
#e.......?#
#.#.#...#.#
#.........#
#..#...#..#
#.........#
#.#.#.#.#.#
#.........#
#......#.##
#.........#
#####D#####
enemies 1
door 0 : 0
sign What you seek is close.

3
2
#####D#####
#.........#
#.........#
#.........#
#.........#
D.........#
#.........#
#.........#
#.........#
#........k#
###########
key : 1

2
1
#####d#####
#.........#
#.#.#.#.#.#
#.........#
#.#...#...#
D.........d
#.....#...#
#.........#
#.#...#.#.#
#.........#
#####D#####

3
0
#####D#####
#......#..#
#...#.#...#
#...####..#
#...###...#
#...##k#..D
#.........#
#.........#
#.........#
#......#..#
#####D#####
key : 0

2
0
#####D#####
#.........#
#.........#
#.........#
#.........#
#?...@....D
#.........#
#.........#
#.........#
#.........#
#####D#####
sign Something glints behind that door…

4
0
#####D#####
#.........#
##.#...#..#
#.........#
#..#.#.#..#
#.........D
#..#...#..#
#.........#
##.#...#.##
#.........#
###########

2
2
#####l#####
#.........#
#.........#
#.........#
#.........#
d.........D
#.........#
#.........#
#.........#
#.........#
#####D#####

2
3
###########
#..k......#
#..#...#..#
#.#.....#.#
#.........#
D.........d
#.........#
#.........#
#.........#
#.........#
###########
key : 2

3
1
#####D#####
##........#
####....#.#
###.#..#..#
#.#....##.#
D.........D
#.........#
#.........#
#.........#
#.........#
#####D#####

1
1
###########
#.........#
#.........#
#.........#
#......#..#
D.........D
#.........#
#..#..#...#
#.........#
#.........#
#####d#####

1
0
###########
####e.....#
#e##s.....#
#..e##....#
#...###...#
#...##....D
#.........#
#.........#
#.........#
#.........#
#####D#####
enemies 3
switch 0 : 0

2
5
#####D#####
#.........#
#.....#..##
#.........#
#.........#
D...#..#..d
#.........#
#.........#
#..#.....##
#.........#
###########

2
6
###########
#.........#
#.........#
#.........#
#....#....#
d....e#...#
#....####.#
#.........#
#.........#
#.........#
#####D#####
boss
enemies 1

1
4
#####D#####
#.........#
#.........#
#k#.......#
#.........#
#.........D
#.........#
#.#.....#.#
#..#...##.#
#.........#
#####D#####
key : 3

4
1
#####D#####
#.........#
#..#......#
#.#.......#
#.........#
D.........#
#.........#
#.#.....#.#
#..#...#..#
#.........#
###########

