5
3
#####D#####
#.........#
#.........#
#.........#
#.........#
D...##....#
#...####..#
#...#####.#
#...#.#...#
#.....X#..#
###########

0
2
###########
#.........#
#..#......#
#.#.......#
#.........#
d.........#
#.........#
#.........#
#.........#
#.........#
#####D#####

1
2
#####D#####
#.........#
#.........#
#.........#
#.........#
D.........#
#.........#
#.........#
#.........#
#.........#
###########

3
2
###########
#........k#
#.........#
#.........#
#.........#
D.........#
#.........#
#.........#
#.........#
#.........#
#####D#####
key : 3

5
0
#####l#####
#.........#
#..##.....#
#.###.....#
#.#...#...#
#..####...d
#.#..##...#
#...##....#
#..#..#...#
#.........#
###########
locked : 0

0
0
###########
#.........#
#.........#
#..#..#..##
#.........#
#.........D
#...#.....#
#.........#
#.........#
#..#.....##
#####D#####

4
0
#####D#####
#e........#
#.........#
#.........#
#e........#
#e........D
#?........#
#......#..#
#.........#
#.........#
#####l#####
enemies 3
sign A locked path — look elsewhere first.

1
0
#####D#####
#.........#
#.........#
#.......#.#
#.........#
#.........D
#......#..#
#.........#
#.........#
#.........#
#####D#####

1
1
#####D#####
#e.......?#
#.........#
#.........#
#.........#
D.........D
#.........#
#.........#
#.........#
#e........#
#####d#####
enemies 2
sign Beware what lurks ahead.

2
1
#####d#####
#.........#
#......#..#
#.......#.#
#.........#
D.........#
#.........#
#.#.......#
#..#......#
#.........#
#####D#####

3
1
#####D#####
#......#..#
#......#..#
#..#.#k##.#
#..#..##..#
D.........D
#.........#
#.........#
#.........#
#.........#
#####D#####
key : 1

5
2
#####D#####
#?........#
#...#..#..#
#.........#
#.........#
D....#....D
#.........#
#.........#
#...#..#..#
#...ee.e..#
###########
enemies 3
sign Something glints behind that door…

3
0
#####D#####
#.........#
#......#..#
#.......#.#
#.........#
#k........D
#.........#
#.......#.#
#......#..#
#.........#
#####D#####
key : 0

4
1
#####D#####
#e.......e#
#.........#
#.........#
#.........#
D.........D
#.........#
#.........#
#.........#
#e.......?#
#####D#####
enemies 3
sign Those who search shall find.

2
0
#####D#####
#.#.......#
#...#.....#
#...#.....#
#.........#
#....@....D
#.........#
#.........#
#.........#
#.........#
#####D#####

4
2
#####D#####
#k........#
#.........#
#.........#
#.......#.#
D.........d
#...#.....#
#.#.....#.#
#..#...#..#
#.........#
#####D#####
key : 2

4
3
###########
#.........#
#.........#
#.#.#.....#
#.#####...#
d..#.e.#..#
#..#..##..#
#..##.#.###
#.....#.###
#.........#
#####D#####
boss
enemies 1

5
1
#####D#####
#.........#
#.........#
#.........#
#....##...#
d...#.....D
#...#.....#
#.........#
#.........#
#.........#
###########

0
1
###########
#.........#
#.........#
##.....#..#
#.........#
D.........d
#.#..#..#.#
#.........#
#.........#
##........#
#####D#####

