0
6
###########
#.........#
#..#......#
#.#.......#
#.........#
#.........#
#.........#
#.#.....#.#
#..#...#..#
#.........#
#####d#####

2
5
#####d#####
#........k#
#........##
#.........#
#.........#
...#..#...l
#.........#
#.........#
#..#......#
#.........#
###########
key : 2

4
4
#####.#####
#.........#
#.........#
#.........#
#.........#
..........#
#.........#
#.#.......#
#..#......#
#.........#
###########

3
4
#####l#####
#......#..#
#..##...#.#
#..###.#..#
#..######.#
d..##.....#
#.....#...#
#.........#
#.........#
#.........#
#####.#####

1
6
#####d#####
#.........#
#.......#.#
#.........#
#.........#
..........l
#.........#
#.........#
#.......#.#
#.........#
#####d#####

4
0
#####.#####
##......#.#
#.##......#
#.##..#...#
#..###....#
#..##.....#
#...##....#
#.........#
#.........#
#.........#
###########

3
2
###########
#e........#
##.#...#..#
#.........#
#....#.#..#
...........
#..#.#.#..#
#.........#
##.#...#.##
#e.......?#
#####.#####
enemies 2
sign What you seek is close.

1
5
###########
#.........#
#..#......#
#.#..#..#.#
#.......#.#
...........
#.........#
#.#.....#.#
#..#...#..#
#.........#
#####d#####

2
4
#####.#####
#.........#
#.........#
#.........#
#...#.....#
#..........
#.........#
#.#.......#
#..#......#
#.........#
#####l#####
locked : 0

3
0
#####.#####
#.........#
#.........#
#.........#
#.........#
#....@.....
#.........#
#..#......#
#.........#
#.........#
#####.#####

4
3
#####.#####
#e........#
##........#
#.........#
#.........#
.....#.....
#.........#
#.........#
##.....#..#
#e...?.e..#
###########
enemies 3
sign Those who search shall find.

2
7
#####.#####
#.........#
#.........#
#.........#
#.........#
......#...#
#...#.#...#
#...#.#...#
#.........#
#........X#
###########

2
0
###########
#k........#
#.........#
#.........#
#.........#
#.........#
#.........#
#.........#
#.........#
#.........#
#####.#####
key : 3

3
1
###########
#......#..#
#...#..#..#
#...#####.#
#.........#
.....#.....
#.........#
#.....#...#
#......#..#
#......#k##
###########
key : 0

2
6
#####d#####
#.........#
#.........#
##..#..#..#
#.........#
l..........
#.#..#..#.#
#.........#
#.........#
##.....#..#
###########
locked : 2

1
4
###########
#.........#
#..#..#..##
#.........#
#.........#
#.....#....
#.........#
#.........#
#..#..#..##
#.........#
#####.#####

4
2
#####.#####
#.........#
#.........#
#.........#
#.........#
#..........
#.........#
#.........#
#.........#
#.........#
###########

1
7
###########
#.........#
#..#......#
#.#.......#
#.###.....#
l..#.e....#
#.........#
#.........#
#.........#
#.........#
#####.#####
locked : 3
boss
enemies 1

3
3
###########
#....k....#
#.........#
#.........#
#.........#
..........d
#.........#
#.........#
#.........#
#.........#
#####.#####
key : 1

