1
6
#####d#####
#.........#
#..#......#
#.#.......#
#.........#
D.........l
#.........#
#.#.....#.#
#..#...#..#
#.........#
#####d#####

1
7
###########
#.........#
#.........#
#...#.....#
#...e.#...#
l....##...#
#.#.......#
#.#.##....#
#.........#
#.........#
#####D#####
locked : 3
boss
enemies 1

3
3
###########
#.k.......#
#.#.......#
#.........#
#.....#...#
D.........d
#.#.#.#...#
#.........#
#.#...#...#
#.........#
#####D#####
key : 1

1
4
###########
#.........#
#..##.##..#
#..#...#..#
#...#.....#
#..#####..D
#.........#
#.........#
#.........#
#.........#
#####D#####

2
5
#####d#####
#..#......#
#...#.##..#
#....###..#
#..###.#..#
D...##.#..l
#....#.#..#
#....#...##
#....k#.###
#.........#
###########
key : 2

2
7
#####D#####
#.........#
#.........#
#.........#
#......#..#
D.........#
#.........#
#.........#
#.........#
#........X#
###########

0
6
###########
#.........#
#..#...#..#
#.#.....#.#
#..#..#...#
#.........#
#.........#
#.#.......#
#..#......#
#.........#
#####d#####

2
0
###########
#k........#
#.........#
#.......#.#
#.........#
#.........#
#.......#.#
#.........#
#.........#
#.........#
#####D#####
key : 3

4
4
#####D#####
#.........#
#.........#
#.........#
#.........#
D....#....#
#......#..#
#....###..#
#.........#
#.........#
###########

1
5
###########
#.#.......#
#.........#
#.........#
#..#..#...#
D.........D
#.........#
#.#.....#.#
#.........#
#.........#
#####d#####

4
0
#####D#####
#.........#
#.........#
#.........#
#.........#
#.........#
#......#..#
#.....#...#
#.......#.#
#.........#
###########

2
4
#####D#####
#.........#
#.........#
#.........#
#.........#
#.........D
#.........#
#.........#
#.........#
#.........#
#####l#####
locked : 0

2
6
#####d#####
#.........#
#......#.##
#.......#.#
#.........#
l.........D
#.........#
#..#......#
#.........#
#......#..#
###########
locked : 2

3
0
#####D#####
#.........#
#.........#
#.........#
#.........#
#....@....D
#.........#
#.........#
#.........#
#.........#
#####D#####

3
1
###########
#.........#
#.........#
#..#...#..#
#..#k###..#
D..####...D
#.........#
#.....#...#
#.........#
#.........#
###########
key : 0

4
2
#####D#####
#.........#
#..#...#..#
#.#.....#.#
#.........#
#.........D
#.........#
#.........#
#.........#
#.........#
###########

4
3
#####D#####
#e........#
#.........#
#.........#
#.........#
D.........D
#.........#
#.........#
#.........#
#e..?e....#
###########
enemies 3
sign Those who search shall find.

3
2
###########
#e...e....#
#.........#
#.........#
#.........#
D.........D
#.........#
#.........#
#.........#
#?........#
#####D#####
enemies 2
sign What you seek is close.

3
4
#####l#####
##.#...#.##
#.........#
#...#.#.#.#
#.........#
d..#.#.#..#
#.........#
#.#.#.#.#.#
#.........#
##.#...#.##
#####D#####

