1
0
#####D#####
#..#......#
#.........#
#k#.#.#.#.#
#.........#
#.........D
#.........#
#...#.#.#.#
#.........#
##........#
#####D#####
key : 2

4
0
#####D#####
#.........#
#.........#
#.........#
#.........#
#.........l
#.........#
#.#.......#
#..#......#
#.........#
#####l#####

1
3
###########
#.........#
#.........#
#.........#
#.........#
d...#.....#
#.........#
#.......#.#
#.#....#..#
#.........#
#####D#####

4
4
#####D#####
#.........#
#.........#
#.........#
#.........#
D.........#
#.........#
#.........#
#.........#
#........X#
###########

3
3
#####d#####
#.#.......#
#.........#
#..#...#..#
#.........#
D...#.#...d
#.........#
#..#.#.#.##
#.........#
#.#.....#.#
#####D#####

4
1
###########
#..#......#
#...#.#...#
#.#..##...#
#..#..#...#
l..##.....#
#.........#
####......#
#.#.......#
#.........#
#####D#####
locked : 0

2
0
#####D#####
#.........#
#...#.#...#
#....#....#
#.........#
#....@....D
#....##.#.#
#....#.#.##
#......#.##
#........##
#####D#####

3
2
#####D#####
##.....#..#
#.........#
#.........#
#.#..#..#.#
#.........D
#.........#
#.........#
#.........#
#.........#
###########

1
2
###########
#.........#
#.........#
#.........#
#.........#
d.........d
#.........#
#.#.......#
#..#......#
#.........#
#####l#####

2
1
#####D#####
#.........#
#......#..#
#.......#.#
#.........#
D.........D
#.........#
#.#.......#
#..#......#
#..k......#
###########
key : 1

5
1
#####D#####
#.#.....#.#
#.........#
#..#.#...##
#.........#
D.....#...#
#.........#
#..#.#.#..#
#.........#
#.......#.#
###########

2
2
#####l#####
#.........#
#......#..#
#.......#.#
#.........#
D.........D
#.........#
#.........#
#.........#
#.........#
#####D#####
locked : 2

1
1
###########
#.........#
#.#.#.#...#
#.........#
#..#.#.#..#
D.........d
#.#.#.....#
#.........#
#..#...#..#
#.........#
#####D#####

3
0
#####D#####
#.........#
#.........#
#.........#
#.........#
#k........#
#.........#
#.........#
#.........#
#.........#
#####D#####
key : 0

0
0
###########
#k........#
#.........#
##..#.....#
#.........#
#.........#
#.#..#..#.#
#.........#
#.........#
##........#
#####D#####
key : 3

5
0
#####l#####
#.........#
#......#..#
#.......#.#
#.........#
#.........D
#.........#
#.........#
#.........#
#.........#
###########
locked : 1

2
3
#####D#####
##e#...#.##
#.........#
#.#.#.#...#
#.........#
D..#.#.#..#
#.........#
#.#.#.#...#
#.........#
##e#...#.##
#####d#####
enemies 2

4
3
#####D#####
##.#......#
#...#.....#
#.........#
#?#.......#
#..##.....D
#.........#
#.........#
#e........#
#ee.......#
###########
enemies 3
sign Beware what lurks ahead.

3
4
###########
#.........#
#.........#
#.........#
#.........#
d....e##..#
#....#.#..#
#.........#
#.........#
#.........#
#####D#####
boss
enemies 1

