4
1
#####d#####
#.........#
#..#......#
#.#.......#
#.........#
D.........D
#.........#
#.........#
#.........#
#.........#
###########

3
0
###########
#.........#
#.........#
#.........#
#.........#
#....@....D
#.........#
#.........#
#.........#
#.........#
#####D#####

3
1
#####D#####
#.#.....#.#
#.........#
#....#.#.##
#.........#
D...#.#...D
#.........#
#..#.#.#.##
#.........#
#.#.....#.#
#####d#####

3
2
#####D#####
#k........#
#.........#
#.........#
#.........#
D.........D
#.........#
#.#.......#
#..#......#
#.........#
#####l#####
key : 0

3
3
#####D#####
#e.......e#
##..#.....#
#.........#
#.........#
D...#..#..D
#.........#
#.........#
##..#..#..#
#e.......?#
#####D#####
enemies 3
sign Those who search shall find.

5
3
#####d#####
#.........#
#.#.......#
#..##.....#
#.#.#.....#
#.........#
#...#.##..#
#.....###.#
#.......#.#
#.......#.#
#####l#####

4
2
#####l#####
#.........#
#..#......#
#.#.......#
#.........#
D.........D
#.........#
#.#.......#
#####.....#
#.........#
###########
locked : 0

1
3
#####d#####
#.........#
#.........#
#.#..#..#.#
#.........#
#.........#
#k#..#....#
#.........#
#.........#
#.#.....#.#
#####D#####
key : 3

2
2
###########
#.........#
#..#......#
#.#.......#
#.........#
D.........D
#.........#
#.......#.#
#......#..#
#.........#
#####D#####

2
3
#####D#####
#.........#
#.........#
#.........#
#.........#
D....##...#
#...#.##..#
#.........#
#......##.#
#......##.#
#####D#####

4
0
#####D#####
#.........#
#.........#
#####.....#
#..#......#
#.........D
#e#e#.....#
####......#
#.........#
#.........#
#####D#####
enemies 2

4
4
#####D#####
#.........#
#.........#
#.........#
#.........#
d.........#
#.........#
#.........#
#.........#
#.........#
###########

5
0
#####D#####
#.........#
#.........#
#.........#
#.........#
#.........#
#.........#
#.#.......#
#..#......#
#.........#
###########

4
3
#####D#####
#k........#
#.........#
#.........#
#.........#
D.........d
#.........#
#.........#
#.....p...#
#p........#
#####d#####
key : 2

6
3
#####l#####
#.........#
#.........#
#.........#
#.#####...#
#..#.e....#
#.#..#.#..#
#..####...#
#.........#
#.........#
#####D#####
locked : 2
boss
enemies 1

2
1
###########
#ee.......#
#e........#
#?........#
#....#.##.#
#....#.#..D
#.....##..#
#....##.#.#
#........##
#.........#
#####D#####
enemies 3
sign Beware what lurks ahead.

7
3
#####D#####
#.........#
#.........#
#.##.#....#
#..###....#
#....##...#
#..#.##...#
#....#....#
#.........#
#X........#
###########

3
4
###########
#..#....k##
#.........#
#.........#
#...#..#..#
D.........#
#.........#
#........##
#.........#
#.........#
#####D#####
key : 1

0
3
###########
#.........#
#.........#
#.........#
#.........#
#..##.#...#
#..###....#
#...###...#
#.#...#...#
#.##......#
#####d#####

