0
3
###########
#........X#
#.........#
#.........#
#.........#
..........#
#.........#
#.........#
#.........#
#.........#
#####.#####

5
0
#####.#####
#.........#
##........#
#.........#
#.........#
#..........
#.........#
#.........#
#.........#
#.........#
#####.#####

4
2
#####.#####
#.........#
#.........#
#.........#
#.........#
d.........#
#.........#
#.#.....#.#
#.........#
#.........#
###########

3
0
#####.#####
#.#.......#
#.....#...#
#...#.....#
#.#.###...#
#..#.##...d
#.........#
#.........#
#.........#
#.........#
#####.#####

3
1
#####l#####
#.........#
#.........#
##........#
#.........#
d..........
#.........#
#.#.......#
#.........#
#.........#
#####.#####

2
0
###########
#ee#e....##
#.........#
#.........#
#.....#...#
#..........
#.........#
#........##
#.........#
#.........#
#####.#####
enemies 3

3
2
#####.#####
#k........#
#.........#
#..#......#
#...#.#...#
...........
#.........#
#.#.......#
#..#......#
#.........#
#####.#####
key : 1

2
3
#####.#####
#.........#
#.........#
#..#..#..##
#........k#
..........#
#..#..#...#
#.........#
#.........#
#..#......#
#####.#####
key : 4

0
2
###########
#.........#
#.........#
#.........#
#.........#
#..........
#.........#
#.........#
#.........#
#.........#
#####.#####

2
2
#####l#####
#.........#
#......#..#
#....##?..#
#...####..#
....#e.#...
#....#..#.#
#.........#
#......##.#
#......##.#
#####.#####
enemies 1
sign This door will not yield without a key.

3
4
###########
#........k#
#.........#
#.........#
#.........#
..........#
#.........#
#.......#.#
#......#..#
#.........#
###########
key : 3

3
3
#####.#####
##.....#..#
#.........#
#.........#
#.#..#....#
...........
#.........#
#...#..#..#
#.........#
#e..ee....#
###########
enemies 3

4
1
#####.#####
#.........#
#.........#
#.........#
#.........#
..........d
#.........#
#.........#
#.........#
#.........#
#####d#####

1
2
#####.#####
#.........#
#.........#
#.........#
#.........#
#.........d
#.........#
###.......#
#..#......#
#.........#
#####l#####
locked : 3

6
0
#####.#####
#.........#
#......#..#
#.......#.#
#.........#
#.........#
#.........#
#.#.......#
#..#......#
#k........#
###########
key : 0

1
3
#####.#####
#.#.......#
#.#.#.....#
#.....#...#
#.##.##...#
d..#.e#...#
#.##......#
##........#
###.......#
#.........#
#####.#####
boss
enemies 1

2
1
###########
#.........#
#......#..#
#.......#.#
#.........#
...........
#.........#
#.......#.#
#......#..#
#.........#
#####l#####
locked : 1

5
1
#####d#####
#.........#
##.#......#
#.#.......#
#.........#
..........#
#.........#
#.#.....#.#
#..#......#
#.........#
###########

4
0
#####.#####
#.........#
#.........#
#...#.....#
#...#.#...#
#...#@.....
#.........#
#.........#
#.........#
#.........#
#####.#####

