6
1
###########
#.........#
#.........#
#..#..#..##
#.........#
..........d
#..#..#...#
#.........#
#.........#
#..#......#
#####.#####

0
2
###########
#e.......e#
##.#...#.##
#e........#
#.#.#.#.#.#
#.........#
#..#.#.#..#
#.........#
#...#.#.#.#
#.........#
#####.#####
enemies 3

2
4
###########
#........e#
##.#...#..#
#.........#
#.......#.#
..........#
#..#...#..#
#.........#
#.....#.#.#
#........?#
###########
enemies 1
door 0 : 0 1
sign Turn back; you are not yet ready.

2
3
###########
#.........#
#.........#
#.........#
#.........#
l....e.....
#.........#
#.........#
#.........#
#.........#
#####.#####
locked : 5
boss
enemies 1

6
3
###########
##.#...#.##
#.........#
##.#.#.#.##
#.........#
d..#.#....#
#.........#
##.#.#.#.##
#.........#
#......#.##
###########

1
2
#####.#####
#.........#
#.........#
#.........#
#....##...#
#..#..##..#
#.#k###...#
#.#.#.#...#
#.#.......#
#.##......#
#####.#####
key : 5

6
0
#####.#####
#.........#
#.........#
#?#.......#
#..#......#
#....@.....
#.........#
#.........#
#.........#
#.........#
#####.#####
sign Beware what lurks ahead.

5
0
###########
#e.......e#
#s........#
#.........#
#.........#
#.........#
#.........#
#.........#
#.........#
#.........#
#####.#####
enemies 2
switch 0 : 0 1

3
3
#####.#####
#.........#
#.........#
#.........#
#.........#
..........#
#.........#
#.#.......#
#.....#...#
#........X#
###########

8
0
#####l#####
####......#
#####.....#
###.##....#
#...##....#
#...#.....#
#.##......#
#..#......#
##.##.....#
#.........#
#####.#####
locked : 0

5
2
#####l#####
#.........#
#.........#
#....#..#.#
#.........#
#.........#
#k#..#....#
#.........#
#.........#
#.#.......#
#####.#####
key : 1

7
1
#####.#####
#.........#
#.........#
#.........#
#.........#
...........
#.........#
#.........#
#.........#
#....k....#
###########
key : 0

3
2
#####d#####
#.........#
#.........#
#..#.....##
#.........#
#..........
#.....#...#
#.........#
#.........#
#..#.....##
#####l#####
locked : 1

6
2
#####.#####
#.........#
#.........#
#.....#...#
#.........#
d.........d
#...#..#..#
#.........#
#.........#
#..#.....##
#####.#####

4
2
#####l#####
#.........#
#...#..#..#
#.......#.#
#.........#
#.........#
#.........#
#......#..#
#.........#
#.......#.#
#####l#####
locked : 2

7
2
#####.#####
#.........#
#..#...#..#
#.#.....#.#
#.........#
..........#
#.........#
#.#.......#
#..#......#
#........k#
###########
key : 2

7
0
#####.#####
#.........#
#.........#
#.........#
#.........#
#..........
#.........#
#.........#
#.........#
#.........#
#####l#####

9
0
#####.#####
#.........#
##.#.....##
#.........#
#.#.......#
#.........#
#..#.#.#..#
#.........#
#.#.#.....#
#.........#
###########

2
2
#####.#####
#.......#.#
#.........#
#..#.#.#.##
#.........#
#...#.....l
#.........#
#..#.#.#.##
#.........#
#.#.....#.#
#####d#####

