4
1
#####.#####
#.......#k#
#.........#
#.........#
#..#..#...#
...........
#.........#
#.#..#..#.#
#.........#
#.........#
#####.#####
key : 0

3
1
###########
#k........#
#......#..#
#.......#.#
#.........#
#..........
#.........#
#.........#
#.........#
#.........#
#####.#####
key : 1

4
0
###########
###?......#
####......#
####.#....#
#.####....#
#..###.....
#..#@.....#
##.#.#....#
#.........#
#.........#
#####l#####
sign This door will not yield without a key.

5
0
#####l#####
#.......#.#
#.........#
#..#...#..#
#.........#
#...#.#...l
#.........#
#..#...#.##
#.........#
#.#.....#.#
###########
locked : 0

1
3
#####.#####
#.......#.#
#.........#
#.#...#.#.#
#.........#
l.....#...d
#.........#
#...#.#.#.#
#.........#
#.#.....#.#
#####.#####
locked : 2

3
2
#####d#####
#k........#
#..#......#
#.#.......#
#.........#
...........
#.......#.#
#.........#
#.........#
#.........#
#####.#####
key : 2

3
4
#####.#####
#.........#
#.#.#.#...#
#.........#
#.#.#.#.#.#
..........#
#.#.......#
#.........#
#.#.#.#.#.#
#........e#
###########
enemies 1

1
2
#####l#####
#........k#
#..#..#..##
#.........#
#.........#
#...#..#..l
#.........#
#.........#
#..#.....##
#.........#
#####.#####
key : 3

3
3
#####.#####
#.........#
#...#.#..##
#...##....#
#...#.....#
...........
#.........#
#.........#
#.........#
#.........#
###########

2
2
#####.#####
#.........#
#.........#
#.........#
#.........#
#..........
#.........#
#.........#
#.........#
#.........#
#####d#####

5
2
#####.#####
#.........#
#.........#
#..#.##...#
#....###..#
...###.#..#
#.###...#.#
#.#...#.#.#
#......#..#
#........e#
###########
enemies 1

0
2
###########
#.........#
#.........#
#.........#
#.........#
#.........d
#.........#
##........#
#........##
#.........#
#####l#####
locked : 3

5
1
#####.#####
#..#....#.#
#......#..#
#.......#.#
#.........#
l..........
#.........#
#.#.....#.#
#......#..#
#.........#
#####.#####
locked : 1

6
1
#####.#####
#.........#
#.........#
#.....#...#
#.........#
#.........#
#.........#
#......##.#
#......#.##
#.........#
###########

0
3
###########
#.........#
#.........#
#.........#
#.........#
d.........#
#.........#
#.........#
#.........#
#.........#
#####.#####

1
4
###########
#.........#
#.........#
##.#......#
#.#.#.....#
d....e#...#
#...#.....#
#.........#
#.........#
#.........#
#####.#####
boss
enemies 1

2
3
#####.#####
#.........#
#.........#
##.#####..#
#.###.....#
...##..#...
#....#.#..#
##.##.##..#
#.........#
#.........#
#####.#####

2
4
#####.#####
#.........#
#.........#
#.........#
#.........#
.....###X.#
#.....###.#
#.....###.#
#.........#
#.........#
#####.#####

4
2
#####.#####
#.........#
#.........#
#.........#
#.........#
..........#
#.........#
#.........#
#.........#
#.........#
#####.#####

