8
0
#####d#####
#.........#
#.........#
#.##......#
#.........#
#....e....#
#.........#
#.........#
#.........#
#.........#
#####.#####
boss
enemies 1

4
0
#####.#####
#.........#
#.........#
#.........#
#.........#
#....@.....
#.........#
#.........#
#.........#
#.........#
#####.#####

6
0
#####.#####
#.........#
#..#......#
#k#.......#
#.........#
#..........
#.........#
#.........#
#.........#
#.........#
#####l#####
key : 4

2
1
#####.#####
#.........#
#.........#
#..#..#..##
#.........#
..........#
#...#..#..#
#.........#
#.........#
#..#.....##
#####.#####

3
1
#####.#####
#.........#
#..#......#
#.#.......#
#.........#
d.........l
#.........#
#.#.......#
#..#......#
#.........#
#####.#####

4
2
#####.#####
#k........#
#......#..#
#.......#.#
#.........#
..........d
#.........#
#.........#
#.........#
#.........#
#####.#####
key : 2

5
1
#####.#####
#k#.....#.#
#.........#
#....#.#.##
#.........#
....#.#....
#.........#
#..#.#.#..#
#.........#
#.#.......#
#####d#####
key : 3

6
1
#####d#####
#.........#
#.........#
#.........#
#.........#
..........#
#.........#
#.........#
#.........#
#.........#
###########

5
0
#####.#####
#k#.......#
#.........#
#.#.#.#.#.#
#.........#
#...#.#....
#.........#
#...#.#.#.#
#.........#
#.#.....#.#
#####.#####
key : 0

2
0
###########
#.........#
#...#..#..#
#.........#
#.........#
#....#.....
#.........#
#.........#
##..#..#..#
#.........#
#####l#####
locked : 0

4
1
#####.#####
#.........#
##........#
#.........#
#.........#
...........
#.......#.#
#.........#
##........#
#.........#
#####.#####

1
1
#####.#####
##.....#..#
#s........#
#.........#
#......#..#
#.........#
#e........#
##........#
#.........#
#.........#
#####.#####
enemies 1
switch 0 : 0 1

9
0
#####.#####
#.........#
#.........#
#.........#
#.........#
#.........#
#.........#
#.........#
#.........#
#X........#
###########

3
0
#####l#####
#.........#
##..#..#..#
#.........#
#.........#
#......#..d
#.........#
#.........#
#...#..#..#
#.........#
#####.#####

4
3
###########
#.........#
#.........#
#.........#
#.........#
d.........#
#.........#
#.........#
#.....#...#
#.........#
###########

3
2
###########
#.........#
#.........#
#.........#
#.........#
l.........#
#.........#
#.........#
#.........#
#.........#
#####.#####
locked : 4

5
2
#####.#####
#.........#
#.........#
#.........#
#.........#
..........#
#.........#
#.........#
#.........#
#.........#
###########

7
0
#####l#####
#.........#
#.........#
#..#..#..##
#.........#
#.........#
#...#.....#
#.........#
#.........#
#..#......#
#####d#####
locked : 2

0
1
###########
#e.......e#
#.........#
#.........#
#.........#
#.........#
#.........#
#.........#
#.........#
#.........#
#####.#####
enemies 2
door 0 : 0 1

