4
3
###########
##.....#.##
#.........#
#.#.#.#.#.#
#.........#
d..#.#.....
#.........#
#.#.....#.#
#.........#
##.#...#..#
#####.#####

5
2
#####.#####
#.........#
#.........#
#.........#
#.........#
...........
#....#....#
#.......#.#
#......#..#
#.........#
###########

3
0
###########
#.........#
#.#...#.#.#
#.........#
#..#...#..#
#..........
#.....#...#
#.........#
#......#..#
#.........#
#####.#####

1
3
###########
#.#.......#
#.###.....#
#.##..#...#
#.##......#
d....e....#
#.#..#....#
###..#....#
#...#.....#
#.........#
#####.#####
boss
enemies 1

3
1
#####.#####
#k........#
##.#.....##
#.........#
#.#...#.#.#
..........l
#..#.#.#..#
#.........#
#.#.#.#.#.#
#.........#
#####.#####
key : 1

3
2
#####.#####
#.........#
#......#..#
#.......#.#
#.........#
l.........#
#.........#
#.......#.#
#......#..#
#.........#
#####.#####
locked : 0

2
2
#####.#####
#e.......##
#.........#
#.........#
#......#..#
...........
#.........#
#..#..#..##
#.........#
#e.......e#
#####.#####
enemies 3

5
1
#####.#####
#.........#
#.........#
#...###.#.#
#...k####.#
#...####...
#....#..#.#
#......#..#
#.........#
#.........#
#####d#####
key : 0

1
2
#####.#####
#.........#
#......#..#
#...#...#.#
#.........#
d.........d
#.........#
#.......#.#
#......#..#
#.........#
#####.#####

4
4
###########
#........k#
#.........#
#.........#
#.........#
..........#
#.........#
#.........#
#.........#
#.........#
###########
key : 3

2
3
#####.#####
#.##......#
#...#.....#
#.####....#
#.#.......#
...#......#
#.........#
#.........#
#.........#
#........X#
###########

1
1
###########
#.........#
#..#..#..##
#.........#
#.........#
#..#......d
#.........#
#.........#
#..#..#..##
#.........#
#####.#####

0
2
###########
#e.......e#
#?........#
#.........#
#.........#
#.........#
#.........#
#.........#
#.........#
#.........#
#####.#####
enemies 2
sign The dungeon remembers all who enter.

5
3
#####.#####
#.........#
#.........#
#.........#
#.........#
..........#
#.........#
#.#.....#.#
#..#...#..#
#........k#
###########
key : 4

6
1
#####d#####
##.....#..#
#.........#
#...#.#.#.#
#.........#
#..#...#..#
#.........#
#.#.#.#...#
#.........#
##.#......#
###########

4
1
#####.#####
#.........#
#.........#
#.........#
#.#..#..#.#
...###.....
#.#.......#
#####.....#
#####.....#
##........#
#####.#####

4
2
#####.#####
#........e#
#...#.##e##
#.......#.#
#.........#
..........d
#.........#
#.........#
#........##
#.........#
#####.#####
enemies 2

4
0
#####.#####
#.........#
#.........#
#.........#
#.........#
#..##@.....
#.##......#
#..#......#
#.........#
#?........#
###########
sign The dungeon remembers all who enter.

2
1
#####.#####
#e........#
#.........#
#.........#
#e........#
#e.........
#?........#
#.........#
#.........#
#.........#
#####.#####
enemies 3
sign A useful tool lies just ahead.

