3
2
#####.#####
#.........#
#..#......#
#.#.......#
#.........#
#.........l
#.........#
#.#.....#.#
#..#...#..#
#.........#
#####d#####

0
2
###########
##........#
#.........#
#.........#
#.#..#..#.#
d.........#
#.........#
##..#.....#
#.........#
#.........#
#####.#####

1
1
#####.#####
#k........#
#.........#
#.........#
#.........#
...........
#.........#
#.#.......#
#..#......#
#.........#
#####.#####
key : 2

1
3
###########
#..k......#
#..#......#
#.#.......#
#.........#
...........
#.........#
#.........#
#.........#
#.........#
#####.#####
key : 4

4
3
#####d#####
#.........#
#...#.....#
#.........#
#..#####..#
.....e#...#
#....#.#..#
#.........#
#.........#
#.........#
#####.#####
boss
enemies 1

1
2
#####.#####
#.........#
#..#.....##
#.........#
#.#.#.#.#.#
...........
#..#.#.#..#
#.........#
#.....#.#.#
#.........#
#####l#####
locked : 2

2
0
#####.#####
#.........#
#.....#...#
#......#..#
#....###..#
#....@.....
#.........#
#.........#
#.........#
#.........#
###########

2
5
###########
#........k#
#..#......#
#.........#
#.........#
..........#
#.........#
#..#......#
#.........#
#.........#
###########
key : 5

2
1
#####.#####
#.........#
#.........#
#.........#
#.........#
.....#....l
#....##...#
#....###..#
#.....##..#
#.........#
###########

2
4
#####.#####
#.........#
#..#......#
#.#.......#
#.........#
d..........
#.........#
#.........#
#.........#
#.........#
###########

5
3
#####.#####
##........#
#.........#
#..#......#
#..##.....#
#..#.#....#
#..#.#.#..#
#..#.##...#
#..#......#
#X........#
###########

0
1
###########
#.........#
##.....#.##
#.........#
#.#.#...#.#
..........d
#..#.#.#..#
#.........#
#...#.#...#
#.........#
#####.#####

0
0
###########
#.........#
#.........#
#.........#
#.........#
#..........
#.........#
#.....#.#.#
#......#..#
#.#.......#
#####.#####

2
3
#####.#####
#.........#
#...#.#.#.#
#.........#
#.#.#...#.#
..........d
#.#.#.#.#.#
#.........#
#.#.#.#.#.#
#.........#
#####.#####

4
2
#####d#####
#.........#
#.........#
#.....#...#
#.........#
#...#......
#.........#
#..#......#
#.........#
#.........#
###########

1
0
#####.#####
#.........#
#..##.....#
#..#....#.#
#k#.......#
#...#......
#...#.....#
#.........#
#.........#
#.........#
#####.#####
key : 0

1
4
###########
#........e#
#........e#
#.....#..##
#.........#
..........#
#...#.....#
#.........#
#.........#
#..#......#
#####.#####
enemies 2

2
2
#####l#####
#.........#
#.#.#.#.#.#
#.........#
#..#.#....#
l..........
#...#.#.#.#
#.........#
#......#.##
#.........#
#####.#####
locked : 0

3
3
#####.#####
#.#.....#.#
#.........#
#...#.#...#
#.........#
l.....#...#
#.........#
#.#.#.#.#.#
#.........#
#.#.....#.#
#####d#####
locked : 4

