2
1
#####D#####
#.........#
#.........#
#.........#
#.##......#
D..##.....D
#.#.#.....#
###.......#
#####.....#
#.........#
#####D#####

2
0
###########
#k........#
#.........#
#.........#
#.........#
#.........D
#.#.#.....#
#..##.....#
#.###.....#
#.........#
#####D#####
key : 1

6
2
#####D#####
##.....#.##
#.........#
#...#.....#
#.........#
#....#.#..#
#.........#
#...#.#...#
#.........#
##k#...#.##
###########
key : 3

1
2
###########
#.........#
#......#..#
#.......#.#
#.........#
D.........d
#.........#
#.......#.#
#......#..#
#.........#
#####l#####
locked : 2

0
3
###########
#X........#
#.........#
#.........#
#.........#
#.........#
#.........#
#.........#
#.........#
#.........#
#####D#####

1
3
#####D#####
#.........#
#.........#
#.........#
#.........#
d....e....#
#.........#
#.........#
#..#......#
#.........#
#####D#####
boss
enemies 1

2
2
#####l#####
#.........#
#.........#
#.........#
#.........#
D.........d
#.........#
#.......#.#
#......#..#
#.........#
#####d#####

4
0
#####D#####
#.........#
#.........#
#.........#
#.........#
#?...@....D
#.........#
#.........#
#.........#
#.........#
#####d#####
sign Beware what lurks ahead.

5
2
#####D#####
#.........#
#.........#
#.........#
#.#....#..#
l......#..l
#.....##..#
#.........#
#.........#
#.........#
#####D#####
locked : 1

5
3
###########
#.........#
#..#...#..#
#.#.....#.#
#.........#
l.........#
#.........#
#.........#
#.........#
#.........#
###########
locked : 3

4
1
#####D#####
#.........#
#.###.....#
#...##....#
#.#..##...#
D..##.#...D
#.........#
#.........#
#.........#
#.........#
#####D#####

4
2
#####D#####
#.........#
#.......#.#
#.........#
#....#....#
D.........#
#...#.#.#k#
#.........#
#..#...#.##
#.........#
#####D#####
key : 2

3
2
#####d#####
#e........#
#.........#
#.....#...#
#....#....#
D......#.e#
#.........#
#.........#
#.........#
#.........#
#####D#####
enemies 2

3
1
#####D#####
#.......#.#
#.........#
#.#...#.#.#
#.........#
D.........D
#.........#
#.#.....#.#
#.........#
#.......#.#
#####D#####

3
0
#####D#####
#.........#
#.#...#.#.#
#.........#
#.#.#.#...#
#.........D
#...#.....#
#.........#
#.#...#.#.#
#.........#
#####D#####

5
1
#####D#####
#.........#
#.........#
##..#..#..#
#.........#
D.........l
#.#..#..#.#
#.........#
#.........#
##....k#..#
###########
key : 0

1
1
###########
#e?.......#
#e........#
#.........#
#.........#
#.........D
#.........#
#.........#
#.........#
#.........#
#####D#####
enemies 2
sign A locked path — look elsewhere first.

5
0
#####d#####
#.........#
#.........#
#.........#
#.........#
#.........D
#.........#
#.#.......#
#..#......#
#.........#
###########

2
3
#####D#####
#.........#
#.........#
#.....#...#
#....##...#
d.........#
#.........#
#.........#
#.........#
#.........#
###########

