2
1
#####.#####
#.........#
#.........#
#.........#
#.........#
...........
#.........#
#...#.....#
#.........#
#.........#
#####.#####

3
2
#####.#####
#.........#
#...#.#.#.#
#.........#
#..#.#.#..#
d.........d
#.......#.#
#.........#
#..#.....##
#.........#
###########

2
0
###########
#?........#
#.........#
#.........#
#.........#
#....@.....
#.........#
#.........#
#.........#
#.........#
#####.#####
sign Those who search shall find.

1
3
###########
#......##.#
#.....##..#
#.....#...#
#.........#
...........
#.........#
#.........#
#.........#
#.........#
###########

1
5
###########
#.##....?e#
#.........#
#....#....#
#...#e#...#
...##.....#
#.###.....#
#.##.#....#
#..#......#
##........#
#####d#####
enemies 2
sign The dungeon remembers all who enter.

2
2
#####l#####
#.........#
#.##......#
#.#.......#
#..#......#
.....#....#
#......#..#
#...#.#...#
#..#......#
#.........#
#####.#####

1
2
###########
#.........#
#.........#
#.........#
#.........#
...........
#.........#
#.........#
#.........#
#.........#
#####l#####
locked : 4

4
3
#####d#####
#.........#
#.........#
#.........#
#.........#
#.........#
#.........#
#.........#
#.........#
#.........#
###########

1
4
###########
#.........#
#..#......#
#.#.......#
#.........#
...........
#.........#
#.........#
#.........#
#.........#
###########

2
5
#####d#####
#.........#
#.........#
#....####.#
#....#.#..#
#...#e.....
#.....###.#
#....####.#
#.........#
#.........#
#####.#####
boss
enemies 1

2
6
###########
#.......ee#
#........s#
#.........#
#.........#
...##?#...#
#....###..#
#..#..#...#
#.....#...#
#..#...#..#
#####.#####
enemies 2
switch 0 : 0
sign Beware what lurks ahead.

3
6
#####.#####
#.........#
#..#..#...#
#.........#
#.........#
...#..#...#
#.........#
#.........#
#..#..#...#
#.....e..e#
###########
enemies 2
door 0 : 0

3
1
#####.#####
#.........#
#..#...#..#
###...#k#.#
#.....#...#
..........d
#.........#
#.........#
#.........#
#.........#
###########
key : 2

1
1
#####.#####
#.........#
#.........#
#.....#...#
#...#..#..#
#....##....
#..#####..#
#..##.....#
#.........#
#.........#
#####.#####

0
1
###########
##.....#.##
#k........#
##.#...#.##
#.........#
#..#.#.#..#
#.........#
##...#...##
#.........#
##.#...#..#
#####.#####
key : 4

3
5
#####.#####
#.........#
#.........#
#.........#
#.........#
#..........
#.........#
#.........#
#.........#
#X........#
###########

3
0
#####.#####
#.........#
#.........#
#.........#
#.........#
#...#..#...
#k##..###.#
#......#..#
#.........#
#.........#
#####.#####
key : 0

4
0
#####.#####
#.........#
#.........#
#.........#
#.........#
#.........#
#.........#
#.........#
#.........#
#k........#
###########
key : 1

3
3
###########
#.........#
#.........#
#.........#
#.........#
d.........#
#.........#
#.#.......#
#..#......#
#.........#
#####d#####

