3
1
#####.#####
#k........#
#.#.#.#.#.#
#.........#
#..#.#.#..#
...........
#.....#...#
#.........#
#.........#
#.........#
#####.#####
key : 3

2
1
#####.#####
#......#..#
#..#..#...#
#..##.##..#
#..#k###..#
...#..##..l
#.........#
#.........#
#.........#
#.........#
#####.#####
key : 4

2
0
###########
#k........#
#...#.#.#.#
#.........#
#.#.#.#.#.#
#..........
#.#.#...#.#
#.........#
#...#.#...#
#.........#
#####.#####
key : 2

5
0
#####.#####
#.........#
#.#.......#
#.........#
#.........#
#..#..#....
#.........#
#s........#
#e......#.#
#ee.......#
###########
enemies 3
switch 0 : 0

4
1
#####.#####
#k........#
#.........#
#.........#
#.........#
...........
#.........#
#.#.......#
#..#......#
#.........#
#####.#####
key : 0

3
4
###########
#......#..#
#..#..##..#
#..##..#..#
#.....##..#
d.....##..d
#.........#
#.........#
#.........#
#.........#
###########

0
1
###########
#.........#
#..#......#
#.#.......#
#.........#
#.........#
#.........#
#.#.....#.#
#..#...#..#
#.........#
#####l#####
locked : 3

4
2
#####.#####
#.........#
#......#..#
#.......#.#
#....#....#
..........#
#.........#
#.#.......#
#..#......#
#.........#
###########

5
1
#####.#####
#.........#
#.........#
#....#..#?#
#.........#
..........#
#..#......#
#.........#
#.........#
#e#.......#
#####.#####
enemies 1
door 0 : 0
sign Something glints behind that door…

1
1
#####l#####
#.........#
#..#...#..#
#.#.....#.#
#.........#
#..........
#.........#
#.........#
#.........#
#.........#
#####.#####

3
2
#####.#####
#.........#
#.#.#.#...#
#.........#
#..#.#.#..#
..........d
#.#.#.#...#
#.........#
#..#.....##
#.........#
#####.#####

4
5
#####.#####
#.........#
#.........#
#.........#
#.........#
#.........#
#.........#
#.........#
#.........#
#X........#
###########

2
2
#####d#####
#.........#
#..#..#...#
#.........#
#.........#
l...#..#..#
#.........#
#.........#
#..#.....##
#.........#
#####.#####
locked : 4

3
0
#####.#####
#.........#
#..#......#
#.#.......#
#.........#
#..........
#.........#
#.........#
#.........#
#.........#
#####l#####
locked : 0

4
0
#####l#####
#.........#
#.........#
#.........#
#.........#
#?...@.....
#.........#
#.........#
#.........#
#.........#
#####.#####
sign Seek the matching key before you proceed.

6
1
#####.#####
#.........#
#.........#
#.........#
#.........#
#......#..#
#.........#
#.........#
#.........#
#........##
###########

3
5
###########
#......#..#
#.........#
#.........#
#.........#
d....e....#
#.........#
#.........#
#.........#
#.......#.#
#####.#####
boss
enemies 1

1
2
###########
#.........#
##........#
#.##......#
#.........#
....#.....#
#.###.....#
#.###.....#
#.#.......#
#.........#
#####d#####

3
3
###########
#.........#
#.........#
##........#
#.........#
d.........d
#.#.....#.#
#.........#
#.........#
##........#
###########

