5
0
#####d#####
#..#.....##
#.........#
#.........#
#...#.....#
#.........#
#.........#
#..#..#...#
#.........#
#.........#
###########

0
1
###########
#.........#
#.##......#
#.#.......#
#.......#.#
#.........D
#.........#
#.........#
#.........#
#.........#
#####D#####

2
4
#####D#####
#.........#
#.........#
#.........#
#.........#
d.........#
#.........#
#.#.....#.#
#..#...#..#
#.........#
###########

0
2
###########
#........k#
#.........#
#.........#
#.........#
D.........#
#.........#
#.........#
#.........#
#.........#
#####D#####
key : 3

1
0
###########
#.k#......#
#.#.......#
#..#......#
#.#.......#
#..#......D
#.........#
#.........#
#.........#
#.........#
#####D#####
key : 1

0
4
###########
#X........#
##........#
#.........#
#.........#
#.........#
#.........#
#.........#
#.........#
#.........#
#####D#####

1
2
#####D#####
##.#...#.##
#.........#
#.#.#...#.#
#.........#
D....#....D
#.........#
#.#.#...#.#
#.........#
#..#...#..#
#####d#####

3
0
#####D#####
#.........#
#.........#
#.........#
#.........#
#?...@....D
#.........#
#.........#
#.........#
#.........#
#####l#####
sign This door will not yield without a key.

3
1
#####D#####
#k........#
#.........#
#..#..#..##
#.........#
D.........D
#.....#...#
#.........#
#.........#
#..#......#
#####D#####
key : 0

4
0
#####l#####
#.......#.#
#.....##..#
#.........#
#.....###.#
#.........D
#.........#
#.........#
#.........#
#.........#
#####d#####
locked : 0

3
2
#####l#####
#.........#
#.........#
#....#....#
#.........#
D.........#
#.........#
#.........#
#.........#
#.........#
###########
locked : 6

2
0
#####D#####
#.........#
#.........#
##.....#..#
#.........#
#.........D
#...#..#..#
#.........#
#.........#
##.....#..#
#####D#####

1
4
#####D#####
#.........#
#.###.....#
#####.....#
#...#.....#
d..##e....#
#.###.....#
#.........#
#.........#
#.........#
#####D#####
boss
enemies 1

2
3
#####D#####
#.........#
#...#.#...#
#.........#
#.#.#.#.#.#
D.........d
#.#.#.#.#.#
#.........#
#.#...#...#
#.........#
###########

4
1
#####D#####
#.........#
#.........#
#.........#
#...p.....#
D.........#
#.........#
#.p.......#
#.........#
#.........#
###########

2
1
#####D#####
#.........#
#..#......#
#.#.......#
#.........#
D.........D
#..#...#..#
#.......#.#
##.....#..#
#.........#
#####D#####

2
2
#####d#####
#e........#
#.........#
#..p...#..#
#.........#
D....#....D
#....###..#
#...#e###.#
#...#.....#
#......##p#
#####l#####
enemies 2

1
3
###########
#e#.....#e#
#.........#
#.#...#...#
#.........#
D.....#...d
#.........#
#.#...#.#.#
#.........#
#e#.....#?#
#####D#####
enemies 3
sign The dungeon remembers all who enter.

1
1
#####D#####
#k........#
#..#...#..#
#.#.....#.#
#.........#
D.........D
#.........#
#.........#
#.....#...#
#..#......#
#####D#####
key : 6

