5
0
#####.#####
#..#.....##
#.........#
#.........#
#...#.....#
#.........#
#.........#
#..#..#..##
#.........#
#.........#
###########

0
3
###########
#X........#
#.........#
#.........#
#.....##..#
#....#.#..#
#....#..#.#
#.....#..##
#.......#.#
#.........#
#####.#####

3
0
#####.#####
#.........#
#.........#
#.........#
#.........#
#..........
#.........#
#.........#
#.........#
#.........#
#####d#####

3
2
#####.#####
#.........#
#..#......#
#.#...#...#
#...##....#
d..........
#.........#
#.#.....#.#
#..#...#..#
#.........#
###########

2
1
#####.#####
#........e#
#..#..#..##
#.........#
#.........#
....#..#...
#.........#
#.........#
#.....#..##
#.........#
#####.#####
enemies 1

4
3
#####.#####
#.........#
#..#...#..#
#.#k....#.#
#..#......#
#.........l
#.........#
#...#...#.#
#......#..#
#.........#
#####.#####
key : 4

1
2
###########
###.......#
####......#
##........#
#.........#
l.........d
#.........#
#.........#
#.........#
#.........#
#####.#####
locked : 3

0
1
###########
#.........#
#..#...#..#
#.#.....#.#
#.........#
#.........#
#.........#
#.......#.#
#......#..#
#.........#
#####d#####

1
1
#####d#####
#.........#
#..#......#
#k#.......#
#.........#
#.........l
#.........#
#.......#.#
#......#..#
#.........#
#####.#####
key : 3

4
1
#####.#####
#.........#
#.#.#.#.#.#
#.........#
#..#.#.#..#
..........#
#.#.#.#.#.#
#.........#
#..#...#..#
#........k#
###########
key : 0

5
3
#####.#####
#.........#
#..#......#
###.##....#
#...#.....#
#..#.#....#
#.#..#....#
#.........#
#.........#
#e.......?#
###########
enemies 1
sign Something glints behind that door…

3
1
#####.#####
#.........#
#.........#
#.#..#..#.#
#.........#
..........d
#..#..#...#
#.........#
#.........#
#.......#.#
#####.#####

2
0
###########
#?.#...#..#
#..#..#...#
#.....#...#
#...###...#
#....@.#...
#.........#
#.........#
#.........#
#.........#
#####.#####
sign The dungeon remembers all who enter.

3
3
#####l#####
#..#...#..#
#.....##..#
#....#.#..#
#..#k#.##.#
....##....#
#.....#...#
#.....##..#
#.........#
#.........#
#####.#####
key : 1

4
0
#####d#####
#.........#
#..#...#..#
#.#.....#.#
#.........#
#..........
#.....#...#
#.........#
#.........#
#.........#
#####.#####

2
2
#####.#####
#.........#
##.#.....##
#.........#
#..#.#....#
...........
#....#.#..#
#.........#
#......#.##
#.........#
#####.#####

4
4
###########
#.#.....#.#
#.........#
#......#.##
#.........#
l.....#...#
#.........#
#..#.#.#.##
#.........#
#.#.....#.#
###########
locked : 4

2
3
#####.#####
#.........#
#..#....#.#
#.#.......#
#.........#
..........#
#.........#
#.......#.#
#......#..#
#.........#
#####l#####
locked : 0

1
3
#####.#####
#.##......#
#.#.#.....#
#...##....#
#...e#....#
d..#.##...#
#...####..#
#..#..#...#
#..##..#..#
#..#...#..#
#####.#####
boss
enemies 1

