3
2
###########
#..#.....e#
#.........#
#.........#
#..#..#...#
..........#
#.........#
#..#..#..##
#.........#
#.........#
#####.#####
enemies 1

4
0
#####.#####
#.........#
#.........#
#.........#
#.........#
#k........l
#.........#
#.........#
#.........#
#.........#
#####.#####
key : 2

6
0
#####.#####
#.#.....#.#
#.........#
#.........#
#..#..#...#
#..........
#.........#
#.#..#..#.#
#.........#
#.........#
###########

4
2
#####.#####
#.........#
#..#...#..#
#.#.....#.#
#.........#
..........d
#.........#
#.......#.#
#...#..#..#
##........#
#####d#####

2
0
#####.#####
#.........#
##.....#..#
#.........#
#..#...#..#
#..........
#....#.#..#
#.........#
#..#...#.##
#.........#
#####.#####

3
1
#####.#####
#..#......#
#.........#
#.........#
#...#..#..#
l..........
#.........#
#..#..#..##
#.........#
#.........#
#####.#####
locked : 1

1
1
###########
#.........#
#......#..#
#.......#.#
#.........#
d.........#
#...#.#...#
#.#.......#
#.##......#
#.........#
#####.#####

5
3
#####.#####
#.........#
#.........#
#.........#
#.........#
..........#
#.........#
#.........#
#.........#
#........X#
###########

4
1
#####.#####
#..#...#.##
#.........#
##.....#.##
#.........#
l..#.#.#...
#.........#
#..#.#.#.##
#.........#
##.#...#.##
#####.#####
locked : 2

1
0
#####.#####
#.........#
#.#...#...#
#.##.##...#
#.##@##...#
#..###....d
#...##....#
#.........#
#.........#
#.........#
#####.#####

6
1
#####.#####
#.........#
#.........#
#.........#
#.........#
...........
#.........#
#.........#
#.........#
#.........#
###########

5
2
#####d#####
#.........#
#.........#
#.........#
#.........#
...........
#.........#
#.........#
#.........#
#.........#
#####d#####

5
1
#####.#####
#.#.....#.#
#.........#
#.........#
#.#..#..#.#
l..........
#.........#
#.#..#..#.#
#.........#
#.........#
#####.#####
locked : 3

5
0
#####.#####
#.........#
#.........#
##.#...#.##
#.........#
#.........l
#.........#
##.#.#...##
#k........#
##.......##
#####.#####
key : 3

2
1
#####.#####
#k........#
##.#.....##
#.........#
#...#.#...#
..........#
#..#...#..#
#.........#
#.#.#...#.#
#.........#
#####.#####
key : 0

0
0
###########
#.##......#
#...#.....#
#.##......#
#.........#
#.........#
#.........#
#.........#
#.........#
#.........#
#####.#####

3
0
#####.#####
#.........#
#..#......#
#k#.......#
#.........#
#.........l
#.........#
#.........#
#.........#
#.........#
#####.#####
key : 1

6
2
#####d#####
#.........#
#..#......#
#.#.......#
#.........#
..........#
#.........#
#.........#
#.........#
#.........#
###########

4
3
###########
#.........#
#.........#
#.........#
#.........#
d....e....#
#.........#
#.........#
#.........#
#.........#
#####.#####
boss
enemies 1

