5
2
#####D#####
#......#..#
#.....#...#
#.....#...#
#.........#
D.........#
#.#.......#
#.........#
##........#
#........X#
###########

2
1
#####D#####
#k........#
#.........#
#..###....#
#..###....#
D...#.....l
#.#.......#
#...#.....#
#.........#
#.........#
#####D#####
key : 0

3
3
###########
#.#......e#
#.##..#...#
#.#.###...#
#.#.###...#
D....#....#
#.........#
#.....#...#
#.........#
#.........#
###########
enemies 1

0
2
###########
#........k#
#.........#
#.##..#...#
#...##.#..#
D..###.#..#
#..#.#....#
#..#.#.#..#
#.........#
#.........#
#####D#####
key : 9

3
2
#####D#####
##.....#..#
#.........#
#.........#
#...#..#..#
d.........D
#.........#
#...#..#..#
#.........#
#.........#
#####l#####

4
2
#####l#####
#.........#
#.........#
#.........#
#.........#
D....e....#
#.........#
#.........#
#.........#
#.........#
#####D#####
locked : 6
boss
enemies 1

4
1
#####D#####
#.........#
##.#...#..#
#.........#
#..#.#....#
D.........D
#..#.#.#..#
#.........#
##.#...#.##
#.........#
#####D#####

2
0
#####D#####
#.........#
#.........#
#.........#
#....#....#
#....@....D
#.........#
#.........#
#.........#
#.........#
#####D#####

1
1
#####D#####
#......##.#
#...#.....#
#...#####.#
#....####.#
D.........d
#.........#
#.........#
#.........#
#.........#
#####D#####

3
1
#####D#####
#k........#
#.##......#
#.#.......#
#.......#.#
D.........d
#.......#.#
#.#.......#
#..#......#
#.........#
#####D#####
key : 1

1
0
#####d#####
#.........#
#.........#
#.......#.#
#.........#
#.....#...D
#.........#
#.........#
#.........#
#.........#
#####D#####

0
0
###########
#.........#
#.#.#.#.#.#
#.........#
#..#.#....#
#.........D
#...#...#.#
#.........#
#..#...#.##
#.........#
#####d#####

5
1
#####D#####
#..#...#..#
#..#..##..#
#..#e##...#
#..##.#...#
D.........D
#..#......#
#.#e#.....#
#.#.#.....#
#...e.....#
###########
enemies 3

0
1
###########
#....k....#
#.........#
#.........#
#......#..#
D....###..D
#.........#
#.........#
#.........#
#.........#
#####D#####
key : 6

5
0
#####d#####
#.........#
#.........#
#.........#
#.....#...#
#.........D
#.........#
#.#...#.#.#
#..#...#..#
#.........#
###########

2
2
#####D#####
#.........#
#..##..#..#
#..#####..#
#...#.##..#
l......#..#
#.........#
#.........#
#.........#
#.........#
#####D#####
locked : 1

4
0
#####D#####
####......#
#####.....#
###e##....#
#e#.##....#
#?........D
#.........#
#.........#
#.........#
#.........#
#####d#####
enemies 2
sign Beware what lurks ahead.

1
2
#####D#####
#.........#
#.........#
#.........#
#.........#
d.........#
#.........#
#.........#
#.........#
#.........#
#####D#####

3
0
#####D#####
#.........#
#.........#
#.........#
#.....#.#.#
#.........D
#.....##..#
#.........#
#.........#
#.........#
#####D#####

