3
0
#####.#####
#.........#
#......#..#
#....#..#.#
#....#....#
#.........l
#.......#.#
#.#.....#.#
#..#...#..#
#.........#
#####.#####

6
2
#####.#####
##.#...#..#
#.........#
#.#.#.#.#.#
#.........#
...#.#.#..#
#.........#
#.#.#.#...#
#.........#
##.#...#.k#
###########
key : 3

5
1
#####.#####
#.........#
#.........#
#.........#
#.........#
#..........
#.........#
#.........#
#.........#
#.........#
#####l#####

0
1
###########
#.........#
#.........#
#.........#
#.........#
d.........#
#.........#
#.#.......#
#..#......#
#.........#
#####.#####

5
3
###########
#.........#
#.#.....#.#
#.........#
#.........#
d....#....d
#.........#
#.........#
#.#.....#.#
#.........#
###########

0
0
###########
#.#.......#
#.........#
#.........#
#.....#...#
#.........d
#...#.#...#
#.........#
#.........#
#.........#
#####d#####

6
4
#####.#####
#.........#
#.........#
#.........#
#.........#
#.........#
#.........#
#.........#
#.........#
#X........#
###########

3
2
###########
#.......#.#
#.........#
#..#.#...##
#.........#
....#.#...#
#.........#
#....#...##
#.........#
#.#.......#
#####.#####

3
1
#####.#####
#.........#
#..#...#..#
#.#.....#.#
#.........#
l..........
#.........#
#.........#
#.........#
#.........#
#####l#####
locked : 0

5
4
###########
#.........#
#.....#...#
#....###..#
#....#....#
d....e....#
#.........#
#.........#
#.........#
#.........#
#####.#####
boss
enemies 1

4
2
#####.#####
#e.......?#
#.........#
#.........#
#.........#
.........e#
#.........#
#.........#
#.........#
#e........#
#####.#####
enemies 3
sign Turn back; you are not yet ready.

6
1
#####l#####
#.........#
#.#.#.#.#.#
#.........#
#..#.#....#
#..........
#.#...#.#.#
#.........#
#..#...#.##
#.........#
###########
locked : 2

4
0
#####.#####
#.........#
#.........#
#.#..#..#.#
#.........#
#..........
#..#..#...#
#.........#
#.........#
#k......#.#
###########
key : 1

1
0
#####d#####
#.........#
#......#..#
#.#.....#.#
#.........#
#..........
#.........#
#...#.....#
#.........#
#.......#.#
#####.#####

4
1
#####l#####
#.#.....#.#
#.........#
#.........#
#.#.....#.#
...........
#.........#
#....#....#
#.........#
#.........#
#####.#####
locked : 1

5
2
#####.#####
#k........#
#.........#
#.........#
#.........#
..........d
#.........#
#.........#
#.........#
#.........#
#####.#####
key : 2

2
1
#####.#####
#.........#
#.........#
#.........#
#.........#
....#.....#
#..#...#.k#
#........##
#.........#
#.........#
#####.#####
key : 0

2
0
#####.#####
##........#
#.........#
#.........#
#.........#
#...#@.....
#.#.......#
#.###.....#
#..##.....#
#..#......#
#####.#####

1
1
#####.#####
#.........#
#........?#
#..#..#..##
#........e#
..........#
#...#.....#
#.........#
#.........#
#..#.....##
#####.#####
enemies 1
sign A useful tool lies just ahead.

