6
1
#####.#####
#.........#
#.#.#.#...#
#.........#
#.#.#.#.#.#
..........#
#...#.#...#
#.........#
#...#.#.#.#
#.........#
###########

5
0
#####.#####
####......#
#e........#
###..#....#
#e#.##....#
#e........d
#.........#
#.........#
#.........#
#.........#
#####.#####
enemies 3

2
1
#####.#####
#.........#
#.........#
#.........#
#.........#
#..........
#.........#
#.........#
#.........#
#.........#
#####l#####
locked : 0

2
3
###########
#.......ee#
#........e#
#.........#
#.........#
..........#
#.........#
#.........#
#.........#
#.........#
#####.#####
enemies 3

3
2
#####.#####
#.........#
#......#..#
#.......#.#
#.........#
l.........d
#.........#
#.#.....#.#
#..#...#..#
#.........#
#####.#####
locked : 2

0
2
###########
#X........#
#.........#
#.........#
#.........#
#.........#
#.........#
#.........#
#.........#
#.........#
#####.#####

3
1
#####l#####
#k........#
#.........#
#.........#
#.........#
..........l
#.........#
#.#.......#
#..#......#
#.........#
#####.#####
key : 2

4
0
#####.#####
#.........#
#...#..#..#
#.........#
#.........#
#..........
#.........#
#.........#
##..#..#..#
#k........#
#####.#####
key : 1

4
2
#####.#####
#.........#
#.....##..#
#.......#.#
#.........#
..........#
#.........#
#.........#
#.....#...#
#.........#
#####.#####

5
2
#####.#####
#.........#
#.........#
#.....#...#
#.........#
..........#
#.........#
#.........#
#.........#
#.........#
###########

6
0
#####.#####
#.........#
#..#......#
#..#####..#
#...@#....#
#..#.###...
#..###.#..#
#......#..#
#..##..#..#
##........#
#####.#####

4
1
#####.#####
#.........#
#.#.......#
#.........#
#.........#
...........
#.........#
#.........#
#.......#.#
#.........#
#####l#####
locked : 1

3
3
#####.#####
#.........#
#.........#
#.........#
#.####....#
d...#.....#
#.##...#..#
####.#....#
###.......#
#.........#
###########

2
2
#####d#####
#.........#
#.........#
#.........#
#.........#
....####...
#...k#.##.#
#...#..#..#
#...#.#...#
#.........#
#####.#####
key : 5

1
1
###########
#e?.......#
#e........#
#.........#
#.........#
#..........
#.........#
#.........#
#.........#
#.........#
#####.#####
enemies 2
sign Seek the matching key before you proceed.

5
1
#####l#####
#.........#
#.........#
#.........#
#.........#
d..........
#.........#
#.........#
#.........#
#.........#
#####.#####

7
0
#####.#####
#.........#
#.........#
#.........#
#.........#
#.........#
#.........#
#.......#.#
#......#..#
#k........#
###########
key : 0

3
0
###########
#.........#
#.........#
#...###...#
#....#....#
#....#.....
#.........#
#.........#
#.........#
#.........#
#####.#####

1
2
#####.#####
#.........#
#..#......#
#...##....#
#.#####...#
.....e....#
#.#####...#
#.##.##...#
#.........#
#.........#
#####d#####
boss
enemies 1

