0
3
###########
#ee.......#
#e........#
#?........#
#.........#
#.........D
#....###..#
#....#....#
#.....##..#
#.........#
#####D#####
enemies 3
sign The dungeon remembers all who enter.

0
0
###########
##.#...#..#
#.........#
##.#.#....#
#.........#
#..#.#....D
#.........#
##.#.#...##
#.........#
#........##
#####D#####

1
2
###########
#.........#
#......#..#
#.......#.#
#.........#
D.........D
#.........#
#.........#
#.........#
#.........#
#####D#####

1
3
#####D#####
#.........#
#..#......#
#.#.......#
#.........#
D.........d
#.........#
#.........#
#.........#
#.........#
#####d#####

2
2
#####D#####
#.......#e#
#.....###.#
#.....###.#
#...#..#..#
D.........l
#.........#
#.........#
#.........#
#....?....#
###########
enemies 1
door 0 : 0 1
sign Only the prepared may pass.

0
4
###########
#........X#
#.........#
#.........#
#.........#
D.........#
#.........#
#.........#
#.........#
#.........#
#####D#####

1
4
#####D#####
#.........#
#.........#
#.........#
#.........#
d....e....#
#.........#
#.........#
#.........#
#.........#
#####D#####
boss
enemies 1

3
0
#####D#####
#.........#
#.........#
#......#..#
#k#.......#
#.........D
#.........#
#.#.......#
#..#......#
#.........#
#####D#####
key : 2

1
0
#####D#####
#.........#
#.........#
#.........#
#.........#
#....@....D
#.........#
#.........#
#.........#
#.........#
#####D#####

2
1
#####D#####
#.........#
#..#...#.##
#.........#
#....#....#
d.........D
#..#.#.#..#
#.........#
##.#...#.##
#.........#
#####D#####

0
1
###########
#.......ee#
#...#....s#
#..##....?#
#.........#
D.........#
#....#....#
#.........#
#.........#
#.........#
#####D#####
enemies 2
switch 0 : 0 1
sign Those who search shall find.

2
4
#####D#####
#.........#
#.........#
##........#
#.........#
D.........D
#......#..#
#.........#
#.........#
##.....#..#
###########

2
5
###########
#.........#
#......#..#
#.......#.#
#...#.....#
D.........#
#.........#
#.#..#....#
#..#......#
#.........#
###########

4
0
#####D#####
#.........#
#.........#
#.........#
#.........#
#.........#
#.........#
#.........#
#.........#
#k........#
###########
key : 4

3
3
#####d#####
#.......#.#
#.........#
#.........#
#.#..#....#
#.........#
#.........#
#.#.......#
#.........#
#.........#
###########

2
3
#####d#####
#.........#
#..#...#..#
#.#.....#.#
#.........#
l.........D
#.........#
#.#.......#
#..#......#
#.........#
#####d#####
locked : 0

1
1
#####D#####
#k........#
#####.....#
#####.....#
#.#.#.....#
D.........D
#.........#
#.........#
#.........#
#.........#
#####D#####
key : 0

2
0
#####D#####
#.........#
####......#
#.###.....#
#...#.....#
#...#.#...d
#.###.#...#
#.........#
#.........#
#.........#
#####D#####

3
1
#####D#####
#.........#
#.........#
#.........#
#...#.....#
D...###...#
#..#.###..#
#....###..#
#..##..#..#
#......#.k#
###########
key : 3

