4
1
#####.#####
#..#......#
#.###.....#
#.####....#
#..##.....#
#....#.....
#.........#
#.........#
#.........#
#k........#
###########
key : 1

6
4
#####.#####
#.........#
#...#.#...#
#...#.#...#
#...##.#..#
#..#...#..#
#..#.#.#..#
#.........#
#.........#
#X........#
###########

2
0
###########
#.........#
#.........#
#.........#
#....#....#
#..#.@.....
#...#.....#
#.........#
#.........#
#.........#
#####.#####

2
1
#####d#####
#.........#
#.........#
#.........#
#.........#
...........
#.........#
#.#.....#.#
#..#...#..#
#.........#
#####.#####

2
2
#####d#####
#.........#
#......#..#
#.......#.#
#.........#
...........
#.........#
#.......#.#
#......#..#
#.........#
#####.#####

4
3
#####.#####
#e.......e#
#.........#
#........##
#.........#
..........d
#..#......#
#.........#
#.........#
#e.#.....?#
#####.#####
enemies 3
sign What you seek is close.

3
0
#####.#####
#.........#
#..#......#
#.#.......#
#.........#
#..........
#.........#
#.......#.#
#......#..#
#.........#
###########

4
2
#####.#####
#.........#
#.#.#...#.#
#.........#
#.#...#.#.#
...........
#.#.#.....#
#.........#
#.......#.#
#....k....#
###########
key : 2

1
2
#####l#####
#.......#.#
#.........#
#.........#
#.........#
..........#
#.........#
#.#.....#.#
#..#...#..#
#.........#
#####d#####

3
1
#####.#####
#.#.......#
#..#......#
#.#.......#
#.........#
...........
#.........#
#.......#.#
#......#..#
#.........#
#####.#####

3
3
#####.#####
#k........#
#..#...#..#
#.#.....#.#
#.........#
...........
#.........#
#.#.......#
#..#......#
#..#......#
#####.#####
key : 3

4
4
#####.#####
#..#.....##
#.........#
#.........#
#..#..#...#
d.........#
#.........#
#........##
#.........#
#.........#
#####.#####

5
3
#####.#####
#.........#
#......#..#
#...####..#
#...#..#..#
#...##....d
#...#####.#
#.........#
#e........#
#e?.......#
###########
enemies 2
sign The dungeon remembers all who enter.

2
3
###########
#........e#
#..#......#
#...#.....#
#.#.......#
..........#
#.##......#
#.........#
#.........#
#.........#
#####.#####
enemies 1

0
2
###########
#.........#
#......#..#
#..#....#.#
#.......#.#
#.........#
#.........#
#.........#
#.........#
#.........#
#####l#####
locked : 1

1
1
###########
#.........#
#.........#
#.........#
#.........#
#..........
#.........#
#.........#
#.........#
#.........#
#####d#####

3
4
###########
#.#......k#
#.........#
#......#.##
#.........#
....#.#...#
#.........#
#..#......#
#.........#
#.......#.#
#####.#####
key : 4

5
4
#####.#####
#.........#
#.........#
#.........#
#.........#
d....e....#
#.........#
#.........#
#.........#
#.........#
#####.#####
boss
enemies 1

3
2
#####.#####
#.........#
#.###.....#
#..##.....#
#.#.#.....#
...........
#.........#
#.........#
#.........#
#.........#
#####.#####

