5
5
###########
#........X#
#......#..#
#......#..#
#.....p#..#
D.........#
#.........#
#.........#
#.........#
#.........#
###########

2
3
###########
#........k#
#.........#
#......#..#
#.........#
D.........#
#...#..#..#
#.........#
#.........#
##.....#..#
#####D#####
key : 1

6
3
#####D#####
##.#...#.##
#.........#
#...#.#.#.#
#.........#
#..#.#.#..D
#.........#
#e#.#.#.#.#
#.........#
#ee#...#..#
###########
enemies 3
door 0 : 0 1

4
3
#####d#####
#.........#
#.........#
#.........#
#.........#
D.........d
#.........#
#.......#.#
#......#..#
#.........#
#####l#####

1
1
###########
#.......se#
##..#.....#
#....##...#
#.....#...#
D..#......#
#.........#
#.........#
#.........#
#.........#
#####D#####
enemies 1
switch 0 : 0 1

2
0
#####D#####
#.##......#
#.........#
#.#.#.....#
#.........#
#....@....d
#.........#
#.........#
#.........#
#.........#
#####D#####

3
3
#####D#####
#k........#
#.........#
#..##.....#
#.##......#
D..#......D
#......#..#
#.....#...#
#.........#
#.........#
#####d#####
key : 2

3
0
#####D#####
#.........#
#.........#
#.........#
#.........#
#.........#
#.........#
#.........#
#.........#
#.........#
###########

5
3
#####l#####
#.........#
#......#..#
#.......#.#
#.........#
#.........l
#.........#
#.........#
#.........#
#.........#
#####D#####
locked : 1

4
2
#####D#####
###....#.##
###.......#
#...#.....#
#.#.......#
#.........D
#.........#
#.........#
#.........#
#.........#
###########

6
4
#####D#####
#......####
#......#..#
#.....###.#
#....##e..#
D....###..#
#.........#
#.....#...#
#.........#
#.......?e#
###########
enemies 2
sign This door will not yield without a key.

0
0
###########
#.........#
#......#..#
#.......#.#
#.........#
#.........#
#.........#
#.#.......#
#..#......#
#.........#
#####D#####

1
0
#####D#####
#.........#
#.........#
#.........#
#.........#
#.........D
#.........#
#.........#
#.........#
#.........#
#####D#####

2
1
#####D#####
#.........#
#.#.#.....#
#..####...#
#....##...#
d..#.##...D
#..#..#...#
#.....#...#
#..#......#
#.........#
###########

3
2
#####d#####
#.........#
#..#......#
#.#.......#
#.........#
#.........D
#.........#
#.#.....#.#
#..#...#..#
#.........#
#####D#####

3
4
###########
#........k#
#.........#
#.........#
#.........#
D.........#
#.........#
#.........#
#.........#
#.........#
#####D#####
key : 3

5
4
#####D#####
#.........#
#.........#
#.........#
#.........#
l....e....D
#.........#
#.........#
#.........#
#.........#
#####D#####
locked : 3
boss
enemies 1

2
2
###########
#......#k##
#..#...#..#
#.#.....#.#
#.........#
D.........D
#.........#
#.#.......#
#..#......#
#.........#
#####d#####
key : 0

4
4
#####D#####
#.........#
#......#..#
#.......###
#.........#
d.........#
#.........#
#.......#.#
#...#..##.#
#.........#
#####D#####

