2
4
###########
#........k#
#.........#
#.#.......#
#.........#
D.........#
#.........#
#.........#
#.........#
#.........#
###########
key : 4

1
1
#####D#####
#.........#
#.........#
#......#..#
#...#...#.#
#...e###..#
#....##.#.#
#....#....#
#...#.###.#
#.........#
#####l#####
locked : 1
boss
enemies 1

4
1
#####D#####
#.........#
#.........#
#.........#
#.........#
D.........D
#....#.#..#
#.........#
#......#..#
#......k..#
###########
key : 2

5
3
#####D#####
#.........#
#...#.#.#.#
#.........#
#....#.#..#
D.........#
#.#...#.#.#
#.........#
#..#...#.##
#.........#
###########

2
1
#####l#####
#.##......#
#.#.#.....#
#.#...#...#
#.#####...#
D..##.....#
#.........#
#.........#
#.........#
#.........#
#####l#####
locked : 0

3
2
###########
#.........#
#..#......#
#.#.......#
#....#....#
l.........d
#..#......#
#.#.......#
#..#......#
#.........#
#####D#####
locked : 2

1
3
###########
#e.....#ee#
#...#.....#
#...##....#
#.........#
#.........#
#.........#
#.........#
#.........#
#.........#
#####D#####
enemies 3

2
0
###########
#k........#
#..#.....##
#.........#
#.........#
#..#..#...D
#.........#
#.........#
#..#..#..##
#.........#
#####D#####
key : 1

3
3
#####D#####
#........##
#.........#
#.........#
#...#..#..#
d.........#
#.........#
#........##
#.........#
#.........#
#####D#####

3
1
#####l#####
####......#
#..#......#
#..#......#
#.##......#
D.........l
#.........#
#.........#
#.........#
#k........#
#####D#####
key : 0

0
1
###########
#X........#
#.........#
#.........#
#...#.....#
#.........#
#.........#
#.........#
#.........#
#.........#
#####D#####

3
0
#####D#####
#.........#
#.........#
#....###..#
#....#....#
#?...@....D
#.........#
#.........#
#.........#
#.........#
#####D#####
sign Those who search shall find.

2
3
#####D#####
#.........#
#.........#
#.........#
#.........#
#.........D
#.........#
#.......#.#
#......#..#
#.........#
#####D#####
door 0 : 0 1

5
2
#####D#####
#.........#
##.#...#.##
#.........#
#.#.#.#.#.#
#.........D
#..#.#.#..#
#.........#
#s#.#.#.#.#
#e........#
###########
enemies 1
switch 1 : 2

4
3
#####D#####
#e.......e#
#?#.....#.#
#.........#
#.........#
D..#..#...D
#.........#
#.........#
#.........#
#e.......s#
#####D#####
enemies 3
switch 0 : 0 1
sign Many have walked this path.

4
2
#####D#####
#.........#
#..#...#..#
#.#.....#.#
#.........#
D.........D
#.........#
#.#.......#
#..#......#
#.........#
#####D#####

4
0
#####D#####
#......##.#
#.....#.#.#
#....##...#
#....#....#
#..###.#..D
#......#..#
#...#.#...#
#...#..#..#
#..#...#..#
#####d#####

5
0
#####d#####
#.........#
#.........#
#.........#
#.........#
#.........#
#.........#
#.........#
#.........#
#.........#
###########

4
4
###########
#........e#
#.........#
#...#..#..#
#.........#
D.........#
#...#..#..#
#.........#
#.........#
#......#.e#
###########
enemies 2
door 1 : 2

