2
2
#####D#####
#.........#
#.........#
#....#....#
#..##.....#
l..##.....D
#.........#
#.........#
#.........#
#.........#
#####D#####
locked : 1

3
3
#####D#####
##........#
#.........#
#.........#
#...#.....#
D.........D
#.........#
##.....#..#
#.........#
#.........#
###########

1
0
###########
#.........#
#.........#
#.........#
#...@.....#
#....#....D
#.....###.#
#......####
#.....#...#
#.......p##
#####D#####

5
4
#####D#####
#.........#
#.###.#...#
#.###.#...#
#.#####...#
#.........#
#.........#
#.........#
#.........#
#X........#
###########

3
5
###########
#......##e#
#.....###.#
#......#..#
#...#.....#
D.........#
#.........#
#.........#
#.........#
#.........#
###########
enemies 1

3
4
###########
#?...e....#
#.........#
#.........#
#..#......#
D..#......D
#.........#
#.........#
#.........#
#.........#
#####d#####
enemies 1
sign Beware what lurks ahead.

4
1
#####l#####
#.........#
#..#...#..#
#.#..#..#.#
#.........#
#.........D
#.........#
#.......#.#
#.........#
#.........#
###########
locked : 2

1
3
###########
#.........#
#.#.#.#.#.#
#.........#
#....#.#..#
d.........#
#...#.#.#.#
#.........#
#..#...#.##
#.........#
#####D#####

1
2
#####d#####
#.........#
#......#..#
#.......#.#
#.........#
l.........d
#.........#
#.........#
#.........#
#.........#
#####D#####
locked : 3

3
2
#####D#####
#.........#
#.........#
#.#.......#
#.#k#.....#
D..#......D
#.........#
#.........#
#.........#
#.........#
#####D#####
key : 2

4
4
#####d#####
#.........#
#.........#
#....#....#
#.........#
#....e....#
#.........#
#...#.....#
#.........#
#.........#
#####D#####
boss
enemies 1

0
2
###########
#.........#
#......#..#
##......#.#
#.........#
D.........#
#.........#
#.#.....###
#..#...#..#
#.........#
#####d#####

1
1
#####D#####
#.........#
#......#..#
#.......#.#
#.........#
D.........l
#.........#
#.......#.#
#......#..#
#.........#
#####l#####
locked : 0

2
3
#####D#####
#.........#
#...p.....#
#.........#
#.........#
D.........#
#.........#
#.......p.#
#.........#
#.........#
#####D#####

4
2
#####D#####
#.........#
#.........#
#.........#
#.........#
D.........#
#.........#
#.........#
#.........#
#.........#
###########

3
1
#####D#####
#.........#
#......#..#
#.........#
#.........#
#k...#....D
#.........#
#.........#
#...#..#..#
#.........#
#####l#####
key : 1

2
1
#####l#####
#.........#
#.........#
#.........#
#.........#
D.........l
#.........#
#.........#
#.........#
#.........#
#####D#####

2
0
#####D#####
#.........#
#.........#
#.........#
#.........#
#.........D
#.........#
#.........#
#.........#
#k........#
###########
key : 0

0
1
###########
#k........#
#.........#
#.........#
#..#...#..#
#..###.#..D
#...###...#
#...##....#
#..##..#..#
#.........#
#####D#####
key : 3

