2
3
#####.#####
#.........#
#.........#
#.........#
#.........#
#?.........
#e........#
##........#
#.........#
#.........#
#####.#####
enemies 1
sign Those who search shall find.

0
4
###########
#........X#
#.........#
#.........#
#.........#
..........#
#.........#
#.........#
#.........#
#.........#
#####.#####

3
4
#####.#####
#.........#
##.#...#.##
#.........#
#..#.#.#..#
..........d
#..#.#.#..#
#.........#
##.#...#.##
#.........#
#####.#####

3
0
#####.#####
#.........#
#.........#
#.........#
#.........#
#.........#
#.........#
#.........#
#.........#
#.........#
#####.#####

5
0
#####.#####
#.........#
#..#...#..#
#.#.....#.#
#.........#
#.........#
#.........#
#.........#
#.........#
#.........#
###########

4
1
###########
#.........#
#.........#
#..#..#..##
#.........#
...........
#..#......#
#.........#
#.........#
#........##
###########

4
4
#####.#####
##.#...#.##
#.........#
#...#.#.#.#
#.........#
...#...#..#
#.........#
#.#.#.#.#.#
#.........#
##.#...#e##
###########
enemies 1

2
4
#####.#####
#.........#
#..#......#
#.#.......#
#.........#
..........#
#.........#
#.........#
#.........#
#.......#k#
#####.#####
key : 5

4
3
#####d#####
#.........#
#..#......#
#.#.......#
#.........#
l..........
#.........#
#.......#.#
#......#..#
#.........#
#####d#####
locked : 1

3
2
###########
#.........#
#.........#
#.........#
#.........#
#..........
#.........#
#.#.......#
#..#......#
#.........#
#####.#####

4
0
#####.#####
##........#
#...#.....#
#.........#
#.........#
#....@.....
#.........#
#.........#
#.........#
#.........#
#####.#####

4
2
#####.#####
#.........#
#.#.#.#.#.#
#.........#
#...#.#.#.#
..........l
#.#.#.#.#.#
#.........#
#.#.#.#.#.#
#...k.....#
###########
key : 1

5
3
#####d#####
#.........#
#.#.....#.#
#.........#
#.........#
#....#....#
#.........#
#.........#
#.........#
#.........#
###########

3
3
#####.#####
#.........#
#.........#
#.........#
#.........#
...........
#.........#
#.........#
#.........#
#.........#
#####d#####

3
5
###########
#.........#
##.#.....##
#.........#
#.#...#...#
d.........#
#..#.#.#..#
#.........#
#.#.#...#.#
#.........#
###########

2
0
###########
##.#...#.##
#k........#
##...#.#.##
#.........#
#..#.#.#..#
#.........#
##.#.#.#..#
#.........#
##.#...#.##
#####.#####
key : 0

0
3
###########
##.....#..#
#.........#
#.........#
#.#.....#.#
#..........
#.........#
#...#..#..#
#.........#
#.........#
#####d#####

1
3
#####d#####
#.........#
#.#.....#.#
#.........#
#....#.#..#
#.........l
#k#.#.#.#.#
#.........#
#..#...#.##
#.........#
#####.#####
key : 6

1
4
#####.#####
#.........#
#.........#
#.........#
#.........#
l..#.e#...#
#.##..#...#
#.#.###...#
#.#...#...#
#.##......#
#####.#####
locked : 6
boss
enemies 1

