1
4
###########
#e........#
#e........#
#.........#
#.........#
#..........
#.........#
#.........#
#.........#
#.........#
#####.#####
enemies 2

1
0
#####.#####
#.........#
#..#...#..#
#.#.....#.#
#.........#
#..........
#.........#
#.........#
#.........#
#.........#
#####.#####

4
1
#####.#####
#.........#
#.........#
#.........#
#.........#
#..........
#.........#
#.........#
#.........#
#k........#
###########
key : 2

2
5
#####d#####
#..#.....##
#.........#
#.........#
#..#..#...#
d..........
#.........#
#..#..#..##
#.........#
#.........#
###########

2
6
###########
#........e#
#.........#
#.........#
#.........#
..........#
#.........#
#.........#
#.........#
#......#..#
###########
enemies 1

3
2
#####.#####
#.........#
#.........#
#.........#
#.........#
d..........
#.........#
#.........#
#.........#
#.........#
#####l#####

3
1
#####.#####
#k........#
#.#.#.#.#.#
#.........#
#......#..#
..........d
#.#.......#
#.........#
#..#...#..#
#.........#
#####.#####
key : 1

2
0
#####.#####
#.........#
#.........#
#.........#
#.........#
#...#@#....
#..#?##...#
#....##...#
#.###.#...#
#.........#
#####.#####
sign What you seek is close.

1
5
#####.#####
#.........#
#.........#
#.........#
#...e.....#
.....#....#
#..#.#....#
#..###....#
#.........#
#.........#
#####d#####
boss
enemies 1

2
1
#####.#####
#.........#
#.........#
#.........#
#....#....#
..........l
#.........#
#..#......#
#.........#
#.........#
#####.#####

0
5
###########
#X........#
#.........#
#.........#
#.........#
#.........#
#.........#
#.........#
#.........#
#.........#
#####.#####

4
2
#####l#####
#.........#
#..#...#..#
#.#.....###
#.........#
..........#
#.........#
#.#.#.....#
#..#......#
#.........#
###########
locked : 1

3
3
###########
#.........#
#.........#
#.........#
#.........#
..........d
#.........#
#.........#
#.........#
##k.......#
###########
key : 3

3
4
#####l#####
#.........#
#..#......#
#.#.......#
#.........#
d.........#
#.........#
#.....#.#.#
#......#..#
#.........#
###########

2
4
#####.#####
#.........#
#......#..#
#.......#.#
#.........#
#.........d
#.........#
#.........#
#.........#
#.........#
#####l#####
locked : 3

3
0
#####.#####
#.........#
#.........#
#.....##..#
#....##...#
#..#..#....
#...##.#..#
#...##....#
#.#.......#
#k........#
###########
key : 0

1
1
###########
#.........#
#.....##..#
#.......#.#
#.........#
..........#
#.....#...#
#.#..#....#
#..#......#
#.........#
#####.#####

0
0
###########
#.........#
#..#...#..#
#.#.....#.#
#.........#
#.........#
#.........#
#.........#
#.........#
#.........#
#####.#####

2
2
###########
#.........#
#.........#
#.........#
#..#.##...#
l..##.....#
#.#.#.#...#
#...###...#
#.###.#...#
#.........#
#####.#####
locked : 0

