6
3
#####D#####
#.........#
#.........#
#...#..#..#
#.........#
D.........#
#...#..#..#
#.........#
#.........#
##......?e#
###########
enemies 1
sign Many have walked this path.

7
2
#####D#####
#..#......#
#..#......#
#.#.......#
#.........#
#.........#
#.........#
#.......#.#
#......#..#
#.........#
###########

3
1
#####D#####
#k........#
#.........#
#.........#
#.........#
D.........l
#.........#
#.......#.#
#......#..#
#.........#
#####D#####
key : 0

0
2
###########
#X........#
#.........#
###...#.#.#
#.....##..#
#..#......#
#.........#
#.........#
#.........#
#.........#
#####D#####

3
0
#####d#####
#..#......#
#..##.....#
#..##.....#
#..#......#
#e........D
#.........#
#.........#
#.........#
#........##
#####D#####
enemies 1

6
2
#####d#####
#.........#
#.........#
#.........#
#.........#
#.........D
#.........#
#.........#
#.........#
#.........#
#####D#####

4
2
#####D#####
#.........#
#.........#
#.........#
#.......#.#
D.........D
#.........#
#.#.......#
#.........#
#.........#
#####D#####

2
0
###########
#.........#
#......#..#
#.......#.#
#.........#
#.........D
#.........#
#.........#
#.........#
#.........#
#####d#####

2
3
###########
#.......#.#
#.........#
#.........#
#..#..#...#
l.........#
#.........#
#.#..#..#.#
#.........#
#.........#
#####D#####
locked : 1

3
3
#####D#####
#.........#
#.........#
#.........#
#.........#
D........k#
#.........#
#.........#
#.........#
#.........#
#####D#####
key : 3

4
1
#####D#####
#.........#
#..#......#
#.#.......#
#.........#
D.........D
#.........#
#.#.......#
#..#......#
#.........#
###########

5
2
#####D#####
#k........#
##.....#..#
#.........#
#.........#
#...#..#..d
#.........#
#.........#
##.....#..#
#.........#
#####d#####
key : 2

4
3
#####D#####
#.........#
#..#......#
#.#.......#
#.........#
D.........#
#.........#
#.........#
#.........#
#.........#
#####D#####

1
2
#####D#####
#.........#
##........#
#.........#
#.........#
#..#.e....#
#..####...#
#.####....#
#.#.#.....#
###.......#
#####l#####
locked : 3
boss
enemies 1

2
2
#####l#####
#.........#
#.........#
#.........#
#.........#
D.....##..l
#..##.##..#
#...#.....#
#..#......#
#.........#
#####l#####
locked : 2

3
2
#####l#####
#.........#
#.........#
#.........#
#.........#
l.........D
#.........#
#.#.....#.#
#..#...#..#
#.........#
#####D#####
locked : 0

4
0
#####D#####
#.........#
#.........#
#.........#
#.........#
#....@....D
#.........#
#.........#
#.........#
#?........#
###########
sign Many have walked this path.

2
1
###########
#....k....#
#.........#
#.........#
#.........#
D.........D
#.........#
#.........#
#.........#
#.........#
#####D#####
key : 1

5
3
#####D#####
#.........#
#...#.#.#.#
#.........#
#..#.#....#
d.........#
#.......#.#
#.........#
#..#...#.##
#.........#
#####D#####

