5
2
#####.#####
##.....#..#
#.........#
#.........#
#...#.....#
#..........
#.........#
#...#..#..#
#?........#
#e........#
###########
enemies 1
sign A useful tool lies just ahead.

0
0
###########
#.........#
#.........#
##..#..#..#
#.........#
#.........#
#....#..#.#
#.........#
#.........#
##.....#..#
#####.#####

2
2
#####d#####
#.........#
#.........#
#.........#
#.........#
....#......
#.........#
#.......#.#
#......#..#
#.........#
#####d#####

2
3
###########
#..#......#
#......#..#
#.......#.#
#....#....#
...#......#
#.........#
#.#.....#.#
#..#...#..#
#.........#
#####.#####

3
4
###########
#........k#
#......#..#
#.......#.#
#.........#
..........#
#.........#
#.#.....#.#
#..#...#..#
#.........#
#####.#####
key : 6

6
3
#####.#####
#.........#
#.........#
#.........#
#.........#
#.........#
#.........#
#...#.....#
#.........#
#X........#
###########

1
2
#####.#####
#.........#
#......#..#
#.......#.#
#.........#
#.........#
#.........#
#.#.....#.#
#..#...#..#
#.........#
#####d#####

4
2
#####.#####
#.........#
#..#...#..#
#k#.....#.#
#.........#
#.........l
#.........#
#.#.......#
#..#......#
#.........#
#####.#####
key : 2

4
4
#####.#####
#.........#
#..#......#
#.#.......#
#.........#
..........#
#.........#
#.........#
#.........#
#.........#
###########

4
3
#####.#####
##.#...#.##
#.........#
#.#.#...#.#
#.........#
l..#.#.#...
#.........#
#.#...#...#
#.........#
##.#...#.##
#####d#####
locked : 2

2
0
#####.#####
#k#.....#.#
#.........#
#.#.#.#.#.#
#.........#
#...#.#...l
#.........#
#.....#...#
#.........#
#.#.....#.#
#####.#####
key : 0

3
0
#####.#####
#.........#
#.........#
#.........#
#.........#
#..........
#.........#
#.........#
#e........#
#ee.......#
###########
enemies 3

2
1
###########
#.........#
#.........#
#.........#
#.........#
l..........
#.........#
#.........#
#.........#
#.........#
#####d#####
locked : 0

0
2
###########
#e.....?.e#
##..#..#..#
#e........#
#.........#
#.........#
#.........#
#.........#
#...#.....#
#.........#
#####.#####
enemies 3
sign Many have walked this path.

1
0
#####.#####
#..#.....##
#.....##..#
#.....##..#
#...##.#..#
#....@....#
#.........#
#.#.......#
#.........#
#.........#
#####.#####

5
3
#####d#####
#.........#
#.........#
#.........#
#.........#
.....e....#
#.........#
##........#
#........##
#.........#
#####.#####
boss
enemies 1

3
3
#####.#####
#k........#
##.#......#
#.........#
#..#.#.#..#
...........
#..#.#.#..#
#.........#
##.#...#.##
#.........#
#####.#####
key : 4

3
2
#####d#####
#.........#
#.........#
#.........#
#.........#
...........
#.........#
#.......#.#
#......#..#
#.#.......#
#####.#####

3
1
#####d#####
#.........#
#......#..#
#......##.#
#.........#
...........
#.........#
#.......#.#
#......#..#
#.........#
###########

