5
1
###########
#X........#
#.........#
#.........#
#.........#
#..........
#.........#
#.........#
#.........#
#.........#
###########

0
2
###########
#.........#
#.........#
#.........#
#.........#
..........#
#.........#
#.........#
#.........#
#.........#
#####d#####

3
1
#####.#####
#.........#
#......#..#
#.......#.#
#.........#
...........
#.........#
#.#.......#
#..#......#
#.........#
###########

1
1
#####.#####
#.........#
#......#..#
#.......#.#
#.........#
...........
#.........#
#.........#
#.........#
#.........#
#####d#####

0
1
###########
#es.......#
#e........#
#.........#
#.........#
#..........
#.........#
#.........#
#.........#
#.........#
#####.#####
enemies 2
switch 0 : 0 1

2
1
#####d#####
#.........#
##.....#..#
#.........#
#.........#
...........
#.........#
#.........#
##..#..#..#
#.........#
#####.#####

3
0
#####.#####
#.........#
#..#...#..#
#.#.....#.#
#.........#
#....#.....
#.........#
#.........#
#.........#
#.........#
###########

4
3
#####.#####
#.........#
#.........#
#.........#
#.........#
.........k#
#.........#
#.#.......#
#..#......#
#.........#
#####.#####
key : 4

2
2
#####l#####
#.........#
#.........#
#..#......#
#.#k#.....#
..........#
#.###.....#
##........#
#...#.....#
#.........#
#####l#####
key : 1

1
3
###########
#.........#
#......#..#
#.......#.#
#.........#
d.........#
#.........#
#.#.......#
#..#......#
#.........#
###########

3
2
#####l#####
#.........#
#.........#
#.........#
#.........#
...........
#.........#
#.#.......#
#..#......#
#.........#
#####.#####
locked : 1

1
2
#####d#####
#.........#
#..#......#
#.#.......#
#.........#
..........d
#.........#
#.#.....#.#
#..#...#..#
#.........#
#####l#####
locked : 0

3
3
###########
#.........#
#.......#.#
#.........#
#.........#
...#..#...#
#.........#
#.........#
#.........#
#.........#
#####.#####

2
0
#####.#####
#.........#
#.........#
#.........#
#.........#
#?...@.....
#.........#
#.........#
#.........#
#.........#
#####.#####
sign A useful tool lies just ahead.

4
2
#####.#####
#?........#
#.........#
#.........#
#.........#
#e.........
#.........#
#.........#
#.........#
#.........#
#####d#####
enemies 1
sign Seek the matching key before you proceed.

5
2
#####d#####
#.........#
#.##..#...#
#.###.....#
#.##......#
....#e#....
#.##..#...#
#.........#
#.........#
#.........#
#####.#####
boss
enemies 1

5
3
#####.#####
#.........#
#.........#
#.........#
#..#......#
...##.....#
#.##......#
#.#.#.....#
#.....#...#
#........e#
###########
enemies 1
door 0 : 0 1

6
2
#####.#####
#.........#
#.........#
#.........#
#.........#
#.........#
#.........#
#.#.......#
#..#......#
#k........#
###########
key : 5

1
0
###########
#k#.......#
#.........#
#.........#
#..#......#
#..........
#.........#
#....#....#
#.........#
#.........#
#####.#####
key : 0

