4
4
###########
#.......ee#
#.#.......#
####......#
#.##......#
D.........#
#.........#
#.........#
#.........#
#.......?e#
###########
enemies 3
door 0 : 0
sign Many have walked this path.

4
0
#####D#####
#.........#
#.........#
#..##.....#
#.........#
#...#@....D
#.##......#
##........#
#.........#
#.........#
#####D#####

1
2
#####D#####
#.........#
#.........#
#.........#
#.........#
l....e....#
#.........#
#.........#
#.........#
#.........#
#####D#####
locked : 3
boss
enemies 1

1
1
###########
##........#
#k........#
#...#.#.#.#
#.........#
#..#.#.#..l
#.........#
#.#.#.#.#.#
#.........#
##.......##
#####D#####
key : 2

3
1
#####D#####
#e........#
#.........#
#.........#
#.........#
D.........D
#.........#
#.........#
#.........#
#e........#
#####D#####
enemies 2

4
2
#####D#####
#.........#
#.........#
#.........#
#.........#
D.........d
#.........#
#.........#
#.........#
#.........#
#####d#####

5
0
#####D#####
#.........#
#.........#
#.........#
#.........#
#.........D
#.........#
#?........#
#s........#
#e........#
###########
enemies 1
switch 0 : 0
sign What you seek is close.

4
3
#####d#####
#.........#
#.........#
#........##
#.........#
d.........D
#...#..#..#
#.........#
#.........#
#..#.....##
#####d#####

0
2
###########
#Xp.......#
#.........#
#.........#
#.........#
#.........#
#.....#...#
#.....###.#
#.......#.#
#.........#
#####D#####

4
1
#####D#####
#.........#
#.#...#...#
#.........#
#..#.#....#
D.........D
#.#...#.#.#
#.........#
#..#.....##
#.........#
#####D#####

5
1
#####D#####
#k#.......#
#.##......#
#.##..#...#
#.##......#
D.........D
#..####...#
#.........#
#.........#
#.........#
###########
key : 1

2
2
#####D#####
#.........#
#.........#
###.......#
#.........#
D.........D
#.###.....#
#.#.#.....#
#.........#
#.........#
#####D#####

3
2
#####D#####
#.........#
#..#...#..#
#.#.....#.#
#...#.....#
D..#......D
#..#......#
#.#.......#
#..#......#
#.........#
#####D#####

3
0
###########
#k........#
#.........#
##..#.....#
#.........#
#.........D
#.#..#..#.#
#.........#
#.........#
##........#
#####D#####
key : 0

5
2
#####d#####
#.........#
#.........#
#.........#
#.........#
D...#.....D
#...#.....#
#..##.....#
#.........#
#.........#
###########

2
1
#####D#####
#e........#
#.........#
#.........#
#.........#
#e........D
#.........#
#.........#
#.........#
#.........#
#####D#####
enemies 2

5
3
#####d#####
#.........#
#.........#
#.........#
#.........#
D.........#
#.........#
#.........#
#.........#
#.........#
###########

3
3
#####D#####
#.........#
#..#..#...#
#.........#
#.........#
D.....#...#
#.........#
#.........#
#..#..#..##
#.........#
#####d#####

2
3
###########
#........k#
#.#.#...#.#
#.........#
#.#...#...#
D.........#
#...#.#.#.#
#.........#
#.#.#...#.#
#.........#
#####D#####
key : 3

