0
0
###########
#k........#
#......#..#
#.......#.#
#.........#
#.........#
#.........#
#.........#
#.........#
#.........#
#####.#####
key : 0

3
1
#####.#####
#.......#.#
#.........#
#.........#
#.#.......#
...........
#.........#
#.#.....#.#
#.........#
#.........#
###########

1
3
###########
#.........#
#.........#
#..#.###..#
#...#.....#
...##.##...
#..###.#..#
#...##.#..#
#.........#
#.........#
#####.#####

3
2
#####l#####
#.........#
#.........#
#.........#
#.........#
...........
#.........#
#.#.....#.#
#..#...#..#
#.........#
###########
locked : 2

2
1
#####.#####
#......#..#
#.....###.#
#.....##..#
#.........#
...#..#...d
#.##e##...#
#.?####...#
#.##......#
#e##......#
#####.#####
enemies 2
sign The brave are rewarded.

1
4
###########
#.......ee#
#.#......e#
#.........#
#.........#
...#..#...#
#.........#
#.........#
#.#.....#.#
#.........#
#####.#####
enemies 3

5
0
#####.#####
#.........#
#.........#
#......#.##
#.........#
#..#.#.#..#
#....#..#.#
#..##.##..#
#..##.#...#
#k........#
###########
key : 2

2
4
#####.#####
##.....#..#
#.........#
#.........#
#.#..#....#
..........#
#.........#
#...#..#..#
#.........#
#........k#
###########
key : 3

2
3
#####.#####
#.........#
#..#.....##
#.........#
#.........#
l...#......
#.........#
#.........#
#........##
#.........#
#####l#####
locked : 0

1
1
###########
#....k....#
#.........#
#.........#
#....##...#
...........
#..#.#.#..#
#..#......#
#...#..#..#
#.........#
#####.#####
key : 1

2
0
#####.#####
#.........#
#.........#
#.........#
#.........#
#..#.@.....
#?#.......#
###.......#
#.........#
##........#
#####.#####
sign The dungeon remembers all who enter.

1
2
###########
#.........#
#......#..#
#.......#.#
#.........#
...........
#.........#
#.........#
#.........#
#.........#
#####d#####

1
0
#####.#####
#.........#
##.#.....##
#.........#
#..#.#.#..#
#..........
#.........#
#.........#
##.#...#.##
#.........#
#####.#####

3
3
#####l#####
#.........#
#.........#
#.........#
#.##e#....#
...###....#
#.#..#....#
##.#......#
##........#
#.........#
#####.#####
locked : 3
boss
enemies 1

4
0
#####d#####
#.........#
##.#...#.##
#.........#
#..#...#..#
#.........#
#..#.#....#
#.........#
##.#...#.##
#.........#
#####.#####

2
2
#####d#####
#..#...#.##
#.........#
#.#.#.#.#.#
#.........#
d..#...#..l
#.........#
#...#.#.#.#
#.........#
##.#......#
#####l#####

4
3
#####.#####
#.........#
#.........#
#.........#
#.........#
#.........#
#.........#
#.........#
#.........#
#X........#
###########

3
0
#####.#####
#.........#
#.........#
#.........#
#.........#
#..........
#.........#
#.........#
#.........#
#.........#
#####d#####

