1
1
###########
##e#?....##
#e........#
##...#.#..#
#e........#
#..#...#..d
#.........#
##.#.#.#.##
#.........#
##.......##
#####D#####
enemies 3
sign Something glints behind that door…

4
1
#####D#####
#.........#
#.........#
##.#......#
#..#......#
#..#......#
#..#......#
#.###.p...#
#.........#
#.........#
#####D#####

3
1
#####D#####
#.........#
#.........#
#.........#
#.........#
#.........#
#.........#
#.........#
#.........#
#.........#
#####D#####

4
3
###########
#.........#
#.........#
##..#..#..#
#.........#
#.........d
#...#.....#
#.........#
#.........#
#......#..#
#####d#####

5
2
###########
#..#e....##
#.........#
#.#...#.#.#
#.........#
D..#.#....D
#.........#
#.#.#.#.#.#
#.........#
#..#s?.#e##
###########
enemies 2
switch 0 : 0
sign Those who search shall find.

5
4
#####D#####
#.........#
#.#.......#
#.........#
#...#.....#
l.........#
#.........#
#.#.......#
#..#......#
#.........#
#####D#####
locked : 1

4
4
###########
#.........#
#...#..#..#
#.........#
#.........#
d....#....#
#.........#
#.........#
##..#..#..#
#.........#
#####D#####

2
1
#####D#####
#.........#
#.........#
#....#....#
#...##....#
#..#k#....D
#.....#...#
#...#.....#
#...#.....#
#.........#
#####D#####
key : 1

6
0
#####D#####
#.........#
#.........#
#.........#
#.........#
#.........#
#.........#
#.........#
#.........#
#.........#
###########

0
3
###########
#X........#
#.........#
#.........#
#.........#
#.........#
#.........#
#.........#
#.........#
#.........#
#####D#####

5
1
#####D#####
#.........#
#.........#
#.........#
#.........#
D.........D
#.........#
#...#.....#
#.........#
#....k....#
###########
key : 0

6
4
#####D#####
##.#...#.##
#.........#
##.#.#.#..#
#.........#
D..#.#.#..#
#.........#
##.#.#.#.##
#.........#
##.#...#.##
###########

2
2
#####D#####
#.........#
#.........#
#..#..#..##
#.........#
D.........D
#..#..#...#
#.........#
#.........#
#..#k.....#
###########
key : 2

5
3
#####d#####
##.....#..#
#.........#
#.........#
#....#....#
D.........l
#.........#
##.....#..#
#.........#
#.........#
#####D#####

5
0
###########
#?........#
#...#.....#
#.........#
#.........#
#....@.#..D
#.........#
#.........#
#.........#
#.........#
#####D#####
sign Something glints behind that door…

6
3
#####D#####
##.....####
#.....#####
#.#.#.###.#
#..##.#.#.#
#.........D
#.........#
#.........#
#e..#.....#
#e..e.....#
###########
enemies 3
door 0 : 0

1
3
#####D#####
#.........#
#.........#
#..#...##.#
#.....#...#
d....e.#..#
#.........#
#.........#
#.........#
#.........#
#####D#####
boss
enemies 1

1
2
###########
#.........#
#.........#
#.........#
#.........#
d.........d
#.........#
#.........#
#.........#
#.........#
#####D#####

2
3
#####D#####
#.........#
#.........#
#.........#
#.........#
D.........#
#.........#
#.........#
#.........#
#........k#
###########
key : 4

