0
1
###########
#e.......e#
#?........#
#.........#
#....##...#
#......#..#
#......#..#
#.....##..#
#.....#...#
#.........#
#####.#####
enemies 2
sign Beware what lurks ahead.

2
3
#####d#####
#.........#
#..#...#.##
#.........#
#.#.#.#...#
..........#
#..#.#.#..#
#.........#
#...#.#.#.#
#.........#
#####.#####

1
2
###########
##........#
#####.....#
##.#.#....#
#..#.#....#
d..#.......
#.........#
#.........#
#.........#
#.........#
#####.#####

5
2
#####.#####
#.........#
#.........#
#.........#
#.........#
#..........
#.........#
#........##
#e#.......#
#e?.......#
###########
enemies 2
sign The brave are rewarded.

2
0
#####.#####
#.........#
#..#......#
#k##......#
#.........#
#.........#
#...#.....#
#...#.....#
#.........#
#.........#
#####.#####
key : 0

4
2
#####.#####
#.........#
#.........#
#.........#
#..#......#
#k........d
#.........#
#.........#
#......#..#
#.........#
#####.#####
key : 3

1
4
###########
#.........#
##..#..#..#
#.........#
#.........#
l....#....#
#.........#
#.........#
##..#..#..#
#.........#
###########
locked : 2

0
3
###########
#.........#
#......#..#
#.......#.#
#.........#
#.........#
#.........#
#.......#.#
#......#..#
#.........#
#####.#####

1
1
#####.#####
#.........#
#.........#
#.........#
#.........#
..........d
#.........#
#.........#
#.........#
#.........#
###########

2
2
#####.#####
#.#.....#.#
#.........#
#.#.#.#.#.#
#.........#
#.....#....
#.........#
#...#.#.#.#
#.........#
#.........#
#####.#####

4
0
#####.#####
#.........#
#..#...#..#
#.#.....#.#
#.........#
#.........#
#.........#
#.#.......#
#..#......#
#.........#
###########

4
3
#####.#####
#.........#
#.........#
#.........#
#.........#
d....e....#
#.........#
#.........#
#.........#
#.........#
#####.#####
boss
enemies 1

5
3
#####.#####
#.#.......#
#.........#
#..#......#
#.#.......#
...##.....#
#...#.....#
#.#.......#
#.........#
#........X#
###########

3
0
#####.#####
#.........#
#.........#
#.........#
#.........#
#k.........
#.........#
#.........#
#.........#
#.........#
#####.#####
key : 1

3
3
#####.#####
#.........#
#.........#
#.........#
#.........#
d.........#
#.........#
#.#.....#.#
#..#...#..#
#.........#
#####.#####

3
2
#####.#####
#k........#
#..#......#
#.#.......#
#.........#
..........d
#.........#
#.#.......#
#..#......#
#.........#
#####.#####
key : 2

1
0
###########
#.........#
#.........#
#.........#
#.........#
#..#.@.....
#.#.......#
##.#......#
#.........#
#.........#
#####.#####

3
1
###########
#.........#
#.........#
#.........#
#.........#
...........
#.........#
#.....#.#.#
#.#....#..#
#.........#
###########

1
3
#####.#####
#.........#
#.........#
#.#..#..#.#
#.........#
..........l
#.....#...#
#.........#
#.........#
#e#.....#e#
#####d#####
enemies 2

