4
4
#####.#####
#.........#
#.........#
#.........#
#....##...#
.......#..#
#....###..#
#.........#
#.........#
#........e#
###########
enemies 1
door 0 : 0 1

2
2
#####d#####
#.........#
#.#...#.#.#
#.........#
#..#.#....#
...........
#.#...#...#
#.........#
#......#.##
#.........#
#####.#####

1
0
###########
#........e#
#.....##s##
#....#.####
#....#..#.#
#.........#
#.........#
#...#.....#
#.........#
#.........#
#####.#####
enemies 1
switch 0 : 0 1

3
2
#####.#####
#.#.....#.#
#.........#
#..#.#.#.##
#.........#
l...#.#....
#.........#
#..#.#.#..#
#.........#
#.#.....#.#
#####l#####
locked : 0

0
2
###########
#.##......#
#.##......#
#...###...#
#..##.....#
#..........
#.........#
#.........#
#.........#
#.........#
#####d#####

0
3
###########
#.#......X#
#.#.#.....#
#...#.....#
#.........#
..........#
#.........#
#.........#
#.........#
#.........#
#####.#####

4
3
#####l#####
#.........#
#.........#
#.........#
#.........#
...........
#.........#
#.#.......#
#..#......#
#.........#
#####.#####
locked : 3

3
4
###########
#.........#
#.........#
#.........#
#...####..#
d......#..#
#....#....#
#.........#
#.........#
#.........#
#####.#####

3
1
#####.#####
#.........#
#.........#
#.........#
#.........#
..........l
#.........#
#.#.......#
#..#......#
#..k......#
###########
key : 0

2
1
###########
#.........#
##.#...#.##
#.........#
#..#.#.#..#
...........
#..#.#.#..#
#.........#
##.#...#.##
#.........#
#####.#####

3
3
#####.#####
#k........#
#......#..#
#.......#.#
#.........#
..........d
#.........#
#.......#.#
#......#..#
#.........#
#####l#####
key : 1

4
2
#####l#####
#.........#
#.........#
#.........#
#.........#
#....#.....
#.........#
#...##....#
#.........#
#.........#
###########
locked : 1

1
2
#####d#####
#.........#
#..#....#.#
#.#.......#
#.........#
#.........d
#.........#
#.......#.#
#.........#
#........##
#####d#####

2
3
#####.#####
#.........#
#.........#
#..#..#..##
#........k#
..........#
#...#..#..#
#.........#
#.........#
#..#.....##
#####.#####
key : 3

4
0
#####.#####
#.........#
#.........#
#.........#
#.#.......#
#...#.....#
#..#......#
#####.....#
###.......#
#.........#
###########

5
3
#####.#####
##.#......#
#.........#
#.#.......#
#.........#
#.........#
#.........#
#.........#
#.........#
#k........#
###########
key : 4

3
0
#####.#####
#......#..#
#.....#..##
#....#.#..#
#...@..#..#
#....#.#...
#.........#
#....#.#..#
#.........#
#.........#
#####.#####

1
3
#####.#####
#.........#
#.........#
#.........#
#.........#
d....e....#
#.........#
#.........#
#.........#
#.........#
#####.#####
boss
enemies 1

2
0
#####.#####
#.#.....#.#
#.........#
#..#...#.##
#.........#
#.....#....
#.........#
#....#...##
#.........#
#.#.....#.#
#####.#####

