3
5
###########
#........k#
#.........#
#.#.....#.#
#.........#
D.........#
#..#..#...#
#.........#
#.........#
#.#.......#
###########
key : 5

1
5
#####d#####
#.........#
#...#.....#
#.........#
#.........#
d.........#
#...#.....#
#.#.....#.#
#..#...#..#
#.........#
###########

4
0
#####D#####
#.........#
#.........#
#.........#
#.........#
#.........#
#.........#
#.........#
#.........#
#k........#
###########
key : 1

1
3
###########
#.........#
#.........#
#.........#
#.....###.#
D.........D
#....##e#.#
#....#e#?##
#........##
#........e#
#####d#####
enemies 3
door 0 : 0 1
sign Seek the matching key before you proceed.

1
4
#####D#####
#.........#
#...#.....#
#..##.....#
#.........#
D...###...d
#...##....#
##..###...#
#......#..#
#.........#
#####D#####

2
3
#####d#####
##.#...#.##
#.........#
#.#.#.#.#.#
#.........#
D..#......D
#.........#
#.#...#...#
#.........#
#..#...#.##
###########

2
4
#####D#####
#.#.....#.#
#.........#
#..#.#.#..#
#.........#
D...#.....#
#.........#
#..#.#...##
#.........#
#.#.....#.#
#####d#####

2
2
#####l#####
##.......##
#.........#
#.#.#...#.#
#.........#
D....#.#..D
#.........#
#.#.#.#.#.#
#.........#
##k#.....##
###########
key : 2

3
1
#####D#####
#.........#
#..#..#..##
#.........#
#.........#
D..#......#
#.........#
#.........#
#..#..#..##
#........k#
###########
key : 0

0
4
###########
#.........#
#.........#
#.........#
#.........#
#.........D
#.........#
#.#.......#
#..#......#
#.........#
#####D#####

2
0
#####D#####
#.........#
#.........#
#.........#
#.........#
#?...@....D
#.........#
#.........#
#.........#
#.........#
#####D#####
sign Beware what lurks ahead.

0
5
###########
#.........#
#.#.#.#...#
#.........#
#.#.#...#.#
D.........#
#.#.#.....#
#.........#
#.#...#.#.#
#.........#
#####d#####

2
1
#####l#####
#.........#
#......#..#
#.......#.#
#.........#
D.........D
#.........#
#.......#.#
#......#..#
#.........#
#####D#####

3
0
#####D#####
#.......#.#
#.........#
#.#.#.#.#.#
#.........#
#...#.#...D
#.........#
#.#.#.#.#.#
#.........#
#.#.......#
#####D#####

3
4
#####d#####
#.#.......#
#..##.....#
#..##.....#
#.........#
#....e....D
#.........#
#.........#
#.........#
#.........#
#####D#####
boss
enemies 1

1
2
###########
#.........#
#..#..#..##
#.........#
#.........#
D..#..#...D
#.........#
#.........#
#..#..#..##
#.........#
#####l#####
locked : 0

4
4
#####D#####
#.........#
#.........#
#.........#
#.........#
#...##....#
#...###...#
#.........#
#.........#
#X........#
###########

1
0
###########
#e#.....#.#
#?s.......#
#e#.#.#.#.#
#.........#
#...#.#...D
#.........#
#...#.#.#.#
#.........#
#.#.....#.#
#####D#####
enemies 2
switch 0 : 0 1
sign Seek the matching key before you proceed.

1
1
###########
#.........#
#.p.......#
#.........#
#.###.....#
D..##.....D
#.##......#
###.#.....#
##........#
#.........#
#####l#####
locked : 1

