3
0
#####.#####
#.........#
#.........#
#.........#
#.........#
#..##......
#.#.#.....#
#...#.....#
#..##.....#
##.#......#
###########

5
1
#####.#####
#.........#
#.........#
#.........#
#.........#
#.........#
#.........#
#.#.......#
#..#......#
#.........#
###########

1
1
#####.#####
#.#.....#.#
#.........#
#.........#
#.....#...#
d..........
#.........#
#.#..#..#.#
#.........#
#.........#
#####d#####

1
4
#####.#####
#......#..#
#......##.#
#.....##..#
#.........#
.....e....#
#.........#
#.........#
#.........#
#.........#
#####d#####
boss
enemies 1

1
2
###########
#......#..#
#.....#...#
#......#..#
#.........#
...........
#.........#
#.........#
#.........#
#.........#
#####l#####
locked : 0

1
0
#####.#####
#.........#
#?###.....#
###.#.....#
#...#.....#
#..#@#....d
#.#..#....#
#..#.#....#
#.........#
#.........#
#####.#####
sign What you seek is close.

3
3
#####.#####
#.........#
#..#..#..##
#.........#
#.........#
d..#..#...#
#.........#
#.........#
#..#..#..##
#.........#
###########

2
1
#####d#####
#.........#
##.....#.##
#.........#
#..#...#..#
..........l
#..#.#....#
#.........#
#..#...#.##
#.........#
#####.#####

0
1
###########
#........k#
#.........#
#.........#
#.........#
..........#
#.........#
#.......#.#
#......#..#
#.........#
#####.#####
key : 1

1
3
###########
#.........#
#......#..#
#.......#.#
#.........#
...........
#.........#
#.........#
#.........#
#.........#
#####l#####
locked : 3

0
4
###########
##X#......#
#...#.....#
#.####....#
#.####....#
#..##.....#
#.........#
#.........#
#..#......#
#.........#
#####.#####

2
3
#####l#####
#........k#
#..#.....##
#.........#
#.#.#.....#
...........
#..#.#.#..#
#.........#
#.#.#.#.#.#
#.........#
#####.#####
key : 3

0
0
###########
#k........#
#..#......#
#.#.......#
#.........#
#..........
#.........#
#.#.....#.#
#..#...#..#
#.........#
#####.#####
key : 0

3
1
#####.#####
#e.......e#
#?#...#.#.#
#.........#
#.#...#...#
...........
#...#.#.#.#
#.........#
#.....#.#.#
#e.......s#
#####.#####
enemies 3
switch 0 : 0 1
sign Something glints behind that door…

3
2
#####.#####
#.........#
#.........#
#.........#
#.........#
..........d
#.........#
#.#.......#
#..#......#
#.........#
###########

2
2
#####l#####
#..#.....##
#.........#
#.........#
#..#..#...#
l..........
#.........#
#.....#..##
#.........#
#.........#
#####.#####
locked : 1

2
0
#####.#####
#.........#
#.........#
#......#..#
#.........#
#..........
#.#..#....#
#.........#
#.........#
##.....#..#
#####.#####

2
4
#####d#####
#..#......#
#.........#
#.........#
#.........#
..........#
#.........#
#.........#
#........?#
#.......ee#
###########
enemies 2
door 0 : 0 1
sign Something glints behind that door…

4
1
#####.#####
#.........#
#.........#
#.....##..#
#...#####.#
#...#.##k.#
#.......#.#
#....#....#
#.........#
#.........#
#####.#####
key : 4

