1
2
###########
##....k#..#
#.........#
#.........#
#......#..#
D.........D
#.........#
##..#..#..#
#.........#
#.........#
#####D#####
key : 5

2
2
#####D#####
#.........#
#.........#
#..#..#..##
#.........#
l.........D
#...#..#..#
#.........#
#.........#
#........##
###########
locked : 1

2
0
#####D#####
#.........#
#.........#
#.........#
#.........#
#?...@....D
#.........#
#.........#
#.........#
#.........#
#####D#####
sign Something glints behind that door…

5
2
#####D#####
##.#.....##
#.........#
#.#.#.#.#.#
#.........#
D..#.#.#..#
#.........#
#.#.#.#.#.#
#........?#
##.#...#e##
###########
enemies 1
sign Turn back; you are not yet ready.

1
0
#####D#####
#.........#
#..#......#
#...#.#...#
#k####....#
#..##.#...d
#.........#
#.........#
#.........#
#.........#
#####D#####
key : 1

2
3
#####D#####
#.........#
#.........#
#...#..#..#
#.........#
D.........#
#.#..#..#.#
#.........#
#.........#
#.........#
#####D#####

4
0
#####D#####
#.........#
#.........#
#.........#
#.........#
#.........d
#.........#
#.#.....#.#
#..#...#..#
#.........#
#####l#####

3
1
#####D#####
#.........#
#.........#
#..#......#
#..#.#....#
D..###....#
#.........#
#.........#
#.........#
#.........#
#####d#####

4
2
###########
#........e#
#.........#
#.........#
#.........#
D..#......#
#..#......#
#.##......#
#.........#
#.........#
#####D#####
enemies 1
door 0 : 0

4
1
#####d#####
#.......#.#
#.........#
#..#.#.#..#
#.........#
d...#.#...D
#.........#
#..#.#.#.##
#.........#
#.#.......#
#####l#####

3
0
#####D#####
#.........#
#.........#
#.........#
#.........#
#k........D
#.........#
#.........#
#.........#
#.........#
#####D#####
key : 0

0
0
###########
#k........#
#.........#
#.........#
#.....###.#
#....#....#
#.....###.#
#.....##..#
#........##
#.........#
#####D#####
key : 2

3
3
#####D#####
#.........#
#.........#
#.........#
#.........#
#.........#
#.........#
#.........#
#.........#
#e.......s#
###########
enemies 1
switch 0 : 0

5
0
#####l#####
#.........#
#.........#
#.........#
#.........#
#.........D
#.........#
#.........#
#.........#
#.........#
###########
locked : 0

1
3
###########
#......#..#
#.........#
#.........#
#...#..#..#
D.........#
#.........#
##..#..#..#
#.........#
#.........#
#####D#####

5
1
#####l#####
#.........#
#......#..#
#.....#...#
#....##...#
D....e....D
#..#......#
#.........#
#.........#
#.........#
#####D#####
locked : 2
boss
enemies 1

6
1
#####D#####
#.........#
#.........#
#.........#
#.........#
#.........#
#.........#
#.........#
#.......p.#
#X........#
###########

2
1
#####D#####
#.........#
#.........#
#.........#
#.........#
D.........l
#.........#
#.#.....#.#
#..#...#..#
#.........#
#####D#####

1
1
###########
#.........#
#.......#.#
#.........#
#..#.#.#..#
d.........D
#.#...#.#.#
#.........#
#..#......#
#.........#
#####D#####

