5
1
#####D#####
#.........#
#.#.#.#.#.#
#.........#
#..#.#.#..#
D.........#
#.#...#.#k#
#.........#
#..#...#..#
#.........#
#####D#####
key : 0

2
3
#####d#####
#.........#
#..#......#
#.#.......#
#.........#
D.........#
#.........#
#.......#.#
#......#..#
#.........#
###########

1
3
#####D#####
#.........#
##........#
#.........#
#...##.##.#
D...#e....#
#...####..#
#......#..#
#......##.#
#.........#
#####d#####
boss
enemies 1

4
1
###########
#.........#
#..#......#
#.#.......#
#.........#
D.........D
#.........#
#.#.......#
##.#......#
#.........#
#####D#####

2
2
#####l#####
#.........#
#.........#
#.###.....#
#.##k.....#
D...#.....D
#.........#
#.........#
#.........#
#.........#
#####D#####
key : 3

0
3
###########
#X.....####
#.....#.###
#....#..###
#....#....#
#.....##..#
#.....###.#
#.........#
#.........#
#.........#
#####D#####

1
1
###########
#.........#
##........#
#.##......#
#.#.......#
d.........D
#.##......#
#.........#
#.........#
#.........#
#####D#####

3
2
#####D#####
#.##......#
#.........#
##.##.....#
#..#......#
#.........#
#.........#
#.........#
#.........#
#.........#
#####D#####

6
1
#####D#####
#.........#
#...#..#..#
#.........#
#.........#
#...#..#..#
#.........#
#.........#
##..#..#..#
#k........#
###########
key : 2

0
0
###########
#.........#
#.........#
#.........#
#.........#
#.........#
#.........#
#.#.....#.#
#..#...#..#
#.........#
#####d#####

2
0
#####D#####
#.........#
#.#.#...#.#
#.........#
#..#.#.#..#
#.........D
#k#.......#
#.........#
#......#..#
#.........#
#####D#####
key : 1

5
0
#####d#####
#......#..#
#.......#.#
#......#..#
#....#.#..#
#.........D
#..##.....#
#..###....#
#.........#
#.........#
###########

4
2
#####D#####
#e.#......#
#.........#
#.........#
#..#..#...#
D.........l
#.........#
#..#..#..##
#.........#
#?...e....#
###########
enemies 2
sign A locked path — look elsewhere first.

4
3
###########
#.........#
#......#..#
#.......#.#
#.........#
l.........#
#.........#
#.......#.#
#......#..#
#.........#
###########
locked : 0

3
0
#####D#####
#.........#
#.........#
#..#..#..##
#.........#
#.........#
#...#.....#
#.........#
#.........#
#..#.....##
#####D#####

4
0
#####D#####
#.........#
#.........#
#.........#
#.........#
#?...@....D
#.........#
#.........#
#.........#
#.........#
#####d#####
sign Beware what lurks ahead.

2
1
#####D#####
#.........#
#.........#
#####.....#
#.#.......#
D..###....D
#.#.##....#
###.#.....#
#.........#
#.........#
###########

1
0
#####d#####
#.........#
##.#...#..#
#.........#
#....#.#..#
#.........d
#..#.#.#..#
#.........#
#..#...#.##
#.........#
#####D#####

1
2
###########
#.........#
#.........#
#.........#
#.........#
D.........D
#.........#
#.........#
#.........#
#.........#
#####l#####
locked : 2

