7
1
#####D#####
#.........#
#.........#
#.....#..##
#.........#
D.........#
#..#......#
#.........#
#.........#
#..#.....##
###########

1
1
#####d#####
#.........#
#.........#
#.#..#..#.#
#.........#
#.........D
#.#..#..#.#
#.........#
#.........#
#.#.....#.#
#####d#####

5
0
#####D#####
#.........#
#.........#
#.....###.#
#.......#.#
#......#..D
#.........#
#.........#
#.........#
#.........#
#####D#####

4
2
###########
#.........#
#.........#
#.........#
#.........#
D.........#
#.........#
#.......#.#
#......#..#
#.........#
#####D#####

2
1
#####d#####
#.........#
#.........#
#.........#
#.........#
D.........D
#.........#
#.........#
#.........#
#.........#
#####D#####

5
2
#####D#####
#.........#
#.........#
#.........#
#.........#
D.........#
#.........#
#.........#
#.........#
#.......ee#
###########
enemies 2

2
2
#####D#####
#.........#
#.........#
#.........#
#.........#
D....#....#
#...#.....#
#..##.....#
#........e#
#......?ee#
###########
enemies 3
sign The dungeon remembers all who enter.

2
0
###########
#.........#
##.#......#
#.###.....#
#.###.....#
#...#.....D
#.#.#.....#
#.........#
#.........#
#.........#
#####l#####
locked : 1

3
1
#####D#####
##.#......#
#.........#
##.#...#.##
#.........#
l..#...#..#
#.........#
##...#.#..#
#.........#
##.#.....##
#####D#####
locked : 2

0
2
###########
#.##......#
#.#.......#
#..#......#
#.........#
d....e....#
#.........#
#.........#
#.........#
#.........#
#####D#####
boss
enemies 1

6
0
#####D#####
#.........#
#..#......#
#k#.......#
#.........#
#.........d
#.........#
#.........#
#.........#
#.........#
#####D#####
key : 2

4
1
#####D#####
#k........#
#.........#
#.........#
#.........#
D.........D
#.........#
#.#.......#
#..#......#
#.........#
#####D#####
key : 1

7
0
#####D#####
#.........#
#.#.......#
#.........#
#.........#
#.........D
#......#..#
#.........#
#.........#
#k........#
###########
key : 4

0
1
###########
#.........#
#..#.....##
#.........#
#.........#
#...#.....d
#.........#
#.........#
#..#..#..##
#.........#
#####d#####

1
2
#####D#####
#.........#
#.........#
#.........#
#.........#
D........X#
#.........#
#.........#
#.........#
#.........#
#####D#####

5
1
#####D#####
#.........#
##.#...#.##
#.........#
#....#.#..#
D.........D
#..#.#.#..#
#.........#
##.#...#.##
#.........#
#####D#####

4
0
#####D#####
##........#
#.........#
#.........#
#.........#
#....@....D
#.........#
#.........#
#.........#
#.......#?#
#####D#####
sign Something glints behind that door…

3
0
#####l#####
#......#..#
#..##.#...#
#..##.#...#
#..###....#
#..##.##..l
#..k#.....#
####......#
##.##.....#
#.........#
#####D#####
key : 0

6
1
#####D#####
#.........#
#......#..#
#.......#.#
#.........#
d.........#
#.........#
#.#.....#.#
#..#...#..#
#.........#
#####D#####

