5
1
#####D#####
#.........#
#......####
#....######
#.....#...#
d.....##..d
#.....###.#
#.......#.#
#.........#
#.........#
#####D#####

6
3
#####D#####
##........#
#.........#
#.........#
#.........#
D.........#
#.......#e#
#.........#
#........?#
#.......ee#
###########
enemies 3
door 0 : 0 1
sign Those who search shall find.

4
1
#####D#####
#.........#
#.......#.#
##........#
#.........#
D.........D
#.......#.#
#.#.....#.#
#..#...#..#
#.........#
#####D#####

3
1
#####D#####
#.........#
#.........#
#....###..#
#....#....#
d....###..D
#....##...#
#....##...#
#.........#
#.........#
#####D#####

3
0
#####D#####
#.##......#
#...#.....#
###.......#
#..#......#
#..##..#..d
#......#..#
#....#..#.#
#...#..##.#
#.......#.#
#####D#####

6
2
#####D#####
#.........#
#..#......#
#.........#
#.........#
D.....#...D
#.........#
#.........#
#..#..#..##
#........k#
#####D#####
key : 4

4
2
#####D#####
#.........#
#.........#
#.........#
#.........#
D........k#
#.........#
#.........#
#.........#
#.........#
#####D#####
key : 3

5
0
#####D#####
#.........#
#e##......#
#####.....#
#s.##.....#
#..#e#....d
#....#....#
#.........#
#.........#
#.........#
#####D#####
enemies 2
switch 0 : 0 1

7
2
#####D#####
#.........#
#.........#
#.........#
#.........#
#.........#
#...#.#...#
#.#.......#
#.###.....#
####......#
###########

5
2
#####D#####
##.#...#..#
#.........#
#...#.#.#.#
#.........#
d..#.#.#..d
#.........#
#.#...#.#.#
#.........#
##.#...#..#
#####D#####

6
0
#####D#####
#.........#
#...#.#...#
##.#.#....#
#.#.......#
#.........D
#.........#
#.........#
#.........#
#.........#
###########

5
3
###########
#.........#
#.........#
#.........#
#.........#
d.....#...#
#.....##..#
#.....#.#.#
#.........#
#.........#
#####D#####

1
1
#####D#####
#.........#
#.........#
#.........#
#.........#
#....e....#
#.........#
#.........#
#.........#
#.........#
#####l#####
locked : 2
boss
enemies 1

2
1
#####l#####
#.........#
#.........#
#.....#..##
#.........#
l.........#
#.....#...#
#.........#
#.........#
#..#.....##
#####D#####
locked : 1

0
1
###########
#X........#
#.........#
#.........#
#.........#
#.........#
#.........#
#.........#
#.........#
#.........#
#####D#####

4
0
#####D#####
#.........#
#.........#
#.........#
#.....#...#
#....@##..D
#..#.###..#
#..##.#...#
#.##..#...#
#?#.......#
#####D#####
sign This room feels watched.

3
2
###########
#.........#
#.........#
#.........#
#.........#
D.........#
#.........#
#.#.......#
#..#......#
#.........#
#####D#####

6
1
#####D#####
#........##
#...#..##.#
#....####.#
#.....###.#
D.....##..D
#.........#
#.........#
#..p......#
#..k......#
###########
key : 2

2
0
###########
#k........#
#.....p...#
#.........#
#.........#
#.........l
#.........#
#.........#
#.....p...#
#.........#
#####D#####
key : 1

