4
4
###########
#........k#
#.........#
#.........#
#.........#
.....##...#
#.###.#...#
#...#.#...#
#.##......#
#..#......#
###########
key : 4

3
1
#####l#####
#.........#
#.........#
#....#.#.##
#.........#
....#.#....
#.........#
#..#.#.#..#
#.........#
#.......#k#
#####.#####
key : 0

4
3
#####.#####
##.#...#..#
#.........#
##.....#.##
#.........#
d..#.#.#...
#.........#
##.#.#.#.##
#.........#
##.#.....##
#####.#####

5
0
#####.#####
#.........#
#.#.....#.#
#.........#
#.........#
#....#.....
#.........#
#.........#
#.......#.#
#.........#
###########

5
2
#####d#####
###.......#
#..##.....#
#.#.......#
#.##......#
..........d
#.#.......#
#...#.....#
#.........#
#.........#
#####d#####

2
3
###########
#.......ee#
#.##.....?#
#.##......#
#.##......#
.......#..#
#....##...#
#....#...##
#......##.#
#.........#
#####.#####
enemies 2
door 0 : 0
sign A locked path — look elsewhere first.

5
1
#####.#####
#e.#......#
#.........#
#....#....#
#.........#
...........
#.........#
#.........#
#.........#
#s..?e....#
###########
enemies 2
switch 0 : 0
sign Beware what lurks ahead.

4
0
#####.#####
#.........#
#.........#
#.........#
#.###.....#
#..?#@.....
#..#......#
###.......#
####......#
#.........#
#####.#####
sign The dungeon remembers all who enter.

4
2
#####.#####
#.........#
#......#..#
#.......#.#
#.........#
..........d
#.........#
#.........#
#.........#
#.........#
#####d#####

3
3
#####.#####
#........k#
#........##
#.........#
#.....#...#
..........#
#.........#
#.........#
#.........#
#.........#
#####.#####
key : 3

3
0
###########
#..#.....##
#.........#
#.........#
#...#..#..#
#..........
#.........#
#..#..#...#
#.........#
#.........#
#####.#####

5
3
#####.#####
#......##.#
#..#...#..#
#..#.#.#..#
#..##.....#
d..#####..#
#.........#
#.........#
#.........#
#.........#
###########

1
2
#####.#####
####......#
#####.....#
##.##.....#
#..#......#
#....e....#
#..#......#
#.........#
#..#......#
#.........#
#####l#####
locked : 3
boss
enemies 1

2
2
#####l#####
#.........#
#..#..###.#
#..#.###..#
#...###...#
...###.#...
#..##..#..#
#.........#
#.........#
#.........#
#####l#####
locked : 0

6
2
#####d#####
#.........#
#..#......#
#.##..#...#
#..#......#
#..###....#
#.....#...#
#.....#...#
#.....#.#.#
#.........#
###########

4
1
#####.#####
#.........#
#.....#...#
#.........#
#.........#
...........
#.........#
#.#.....#.#
#..#...#..#
#.........#
#####.#####

3
2
#####l#####
#k........#
#.#....#..#
#.......#.#
#.........#
...........
#.........#
#.........#
#......#..#
#.........#
#####.#####
key : 2

2
1
###########
#.........#
#.........#
#.........#
#.........#
#..........
#.........#
#.......#.#
#......#..#
#.........#
#####l#####
locked : 2

0
2
###########
#X.......##
#.........#
#.........#
#.........#
#......#..#
#.........#
#.........#
#.........#
#.........#
#####.#####

