4
2
#####.#####
#k........#
#......#..#
#.......#.#
#.........#
..........d
#.........#
#.........#
#.........#
#.........#
#####d#####
key : 3

2
4
#####.#####
#.........#
#.........#
#..#......#
#.........#
..........#
#.##......#
#.........#
#..##.....#
#........X#
###########

3
0
#####l#####
#.........#
#.........#
#.........#
#.........#
#..........
#.........#
#.......#.#
#.....#...#
#.........#
#####.#####
locked : 0

2
1
#####.#####
#.........#
#.........#
#..#..#...#
#.........#
l..........
#...#.....#
#.........#
#.........#
#..#......#
#####.#####
locked : 1

2
2
###########
#e..?e....#
#.........#
#.........#
#.........#
...........
#.........#
#.........#
#.........#
#e........#
#####.#####
enemies 3
sign Seek the matching key before you proceed.

3
2
#####.#####
#.#.......#
#..##.....#
#..####...#
#.........#
d..........
#.........#
#.........#
#.........#
#.........#
#####.#####

4
0
#####.#####
#.........#
#..#......#
#.#.......#
#.........#
#..........
#.........#
#.........#
#.........#
#.........#
###########

0
0
###########
#e.......e#
#s........#
#.....#...#
#.........#
#.........#
#.........#
#.........#
#.........#
#.........#
#####.#####
enemies 2
switch 0 : 0

3
3
#####.#####
#e#.....#.#
#.........#
#.#.#.#.#.#
#.........#
....#.#...#
#.........#
#.#...#.#.#
#.........#
#e#.....#.#
#####.#####
enemies 2
door 0 : 0

1
1
###########
#........k#
##..#.....#
#.........#
#.........#
....#..#..#
#.........#
#.........#
##..#..#..#
#.........#
#####.#####
key : 0

2
3
#####.#####
#.........#
#..#...#..#
#.#.....#.#
#.........#
...........
#.........#
#.#.......#
#..#......#
#.........#
#####.#####

4
1
#####.#####
#.........#
#...#...#.#
#.........#
#..#.#.#..#
...........
#.#.#.#...#
#.........#
#..#...#.##
#.........#
###########

1
3
###########
#.........#
#.........#
#.........#
#.........#
#.........d
#..#......#
#.#.....#.#
#..#...#..#
#.........#
#####.#####

5
2
#####d#####
#.#.....#.#
#.........#
#...#.#.#.#
#.........#
#.....#...#
#.........#
#.#...#.#.#
#.........#
#.#.....#.#
###########

4
3
#####.#####
##.....#..#
#.........#
#.........#
#...#.....#
d.........#
#.........#
##.....#..#
#.........#
#.........#
###########

1
4
###########
#......#..#
#...#.#...#
#....#....#
#..#e..#..#
d..####...#
#.....#.#.#
#......##.#
#.....#####
#.........#
#####.#####
boss
enemies 1

1
0
#####.#####
#.........#
#.........#
#.........#
#......#..#
#....@##...
#.....#...#
#.........#
#.........#
#.........#
#####.#####

2
0
#####.#####
#.........#
#..#......#
#k#.......#
#.........#
#.........l
#.........#
#.........#
#.........#
#.........#
#####l#####
key : 1

3
1
#####.#####
#k........#
#..#......#
#.#.......#
#......#..#
.....#....d
#.........#
#.#.......#
#..#....#.#
#.........#
#####.#####
key : 2

