4
0
#####D#####
#.........#
#..#...#..#
#.........#
#.#.#.#...#
#.........#
#..#...#..#
#.........#
#.#.#...#.#
#.........#
#####l#####
locked : 1

1
1
###########
##.#...#e##
#........?#
#....#.#.##
#.........#
D..#.#.#..#
#.........#
#....#...##
#.........#
##.#...#..#
#####D#####
enemies 1
sign Turn back; you are not yet ready.

5
0
#####l#####
#.........#
#.........#
#.........#
#.........#
#.........#
#.........#
#.........#
#.........#
#.........#
#####l#####
locked : 0

7
0
#####D#####
#.........#
#.........#
#.........#
#.........#
#.....#...D
#?........#
#s...##...#
#e........#
#ee.......#
###########
enemies 3
switch 0 : 0
sign Those who search shall find.

7
2
###########
#........k#
#..#......#
#.#.......#
#.........#
D.........#
#.........#
#.#.......#
#..#......#
#.........#
#####D#####
key : 3

7
1
#####D#####
#k........#
#.........#
#.........#
#.........#
D.........D
#.........#
#.#.....#.#
#..#...#..#
#.........#
#####D#####
key : 1

2
2
###########
#..#.....k#
#..#...#.##
#.#.......#
#.........#
D.........#
#.........#
#.#.......#
#..#......#
#.........#
###########
key : 11

0
0
###########
#X........#
#.....#...#
#...##....#
#.........#
#.........#
#.........#
#.........#
#.........#
#.........#
#####D#####

1
0
#####D#####
#.........#
#.........#
#..#.#.#..#
#..#..#...#
#..##e#...D
#....#....#
#...#.##..#
#.........#
#.........#
#####l#####
locked : 9
boss
enemies 1

3
0
#####d#####
#.........#
#..#......#
#.#.......#
#.........#
#.........D
#.........#
#.......#.#
#......#..#
#.........#
#####D#####

10
1
#####d#####
#.........#
#.........#
#......p..#
#.........#
#.........#
#.........#
#.........#
#.........#
#.........#
###########

8
2
#####D#####
#.........#
#.........#
#.........#
#.#.#.....#
D.........#
#.........#
#........##
#.........#
#.........#
###########

6
1
###########
#........k#
#......#..#
#.......#.#
#.........#
D.........#
#.........#
#.#.......#
#..#......#
#.........#
#####D#####
key : 0

6
0
#####l#####
#.........#
#......#..#
#....##...#
#....#.##.#
#....@.#..D
#....###..#
#....##..##
#.....#..##
#.........#
#####D#####

9
1
#####l#####
##.#...#.##
#.........#
#.#.#.#...#
#.........#
#..#.#.#..#
#.........#
#.#.....#.#
#.........#
##.#...#..#
#####d#####
locked : 3

3
1
#####D#####
#.........#
#..#......#
#.#.......#
#.........#
D.........#
#.........#
#.#.......#
#..#......#
#.........#
###########

2
0
#####l#####
#.........#
#...#.#.#.#
#.........#
#.#.#.#.#.#
#.........D
#.#.#...#.#
#.........#
#...#.#.#.#
#.........#
#####d#####

8
1
#####D#####
#.........#
#.........#
#e#..#..#.#
#.........#
#.........D
#.....#...#
#.........#
#.........#
#e#.....#e#
#####l#####
enemies 3
door 0 : 0

2
1
#####D#####
#k........#
##.#.....##
#.........#
#.#...#.#.#
D.........D
#.........#
#.........#
#.#...#.#.#
#.........#
#####D#####
key : 9

