1
1
###########
#.........#
#...#.....#
#........##
#.........#
...........
#.........#
#.......#.#
##.....#..#
#k........#
#####.#####
key : 1

4
0
#####l#####
#......##.#
#......##.#
#.........#
#....####.#
#..####...#
#...##....#
#.#.#.....#
###.......#
#.........#
###########
locked : 0

2
2
#####.#####
#.........#
#.........#
#.#..#....#
#.........#
...........
#..#..#...#
#.........#
#.........#
#.........#
###########

3
1
#####.#####
#.........#
#.....##..#
#....#....#
#.........#
..........#
#.........#
#.........#
#.........#
#........k#
###########
key : 0

2
4
#####.#####
#.........#
#...#.#.#.#
#.........#
#.#.#.#.#.#
...........
#.#.......#
#.........#
#.#.#.#...#
#.........#
#####d#####

0
3
###########
#.........#
#.#...#.#.#
#.........#
#...#.#.#.#
...........
#...#.#.#.#
#.........#
#.#...#.#.#
#.........#
#####.#####

1
2
#####d#####
#.........#
#.........#
#..#..#...#
#...#####.#
....##.....
#..##..#..#
#...#####.#
#...#.##..#
#.........#
#####.#####

3
4
#####d#####
##........#
#.........#
#.........#
#.........#
#.........#
#.........#
#.......#.#
#.#....#..#
##........#
###########

3
0
#####.#####
#.........#
#.#.......#
#.###.....#
#.#.##....#
#....@.....
#.#..##...#
#..#......#
#...#.#...#
#.........#
#####l#####

0
2
###########
#.#.....#.#
#.........#
#.........#
#..#......#
#..........
#.........#
#.#.....#.#
#.........#
#.........#
#####d#####

0
4
###########
#.........#
#.......#.#
#.........#
#.........#
...#..#...#
#.........#
#.........#
#.#.....#.#
#.........#
#####l#####
locked : 3

1
4
#####l#####
#k#.......#
#......#..#
#.......#.#
#.........#
..........l
#.........#
#.........#
#........##
#.........#
#####.#####
key : 3

2
5
#####.#####
#..#......#
#.#.......#
#.##.#....#
#.####....#
..........#
#.........#
#.........#
#.........#
#........X#
###########

2
1
#####.#####
#.........#
#......#..#
#.......#.#
#.........#
...........
#.........#
#.......#.#
#......#..#
#.........#
#####.#####

1
5
###########
#.........#
#.........#
#.........#
#.........#
l....e....#
#.........#
#.........#
#.........#
#.........#
#####.#####
locked : 2
boss
enemies 1

1
3
#####.#####
##........#
#.........#
#.........#
#...#..#..#
...........
#.........#
##..#..#..#
#.........#
#.........#
#####d#####

2
3
#####d#####
#k........#
##........#
#.........#
#.........#
.....#.....
#.........#
#.........#
##..#..#..#
#.........#
###########
key : 2

2
0
#####d#####
#.........#
#.........#
#......#..#
#..#..#e#.#
#.e##.#....
#e##......#
#.........#
#.........#
#.........#
#####.#####
enemies 3

1
0
###########
#.........#
#.........#
#.........#
#.........#
#..........
#.........#
#.#.......#
#..#......#
#.........#
#####d#####

