0
0
###########
#.........#
#.........#
#.........#
#.........#
#.........#
#.........#
#.........#
#.........#
#.........#
#####.#####

2
1
#####.#####
#.........#
#.........#
##..#..#..#
#.........#
...........
#.#..#..#.#
#.........#
#.........#
##....k#..#
###########
key : 0

2
3
#####d#####
#.........#
#.........#
#.........#
#.........#
...........
#.........#
#.........#
#.........#
#.........#
###########

3
2
#####d#####
#.#.....#.#
#.........#
#.........#
#.....#...#
#.........#
#.........#
#.#..#..#.#
#.........#
#.........#
###########

1
1
###########
#e........#
##e#......#
####......#
#.##......#
...........
#.........#
#.........#
#.........#
#.........#
#####.#####
enemies 2

1
4
#####.#####
#.........#
#.........#
#.........#
#.........#
..........l
#.........#
#.#.......#
#..#......#
#.........#
#####d#####

1
5
#####.#####
#.........#
#..#...#.##
#.........#
#...#.#.#.#
l.........#
#..#...#..#
#.........#
#.#.#.#.#.#
#.........#
#####.#####
locked : 2

2
0
#####.#####
#.........#
#..#......#
#.#.......#
#.........#
#..........
#.........#
#.#.......#
#..#......#
#.........#
###########

2
4
#####d#####
#.........#
#.........#
#.##.#....#
#..#e#....#
...###.....
#...#.....#
#.........#
#.........#
#.........#
#####.#####
boss
enemies 1

0
4
###########
#...e.e...#
#..##e##..#
#..##.#?..#
#.....##..#
...#.#.....
#....###..#
#.........#
#.........#
#.........#
#####.#####
enemies 3
sign A useful tool lies just ahead.

0
3
###########
#.........#
#.........#
#.........#
#.........#
....#......
#.........#
#.#.....###
#..#...#..#
#.........#
#####.#####

1
0
#####.#####
#.........#
#.........#
#.........#
#.........#
#?...@.....
#.........#
#...#.....#
#.........#
##........#
#####.#####
sign The dungeon remembers all who enter.

1
3
#####.#####
#......#..#
#.....#.#.#
#.#.#.....#
#.####.##.#
d..##......
#.........#
#.........#
#.........#
#.........#
#####d#####

0
5
###########
#........k#
#.........#
#.........#
#.........#
..........#
#.........#
#.#......##
##.#......#
#.........#
#####.#####
key : 6

3
4
#####.#####
#.........#
#..#......#
#.#####...#
#.#####...#
#..#.#....#
#.#.......#
#.#...#...#
##........#
#X......#.#
###########

2
5
#####.#####
#.........#
#.........#
#.........#
#.........#
..........#
#.........#
#.......#.#
#......#..#
#.........#
###########

2
2
#####.#####
#k#.....#.#
#.........#
#..#.#.#.##
#.........#
......#....
#.........#
#..#.#.#..#
#.........#
#.#.......#
#####d#####
key : 2

1
2
#####l#####
#.........#
#.#.#...#.#
#.........#
#..#.#.#..#
..........d
#.#.#.#.#.#
#.........#
#..#...#.##
#........k#
#####.#####
key : 1

0
2
###########
#.........#
##........#
#.........#
#.........#
#...#..#...
#.........#
#.........#
##..#.....#
#.........#
#####l#####
locked : 0

