7
0
#####d#####
#.........#
#......#..#
#.......#.#
#.........#
#.........#
#.........#
#.........#
#.........#
#.........#
###########

3
2
#####.#####
#.........#
#.........#
#.....#..##
#........k#
..........#
#......#..#
#.........#
#.........#
#..#.....##
#####.#####
key : 1

4
1
#####l#####
#e........#
#.........#
#...#..#..#
#.##...#..#
...........
#.#.......#
#.........#
#.........#
#e........#
#####.#####
enemies 2

2
3
###########
#........e#
#.#.....#.#
#.........#
#.........#
..........#
#.........#
#.........#
#.#.....#.#
#........?#
###########
enemies 1
sign What you seek is close.

6
0
#####.#####
#.##......#
#..#......#
#.#.###...#
#....##...#
#..####...#
#.........#
#.........#
#.........#
#.........#
#####d#####

2
2
#####l#####
#.......#.#
#.........#
#.#.#.#...#
#.........#
....#.#....
#.........#
#.#.#.#.#.#
#.........#
#k#.....#.#
#####.#####
key : 3

4
2
#####.#####
#.........#
#..#..#..##
#.........#
#.........#
...#..#...l
#.........#
#.........#
#..#.....##
#.........#
#####.#####

5
1
#####.#####
#..#......#
#...#.....#
#..#......#
#.........#
...........
#.........#
#.#.......#
#.##......#
#.........#
###########

2
1
#####d#####
#.........#
#..#......#
#k#.......#
#.........#
#..........
#.........#
#.......#.#
#......#..#
#.........#
#####.#####
key : 2

1
1
#####.#####
#.........#
#.#.....#.#
#.........#
#.........#
#....#.....
#.........#
#.........#
#.........#
#.........#
#####d#####

0
1
###########
##.#.....##
#.........#
#.#.#.#...#
#.........#
#..#.#.#...
#.........#
#.#.#.#.#.#
#.........#
#..#...#.##
#####.#####

4
3
###########
#.........#
#.........#
#.........#
#.........#
l.........#
#.........#
##........#
#...#.....#
#.........#
###########
locked : 2

6
2
#####d#####
#.........#
#...#.##.##
#....####.#
#....####.#
#...#.#...#
#......##.#
#.........#
#.........#
#.........#
###########

4
0
###########
#k........#
#.........#
#.........#
#.........#
#..........
#....#....#
#..#......#
#.........#
#.........#
#####.#####
key : 0

1
2
#####.#####
#.........#
#.........#
#.........#
#...##....#
...#.e#...#
#..#..#...#
#.#.#.#...#
#.........#
#.........#
#####l#####
locked : 1
boss
enemies 1

3
1
#####.#####
#.#.....#.#
#.........#
#..#...#..#
#.........#
#...#......
#.........#
#..#.#...##
#.........#
#.#.......#
#####l#####
locked : 0

0
2
###########
#........X#
#.........#
#.........#
#.........#
..........#
#.........#
#.........#
#.........#
#.........#
#####.#####

5
2
#####.#####
###.......#
#####.....#
#.#.#.....#
#.#.......#
....##....#
#...#.#...#
#.........#
#.........#
#.........#
#####d#####

5
0
#####.#####
#.........#
#.........#
#.........#
#.........#
#....@.....
#.........#
#.........#
#.........#
#.........#
#####.#####

