1
0
#####D#####
#.........#
#.........#
#...#.....#
#...##....#
#..##@....D
#.........#
#.........#
#.........#
#.........#
#####D#####

2
1
#####D#####
#.........#
#..#......#
#.#.......#
#.........#
l.........d
#.........#
#.......#.#
#......#..#
#.........#
#####d#####
locked : 0

4
1
#####D#####
#.........#
#..#...#.##
#.........#
#.#.#...#.#
#.........D
#..#......#
#.........#
#e#.#.#.#.#
#ee.......#
###########
enemies 3

2
0
#####D#####
#.........#
#..#......#
#.#.......#
#.........#
#.........l
#.........#
#.........#
#.........#
#k........#
###########
key : 0

3
2
#####D#####
#e#.....#.#
#.........#
#.........#
#.....#...#
D.........D
#.........#
#....#..#.#
#.........#
#.........#
#####d#####
enemies 1

2
2
#####D#####
#.........#
#.........#
#.#.....#.#
#.........#
d.........D
#.#..#....#
#.........#
#.........#
#.#.......#
#####D#####

4
3
#####d#####
#.........#
#.........#
#.........#
#.........#
D....e....#
#.........#
#.........#
#.........#
#.........#
#####D#####
boss
enemies 1

1
3
###########
#.........#
#..#...#..#
#.#.....#.#
#.........#
D.........#
#.........#
#.........#
#.........#
#.........#
#####D#####

3
1
#####d#####
#.........#
#..#...#.##
#.........#
#.#.#.#.#.#
#.........D
#..#.#.#..#
#.........#
#.#...#.#.#
#.........#
#####D#####

5
3
#####D#####
#.........#
#.........#
#.#.##....#
#.####....#
#...###...#
#.#.##....#
#.....#...#
#.........#
#X........#
###########

4
2
#####d#####
#.#.....#.#
#.........#
#.#.#.#.#.#
#.........#
D...#.....D
#.........#
#.#.#.#.#.#
#.........#
#.#.....#.#
###########

1
1
#####D#####
#k........#
#..#......#
#.#.......#
#.........#
D.........D
#.........#
#.#.......#
#..#......#
#.........#
#####D#####
key : 1

1
2
#####D#####
#........k#
#........##
#.........#
#.........#
D......#..D
#.........#
#.........#
#..#..#..##
#.........#
#####D#####
key : 2

0
0
###########
#.........#
#.........#
#.........#
#.........#
#.........D
#.........#
#...#..##.#
#.....##..#
#.........#
#####D#####

0
2
###########
#........k#
#.........#
#.........#
#.#.......#
D.........#
#.........#
#.........#
#.........#
#.........#
#####D#####
key : 3

2
3
#####D#####
#.........#
#.#.#.#.#.#
#.........#
#.#.#.#.#.#
D.........#
#.#.#.....#
#.........#
#.#...#.#.#
#.........#
#####D#####

0
1
###########
####......#
#......p..#
#.###.....#
#.........#
D..#......D
#.##......#
#.##......#
#.........#
#.........#
#####D#####

3
3
#####D#####
#.........#
#.........#
#.........#
#....#.#..#
D......#..D
#....###..#
#.........#
#.........#
#.........#
#####d#####

3
4
###########
#.....?##e#
#.....##..#
#....#....#
#....#..#.#
D......#..#
#..#......#
##........#
#.#.......#
#.........#
###########
enemies 1
sign The dungeon remembers all who enter.

