4
0
#####D#####
#s........#
##.#......#
#.........#
#..#.#.#..#
#.........D
#..#.#.#..#
#e........#
##?....#.##
#ee.......#
###########
enemies 3
switch 0 : 0 1
sign The brave are rewarded.

3
0
#####D#####
#.........#
#.......#.#
#.........#
#.#.#.#.#.#
#.........D
#.#.#.#.#.#
#.........#
#.#.#.#.#.#
#.........#
#####D#####

3
3
#####D#####
#.........#
#.........#
#.........#
#.........#
D.........D
#.........#
#.........#
#.........#
#....k....#
###########
key : 4

3
2
#####d#####
#.........#
##.#...#.##
#.........#
#....#.#..#
D.........D
#..#...#..#
#.........#
#..#...#.##
#.........#
#####d#####

1
3
###########
#k........#
#.........#
#.........#
#.........#
#.........#
#.........#
#.........#
#.........#
#.........#
#####D#####
key : 5

2
4
###########
#.....e...#
#..#..#..##
#.........#
#.........#
D...#..#..l
#.........#
#.........#
#..#.....##
#.........#
#####D#####
enemies 1

1
1
#####D#####
#.........#
#.........#
#.........#
#.........#
D.........#
#.........#
#.......#.#
#......#..#
#.........#
#####D#####

2
5
###########
#.........#
#.........#
#...#.....#
#..#......#
l....e....#
#.........#
#.........#
#.........#
#.........#
#####D#####
locked : 5
boss
enemies 1

2
1
#####D#####
#.........#
#......#..#
#.......#.#
#.........#
d.........d
#.........#
#.#.....#.#
#..#...#..#
#.........#
#####D#####

1
0
###########
#.........#
#..#...#.##
#.........#
#...#...#.#
#.........D
#..#.#.#..#
#.........#
#.#.#.#.#.#
#.........#
#####D#####

2
3
#####D#####
#e##......#
#.?.......#
#.#####...#
#..#e##...#
D....#....D
#.........#
#.........#
#.........#
#e........#
#####D#####
enemies 3
sign What you seek is close.

3
4
#####D#####
#.........#
#.#.....#.#
#.........#
#.........#
D....#....D
#.........#
#.........#
#.#.....#.#
#.k.......#
###########
key : 6

2
0
#####D#####
#.........#
#.........#
#.........#
#.........#
#....@#...d
#.....?##.#
#.....###.#
#.....###.#
#.........#
#####D#####
sign Many have walked this path.

4
2
#####d#####
#.........#
#..#......#
#.#.......#
#.........#
D.........#
#.........#
#.#.......#
#..#......#
#.........#
###########

0
1
###########
#e.....epe#
#.........#
#.........#
#.........#
#.........#
#.........#
#.........#
#........p#
#.........#
#####D#####
enemies 3
door 0 : 0 1

3
5
#####D#####
#.........#
#.........#
#.........#
#.........#
D.........#
#.....#...#
#..#...#..#
#.#....#..#
#........X#
###########

4
1
#####D#####
###.......#
#..##.....#
#..##.....#
#.###.....#
D..#k#....D
#.........#
#.........#
#.........#
#.........#
###########
key : 1

3
1
#####D#####
#.........#
#.........#
#..#......#
#.........#
D..#......D
#.#.......#
#.........#
#.....##..#
#.........#
#####D#####

2
2
###########
#.........#
#.........#
#.........#
#.........#
d.........D
#.........#
#.........#
#.........#
#.........#
#####d#####

