3
3
#####.#####
#e........#
###.......#
##...#....#
#.####....#
....##....#
#.##.#....#
#.........#
##........#
#?........#
#####.#####
enemies 1
sign Something glints behind that door…

7
3
#####.#####
#.........#
#.........#
#.........#
#.........#
#......#..#
#....##...#
#.#....#..#
#.........#
#X........#
###########

2
2
#####d#####
#.........#
##..#..#..#
#.........#
#.........#
.....#....d
#.........#
#.........#
##.....#..#
#.........#
#####.#####

1
1
#####.#####
#.#.....#.#
#.........#
#.#...#...#
#.........#
d.....#....
#.........#
#.#.#...#.#
#.........#
#.#.....#.#
#####.#####

0
2
###########
#......see#
#........e#
#........?#
#.........#
..........#
#.#.......#
#......#..#
#.........#
#.........#
#####.#####
enemies 3
switch 0 : 0
sign Beware what lurks ahead.

0
1
###########
##........#
#.........#
#.#.#.#.#.#
#.........#
...#.#.....
#.........#
#.#.#...#.#
#.........#
##.#...#.##
#####.#####

2
1
#####.#####
#..#.....##
#.........#
#.........#
#..#..#...#
...........
#.........#
#..#..#...#
#.........#
#....k....#
###########
key : 1

3
2
#####.#####
#.........#
#.........#
#.........#
#.........#
#k.........
#.........#
#.........#
#.........#
#.........#
#####.#####
key : 4

5
3
#####d#####
#.........#
#.........#
#..#.....##
#.........#
#..........
#..#..#...#
#.........#
#.........#
#..#.....##
#####l#####

4
3
#####.#####
#........k#
#........##
#.........#
#.#.#.#.#.#
..........l
#..#.#.#..#
#.........#
#.#.#...#.#
#.........#
#####d#####
key : 6

5
4
#####.#####
#.........#
#.........#
#.........#
#.........#
..........#
#.........#
#.........#
#........e#
#.......ee#
###########
enemies 3
door 0 : 0

1
0
#####.#####
#.#.......#
#.....#.#.#
#.#.###...#
#..##..#..#
#...##....d
#...@.....#
#.........#
#.........#
#.........#
#####.#####

2
0
#####.#####
#......#..#
#.........#
#.........#
#......#..#
#..........
#.........#
#.....#...#
#.........#
#k........#
###########
key : 0

4
2
#####.#####
#.........#
#..#.....##
#.........#
#.........#
#..#..#....
#.........#
#.........#
#.....#..##
#.........#
###########

4
4
###########
#.........#
#..#......#
#.#.......#
#.........#
l.........#
#.........#
#.........#
#.........#
#.........#
#####.#####
locked : 0

0
0
###########
#......#..#
#.........#
#.........#
#.........#
#..........
#.........#
#.......#.#
#......#..#
#.........#
#####.#####

2
3
###########
#.........#
#..#..#..##
#.........#
#.........#
d...#..#..#
#.........#
#.........#
#..#..#..##
#.........#
#####.#####

1
2
#####.#####
#.........#
#.........#
##.......##
#.........#
..........#
#.........#
#.#.......#
#..#......#
#.........#
#####d#####

6
3
#####l#####
#.........#
#......#..#
#.#.....#.#
#..##.#.#.#
#...#e....#
#.........#
#.........#
#.........#
#.........#
#####.#####
locked : 6
boss
enemies 1

