0
0
###########
#.........#
#.........#
#.........#
#.........#
#.........#
#.........#
#.#.....#.#
#..#...#..#
#.........#
#####d#####

5
2
#####.#####
#e.#......#
##........#
##..#.....#
#.#.#.....#
....##....l
#.........#
#?##.#....#
##e#......#
#e........#
#####.#####
enemies 3
sign This door will not yield without a key.

4
0
#####.#####
#.........#
#.....###.#
#......##.#
#......##.#
#k...#.....
#....#.#..#
#.........#
#.........#
#.........#
#####.#####
key : 0

3
1
#####.#####
#e........#
#.........#
#.........#
#.....##..#
...........
#....#.#..#
#.........#
#.........#
#e........#
#####.#####
enemies 2

1
0
#####d#####
#.........#
#.........#
#..#......#
#...##....#
#.........#
#.........#
#.........#
#.........#
#.........#
#####.#####

5
0
#####.#####
#.........#
#.........#
#.#..#..#.#
#.........#
#..........
#..#..#...#
#.........#
#.........#
#.......#.#
###########

4
1
#####.#####
#.........#
#.##......#
####...#..#
#..#......#
......##...
#.........#
#.........#
#.........#
#.#.......#
#####.#####

7
2
#####d#####
#......####
#.....##.##
#....##...#
#..#..#.#.#
#....e....#
#.........#
#.........#
#.........#
#.........#
#####.#####
boss
enemies 1

6
2
#####.#####
#k#.....#.#
#.........#
#.........#
#.#..#..#.#
...........
#.........#
#.#..#..#.#
#.........#
#.........#
#####d#####
key : 2

6
3
#####.#####
#.........#
#...#.#.#.#
#.........#
#..#.#.#..#
..........#
#...#.#.#.#
#.........#
#..#......#
#........k#
###########
key : 4

2
1
###########
#.......ee#
#.........#
#.........#
#.........#
..........#
#.........#
#.........#
#.........#
#.........#
#####.#####
enemies 2
door 0 : 0 1

3
0
#####.#####
#.........#
#.........#
#.....##.##
#....##.#.#
#....@.....
#.....#...#
#....#....#
#.........#
#.........#
#####.#####

4
2
#####d#####
#.........#
#.........#
#.........#
#......#..#
..........#
#.........#
#...#...#k#
#......#.##
#.........#
#####.#####
key : 1

6
1
#####d#####
#.........#
#.........#
#.........#
#.........#
#..........
#......#..#
#...####..#
#...#..##.#
#......##.#
###########

8
2
#####.#####
##.#......#
##.#......#
#..#.....##
#.........#
#.........#
#.........#
#.........#
#.........#
#X........#
###########

3
2
###########
#.........#
#.#...#.#.#
#.........#
#..#.#....#
..........#
#.#.#.....#
#.........#
#..#...#.##
#.........#
#####d#####

5
3
###########
#.........#
#.........#
#.........#
#.....###.#
l.....#...#
#.....###.#
#.........#
#.........#
#.........#
#####.#####
locked : 1

2
0
#####.#####
#.........#
#.........#
#.........#
#.........#
#e.#?.##...
#..s##.e#.#
#...##.#e##
#..##..#.##
#........##
#####.#####
enemies 3
switch 0 : 0 1
sign The dungeon remembers all who enter.

5
1
#####.#####
#.........#
#.........#
#.........#
#.........#
...........
#.....##..#
#.....###.#
#.......#.#
#.........#
#####d#####

