3
2
#####D#####
#.........#
#.........#
#.........#
#.........#
D...#k#...#
#...##.##.#
#.......#.#
#......##.#
#......#..#
#####D#####
key : 4

5
1
#####l#####
#.........#
#.........#
#.........#
#.#..#....#
#...#.#...D
#.#.#.....#
#...##....#
#...#.....#
#.........#
###########
locked : 2

4
1
#####D#####
#.........#
#.........#
#.........#
#.........#
D.........d
#.........#
#.#.......#
#..#......#
#.........#
#####l#####

4
3
###########
#.........#
#.........#
#.........#
#.........#
d.........#
#.#.#.....#
#.###.....#
#.#.#.....#
#.........#
###########

4
0
#####D#####
#.........#
#.........#
#.........#
#.........#
#.........D
#.........#
#.........#
#.........#
#.........#
###########

6
2
#####D#####
#.........#
#.........#
#.........#
#.#.......#
#..#......#
#X#.......#
##.#......#
#.........#
#.........#
###########

4
2
#####D#####
#.........#
##.....#.##
#.........#
#.#.#.#.#.#
d.........d
#..#.#.#..#
#.........#
#.#.#.#...#
#.........#
#####l#####

2
0
#####D#####
#.........#
#..#..#..##
#.........#
#.........#
#......#..D
#.........#
#.........#
#..#.....##
#.........#
#####D#####

3
0
#####D#####
#.........#
#.........#
#.........#
#...@.....#
#?...#....D
#....#....#
#..#......#
#.........#
#.........#
#####D#####
sign A locked path — look elsewhere first.

2
2
#####D#####
#k#.......#
#...#.....#
#.###.....#
#...##....#
D...#.#...D
#...#.#...#
#.........#
#.........#
#.........#
#####D#####
key : 2

3
1
#####l#####
#.........#
#......#..#
#.......#.#
#.........#
D.........D
#.........#
#.........#
#.........#
#.........#
#####D#####
locked : 0

0
0
###########
#.........#
#......#..#
#.......#.#
#.........#
#.........D
#.........#
#.#.......#
#..#......#
#.........#
#####d#####

0
1
###########
#........k#
#.........#
#.........#
#.........#
D.........#
#.........#
#.........#
#.........#
#.........#
#####D#####
key : 3

1
1
#####D#####
#.........#
#.........#
#.........#
#.........#
D.........d
#.........#
#.........#
#.........#
#.........#
#####D#####

2
1
#####D#####
#k........#
##.#...#.##
#.........#
#.#.....#.#
D.........D
#..#.#....#
#.........#
#.#.....#.#
#.........#
#####l#####
key : 0

2
3
###########
#.........#
#..#......#
#.#.......#
#.........#
D.........#
#.........#
#.#.......#
#..#......#
#.........#
###########

1
2
###########
#.........#
#..#......#
#.#.......#
#.........#
d...#.....#
#......#..#
#.........#
#.........#
#..#......#
#####D#####

5
2
#####l#####
#.........#
#.........#
#....#.#..#
#.........#
D....e....#
#...#.....#
#.........#
#..#......#
#.........#
#####D#####
locked : 4
boss
enemies 1

1
0
#####d#####
#.........#
#...#.....#
#...###...#
#.........#
#.........D
#.........#
#.........#
#.........#
#.........#
#####D#####

