3
0
#####D#####
#.........#
##.#...#.##
#.........#
#..#.#.#..#
#.........D
#....#.#..#
#.........#
##.#...#.##
#.........#
#####D#####

4
2
#####d#####
#.........#
#......#..#
#......##.#
#.........#
D.........#
#.........#
#.#.......#
#.##......#
#.........#
###########

1
1
#####D#####
#.........#
#.........#
#...#.....#
#.........#
D.........D
#.........#
#.........#
#.........#
#.........#
#####D#####

1
2
#####D#####
#.........#
#.........#
#.#.#.....#
#.##......#
D..###....d
#.#.##....#
#...#.....#
#.........#
#.........#
#####d#####

0
1
###########
#.........#
#.#.#.....#
##..#.....#
#.#.......#
D..#......D
#.##......#
#.........#
#.........#
#.........#
#####D#####

3
1
#####l#####
#.........#
#.........#
#.........#
#.........#
D.........D
#.........#
#.........#
#.........#
#.........#
#####D#####
locked : 0

2
0
#####D#####
#........p#
#.........#
#.........#
#.........#
#e........D
#.........#
#.........#
#.........#
#.........#
#####D#####
enemies 1

3
2
#####D#####
#.........#
#.........#
#.........#
#.........#
D.........#
#.........#
#.........#
#.........#
#.........#
#####d#####

5
0
#####D#####
#.........#
#.........#
#.........#
#.........#
#.........l
#.........#
#.........#
#.........#
#.........#
#####D#####

1
0
#####d#####
#.........#
#.........#
#.........#
#....#....#
#....@.p..D
#..p......#
#.........#
#.........#
#.........#
#####D#####

6
1
#####D#####
#.........#
#.........#
#.........#
#.........#
D.........#
#.........#
#.........#
#........p#
#........X#
###########

4
1
#####D#####
#k#.....#.#
#.........#
#..#.#.#.##
#.........#
D.....#...D
#.........#
#..#.#.#.##
#.........#
#.#.....#.#
#####D#####
key : 3

1
3
###########
#.........#
#.........#
#......#..#
#.........#
d.........#
#...#..#..#
#.........#
#.........#
##........#
###########

2
2
#####d#####
#.........#
#.........#
#.........#
#.........#
D..##.....#
#..##.....#
#.#.#.....#
##........#
#k.#......#
#####D#####
key : 2

6
0
#####D#####
#.........#
#.........#
#.........#
#.........#
#.........D
#.....#...#
#.........#
#.........#
#k........#
###########
key : 7

5
1
#####D#####
#.........#
###.......#
####...p..#
#..#e.....#
l...###...#
#..####...#
#..#.##...#
#..#......#
#.##......#
#####D#####
locked : 7
boss
enemies 1

0
0
###########
#.........#
#..#..#..##
#.........#
#.........#
#..#..#...D
#.........#
#.........#
#..#.....##
#.........#
#####d#####

0
2
###########
#.........#
#.........#
#...#.....#
#..#..##..#
D..#.###..#
#....#.#..#
#.........#
#.........#
#.........#
#####D#####

2
1
#####D#####
#k........#
#.........#
#.........#
#....#....#
D......#..D
#.........#
#.........#
#.........#
#.........#
#####l#####
key : 0

4
0
#####D#####
#e........#
#......#..#
#.........#
#?...#.#..#
#e........D
#..#.#.#..#
#.........#
#..#...#.##
#........e#
#####D#####
enemies 3
sign What you seek is close.

