4
5
###########
#........e#
#.#.#.#.#.#
#.........#
#...#...#.#
D.........#
#.#.#.#.#.#
#.........#
#...#.#...#
#.........#
###########
enemies 1

3
1
#####d#####
#.........#
#.#.#.#.#.#
#.........#
#..#...#..#
l.........D
#.#...#.#.#
#.........#
#..#...#..#
#.........#
#####D#####
locked : 0

2
2
###########
#e..?e....#
#.........#
#.........#
#.........#
D.........D
#.........#
#.........#
#.........#
#s........#
#####D#####
enemies 2
switch 1 : 1
sign The brave are rewarded.

4
1
#####D#####
#k........#
##.......##
#.........#
#...#...#.#
D.........D
#..#.#.#..#
#.........#
#.#.#.#.#.#
#.........#
###########
key : 1

5
2
#####D#####
#.........#
#...#.....#
#.........#
#.........#
#.........D
#.........#
#.........#
#.........#
#.........#
###########
door 0 : 0

4
3
#####D#####
#.e#...#..#
#.##..##..#
#..###?#..#
#..#......#
D.........D
#.........#
#.........#
#.........#
#.........#
#####D#####
enemies 1
sign The brave are rewarded.

3
2
#####D#####
#k........#
#.........#
#.........#
#.........#
D.........D
#.........#
#.........#
#.........#
#.........#
#####D#####
key : 2

0
1
###########
#X........#
#.........#
#.........#
#.........#
#.........#
#.........#
#.........#
#.........#
#.........#
#####D#####

4
4
###########
#.........#
#.........#
#....#....#
#.........#
D.........D
#.#..#..#.#
#.........#
#.........#
#e#.....#.#
#####D#####
enemies 1

1
1
#####D#####
#.........#
#.........#
#.........#
#.........#
#....e....#
#.........#
#.........#
#.........#
#.........#
#####l#####
locked : 2
boss
enemies 1

5
3
#####D#####
#.........#
#####.....#
#.##..#...#
#.#.#.....#
D.....#...D
#.........#
#....##...#
#...#.....#
#.........#
###########

3
0
###########
#?........#
#.........#
#.........#
#.#.......#
#..##@p...l
#...#.....#
#.....##..#
##.##..p..#
#.........#
#####D#####
sign Turn back; you are not yet ready.

5
4
#####D#####
#.........#
#.#.....#.#
#.........#
#.#.....#.#
D.........#
#.#.#.#.#.#
#.........#
#.#.#...#.#
#.........#
###########
door 1 : 1

3
3
#####D#####
#.........#
#.........#
#...#.....#
#.........#
D.........#
#.........#
#.#.....#k#
#.##...#..#
#.........#
#####D#####
key : 3

4
0
#####D#####
#.........#
#.........#
#.........#
#.........#
#k........D
#....#....#
#.......#.#
#......#..#
#.........#
#####D#####
key : 0

5
0
#####D#####
#.........#
#..#......#
#.#.......#
#.........#
#.........#
#.........#
#.......#.#
#......#..#
#.........#
###########

2
1
#####l#####
#.........#
#.........#
#...#.#...#
#.........#
#...#.#...D
#.........#
##.#......#
#...#.....#
#.........#
#####d#####

4
2
#####D#####
#s........#
#..#......#
#.#.......#
#.........#
D.........D
#.......#.#
#.........#
#.........#
#?........#
#####D#####
switch 0 : 0
sign A useful tool lies just ahead.

2
3
###########
#.......#.#
#.........#
#..#......#
#.........#
D..#.#....#
#.........#
#.........#
#.........#
#.........#
#####D#####

