3
2
#####D#####
#.........#
#..#..#..##
#.........#
#.........#
D......#..#
#.........#
#.........#
#..#..#..##
#........k#
###########
key : 2

4
4
#####D#####
#.........#
#.........#
#.........#
#.........#
#.........#
#.........#
#.........#
#.........#
#X........#
###########

0
0
###########
#k........#
#..#..#..##
#.........#
#.........#
#...#.....D
#.........#
#.........#
#.....#..##
#.........#
#####D#####
key : 0

1
3
#####D#####
#?........#
#.........#
#..##.....#
#.#e#.....#
D.........D
#....#....#
#...#.....#
#.........#
#.........#
#####D#####
enemies 1
door 0 : 0
sign The brave are rewarded.

1
4
###########
#.........#
#.#.#.#.#.#
#.........#
#..#.#.#..#
D.........#
#.#.#.#.#.#
#.........#
#..#...#.##
#.........#
#####D#####

0
1
###########
#e#.....#e#
#.........#
#..#.#...##
#.........#
D...#.#...l
#.........#
#..#.#.#.##
#.........#
#e#.....#s#
#####D#####
enemies 3
switch 0 : 0

2
1
#####D#####
#.........#
#.........#
#.........#
#.........#
D.........D
#.........#
#.#.....#.#
#..#...#..#
#.........#
#####l#####

3
4
#####d#####
#.........#
#..#..##..#
#....###..#
#...#..#..#
#..###....#
#...e.....#
#.........#
#.........#
#.........#
#####D#####
boss
enemies 1

2
0
#####D#####
#.........#
#.........#
#.........#
#.........#
#....@....D
#.........#
#.........#
#.........#
#.........#
###########

1
0
#####D#####
#.........#
#.........#
#.........#
#...#.....#
#..#.#....d
#..#......#
#..#.#....#
####......#
#.........#
#####D#####

0
2
###########
#.........#
#......#..#
#.......#.#
#.........#
l.........D
#.........#
#.........#
#.........#
#.........#
#####D#####
locked : 2

3
1
#####l#####
#.........#
#.........#
#.........#
#.........#
#..#.#....D
#...##..#.#
####..#...#
#...#.##..#
###.......#
###########
locked : 0

2
4
#####D#####
#.........#
#.........#
#.........#
#.........#
l.........d
#.........#
#.........#
#.........#
#.........#
#####d#####
locked : 1

0
3
###########
#.#......k#
#...#.....#
##..#.....#
#.##......#
D.........#
#.....#...#
#...#.#...#
#.....#...#
#.........#
#####D#####
key : 3

2
2
#####d#####
#.........#
#.........#
#.........#
#.........#
D.........D
#.........#
#.#.......#
#..#......#
#.........#
#####D#####

2
5
###########
#.........#
#..#...#..#
#.#.....#.#
#.........#
d.........#
#.....#...#
#.#.......#
#.........#
#.........#
###########

1
2
#####D#####
#.........#
#......#..#
##......#.#
#.........#
D.........D
#.#.......#
#.........#
#.........#
#.........#
#####d#####

1
1
#####D#####
#.#.....#.#
#.........#
#.........#
#.#..#....#
d.........D
#.........#
#.#..#..#.#
#.........#
#.........#
#####D#####

2
3
#####D#####
#k#.....#.#
#.........#
#.........#
#.#.......#
D.........l
#.........#
#.#..#..#.#
#.........#
#.........#
###########
key : 1

