2
4
###########
#.........#
#.........#
#.........#
#.....##..#
d....###..#
#....###..#
#.........#
#.........#
#.........#
###########

5
1
#####d#####
#.........#
#.........#
#.........#
#....#.#..#
#....##...#
#....#..#.#
#....##..##
#.....###.#
#.........#
###########

3
3
#####.#####
#.........#
#...#...#.#
#...#.#...#
#...#..##.#
....##....#
#...#..##.#
#.........#
#.........#
#.........#
#####l#####

1
0
#####.#####
#.........#
#..#......#
#k#.......#
#.........#
#..........
#.........#
#.#.......#
#..#......#
#.........#
#####.#####
key : 0

4
1
#####.#####
#.........#
#.........#
#.........#
#.........#
.........k#
#.........#
#.........#
#.........#
#.........#
#####d#####
key : 2

4
3
#####l#####
#.......#.#
#.........#
#.........#
#.........#
#....e....#
#.........#
#..#......#
#.........#
#.........#
#####.#####
locked : 5
boss
enemies 1

1
1
###########
#.#.......#
#.........#
#.........#
#.........#
...........
#.........#
#.#.....#.#
##.#...#..#
#.........#
#####.#####

0
0
###########
#k........#
#.........#
#.........#
#.........#
#.........#
#.........#
#.#.....#.#
#..#...#..#
#.........#
#####.#####
key : 1

2
0
#####.#####
#.........#
#.........#
#.........#
#.........#
#?...@.....
#.........#
#.........#
#.........#
#.........#
#####l#####
sign Turn back; you are not yet ready.

3
0
#####l#####
#........##
#......#..#
#.......#.#
#.........#
#..........
#.........#
#.......#.#
#.........#
#.........#
#####d#####
locked : 0

2
1
#####.#####
#.........#
#.........#
#.........#
#.........#
...........
#.......#.#
#.........#
#.........#
#.........#
#####l#####

5
3
#####.#####
#........##
#.......#.#
#.........#
#.........#
#.........#
#.........#
#.........#
#.........#
#X........#
###########

3
2
#####.#####
#e#.....#e#
#.........#
#...#.#.#.#
#.........#
......#....
#.........#
#.......#.#
#.........#
#e#.....#?#
###########
enemies 3
sign Seek the matching key before you proceed.

1
3
###########
#........k#
#......#..#
#.......#.#
#.........#
..........#
#.........#
#.........#
#.........#
#.........#
#####.#####
key : 5

4
0
#####d#####
#.........#
#..#......#
#.#.......#
#.........#
#..........
#.........#
#.........#
#.........#
#.........#
###########

3
1
#####l#####
#.........#
#.........#
#...###...#
#.........#
...........
#.........#
#....#....#
#........##
#.........#
#####.#####
locked : 1

2
3
#####.#####
#.........#
#......####
#..#.#.####
#..#.###..#
d..#####..d
#...##.#..#
#...##....#
#.........#
#.........#
#####.#####

1
2
###########
#.#.....#.#
#.........#
#..#.#...##
#.........#
......#....
#.........#
#..#.#.#..#
#.........#
#.#.....#.#
#####.#####

2
2
#####.#####
#.#.....#.#
#.........#
#.#.#...#.#
#.........#
....#.#...d
#.........#
#...#.#.#.#
#.........#
#.#.....#.#
#####.#####

