3
2
#####d#####
#.#.....#.#
#.........#
#.........#
#....#..#.#
D.........D
#.........#
#....#..#.#
#.........#
#.........#
#####D#####

1
1
#####l#####
#.........#
#.#.......#
#.........#
#.........#
D.....#...D
#.........#
#.........#
#.......#.#
#.........#
###########

1
0
###########
#?........#
#.........#
#.##......#
#.##......#
#..#p@....D
#.........#
#.........#
#.........#
#.........#
#####D#####
sign A useful tool lies just ahead.

3
3
###########
#........k#
#.........#
#.........#
#.........#
D.........#
#.........#
#.........#
#.........#
#.........#
#####D#####
key : 1

4
1
#####D#####
#e#.....#.#
#.........#
#..#...#..#
#.........#
D...#.#...D
#.........#
#..#.#.#.##
#.........#
#.#.....#.#
###########
enemies 1

5
2
#####d#####
#.........#
#.........#
#.........#
#.........#
#....e....D
#.........#
#.........#
#.........#
##........#
#####D#####
boss
enemies 1

5
0
#####D#####
#.........#
#.........#
#.........#
#.........#
#.........#
#.........#
#.........#
#.........#
#.........#
###########

2
0
#####D#####
#.........#
#.#.#.#...#
#.........#
#..#.#.#..#
#.........#
#k#.#.#...#
#.........#
#..#...#.##
#.........#
#####D#####
key : 0

3
0
#####D#####
#.........#
#?#...#...#
#.........#
#......#..#
#.........D
#.....#.#.#
#.........#
#......#.##
#........e#
#####D#####
enemies 1
sign Something glints behind that door…

4
0
#####D#####
#.........#
#.........#
#...#..#..#
#.........#
#k........D
#...#.....#
#.........#
#.........#
##........#
#####D#####
key : 5

2
2
#####D#####
###.......#
#####.....#
##...#....#
#..###....#
#....#....#
#.........#
#.#.#.....#
#.###.....#
#.........#
#####d#####

4
2
#####D#####
#.......#.#
#.........#
#.#...#.#.#
#.........#
D...#.#...d
#.........#
#.#.#.....#
#.........#
#.#.....#.#
#####d#####

0
1
###########
##.....#..#
#.........#
#.........#
#.........#
#.........D
#.........#
##..#..#..#
#.........#
#.........#
#####l#####
locked : 0

3
1
###########
##e#...#..#
#.........#
##.#.#.#.##
#.........#
D..#...#..D
#.........#
#..#.....##
#.........#
##.......##
#####D#####
enemies 1

1
2
#####d#####
#.........#
#.........#
#.........#
#.........#
D........e#
#.........#
#.........#
#.........#
#.........#
#####D#####
enemies 1

0
2
###########
#.........#
#.........#
#.........#
#.........#
D.........#
#.........#
#.........#
#.........#
#.........#
#####d#####

4
3
#####D#####
#.........#
#.........#
#.........#
#.........#
d.........#
#.........#
#.........#
#.........#
#.........#
#####D#####

6
2
#####D#####
#.........#
#.........#
#.........#
#.........#
#.........#
#.........#
#.........#
#.........#
#X........#
###########

5
3
#####D#####
#.........#
#.........#
#.........#
#.........#
D.........#
#.........#
#.........#
#.........#
#........k#
###########
key : 4

