1
1
###########
#.........#
#...#.#...#
#....#....#
#.#...#...#
D..#......#
#.........#
#.........#
#.........#
#.........#
#####D#####

0
0
###########
#k.#......#
#.........#
#.........#
#..#..#...#
#.........#
#.........#
#..#.....##
#.........#
#.........#
#####D#####
key : 0

2
0
#####D#####
#.........#
#.##......#
#.##.p....#
#.#.......#
#.........l
#.........#
#.........#
#.........#
#.........#
#####D#####

1
4
###########
#.......#.#
#.........#
#..#...#.##
#.........#
d.....#...D
#.........#
#..#.#.#..#
#.........#
#.#.....#.#
#####D#####

1
0
#####D#####
#.........#
#.........#
#.........#
#.........#
#?...@....D
#.........#
#.........#
#.........#
#.........#
#####D#####
sign Something glints behind that door…

4
1
#####D#####
#.........#
#.........#
##.##.....#
#...#.....#
#.....#...#
#k###...#.#
##.#....#.#
#..#......#
#........##
###########
key : 2

3
2
#####D#####
#.........#
#.........#
#.#..#..#.#
#.........#
D.........D
#..#..#...#
#.........#
#.........#
#.#.......#
###########

1
5
#####D#####
#.........#
#.........#
#.........#
#.........#
D....e....#
#.........#
#.........#
#.........#
#.........#
#####d#####
boss
enemies 1

0
5
###########
#X........#
#.........#
#.........#
#.........#
#.........#
#.........#
#.........#
#.........#
#.........#
#####D#####

2
1
#####D#####
#.........#
##.#...#.##
#.........#
#.....#...#
l.........D
#..#.#.#..#
#.........#
#...#.#.#.#
#.........#
#####d#####
locked : 0

1
3
###########
#k........#
#.........#
#.........#
#.........#
#.........d
#.........#
#.........#
#.........#
#.........#
#####D#####
key : 4

3
1
#####d#####
#..#.....##
#.........#
#.........#
#..#..#...#
D.........D
#.........#
#..#..#..##
#.........#
#.........#
#####D#####

2
5
#####d#####
#.#.......#
#.........#
#.........#
#.........#
d...#.#...#
#.........#
#..#.#.#.##
#.........#
#.........#
#####l#####

2
2
###########
#.........#
#..#...#..#
#.#.....#.#
#.........#
D.........D
#.........#
#.......#.#
#......#..#
#.........#
#####D#####

3
0
#####D#####
#.........#
#.........#
#.........#
#.........#
#.........D
#.........#
#.........#
#?........#
#e........#
###########
enemies 1
sign The dungeon remembers all who enter.

3
5
#####l#####
#.........#
#.........#
#.........#
#.........#
#.........#
#.........#
#.......#.#
#......#..#
#.........#
###########
locked : 2

2
3
#####D#####
#.#.....#.#
#.........#
#.#.#.#.#.#
#.........#
D...#.#...l
#.........#
#.#.#...#.#
#.........#
#.#.......#
#####D#####

3
3
#####D#####
#.........#
#.........#
#.........#
#.........#
D.........#
#.........#
#.........#
#.........#
#........k#
###########
key : 3

2
4
#####D#####
#.........#
#.........#
#..#.....##
#.........#
l.........d
#...#..#..#
#.........#
#.........#
#..#......#
###########
locked : 3

