4
0
#####l#####
#.........#
#.........#
#..#..#...#
#.........#
#..........
#...#.....#
#.........#
#.........#
#..#.....##
###########
locked : 0

3
2
#####.#####
#.......#.#
#.........#
#.#.#.#.#.#
#.........#
d...#.....d
#.........#
#.#.#.#.#.#
#.........#
#.......#.#
#####.#####

2
2
###########
#.........#
#.........#
#.........#
#.........#
#..........
#.........#
#.........#
#.........#
#.........#
#####.#####

2
3
###########
#.........#
##..#..#..#
#.........#
#.........#
..........#
#.........#
#.........#
##........#
#.........#
#####l#####
locked : 4

1
0
#####d#####
#.........#
#..#......#
#.#.......#
#.........#
#....#....#
#.........#
#.........#
#.........#
#..#......#
#####.#####

4
3
#####.#####
#k........#
#.........#
#.........#
#.........#
...........
#.........#
#.#.......#
#..#......#
#.........#
#####.#####
key : 4

4
4
#####.#####
#e........#
#.........#
#.........#
#.........#
..........d
#.........#
#.........#
#.........#
#?...e....#
###########
enemies 2
sign Something glints behind that door…

3
4
###########
#.#.....#.#
#.........#
#..#.#...##
#.........#
....#.#...#
#.........#
#..#.#.#.##
#.........#
#.#.....#.#
#####.#####

3
3
#####l#####
#.........#
##.....#.##
#.........#
#.#.#.#.#.#
d..........
#..#.#.#..#
#.........#
#.#...#.#.#
#.........#
#####.#####

4
2
#####.#####
#k........#
#..#......#
#.#.......#
#.........#
...........
#.........#
#.#.......#
#..#......#
#.........#
#####l#####
key : 2

5
5
#####.#####
#.##......#
#.##......#
#......#..#
#.........#
#.........#
#.........#
#.........#
#.........#
#X........#
###########

4
5
###########
#......##.#
#...#.#...#
#...#...#.#
#.........#
d....e....#
#.........#
##........#
#.........#
#.........#
#####.#####
boss
enemies 1

3
1
###########
#.........#
#.........#
#..#.....##
#.........#
..........d
#...#..#..#
#.........#
#.........#
#..#.....##
#####.#####

4
1
#####.#####
#.........#
#...#.###.#
#.#...#...#
#..##.....#
....#.#....
#.........#
#.........#
#.........#
#....k....#
###########
key : 1

3
0
#####.#####
#.#.......#
#...#.....#
#....#....#
#.##......#
#....@.....
#.........#
#.........#
#.........#
#.........#
#####l#####

2
0
#####.#####
#.........#
#..#......#
#k#.......#
#.........#
#.........#
#.........#
#.........#
#.........#
#..#......#
#####.#####
key : 0

0
0
###########
#.........#
#..#...##.#
#.#.....#.#
#.........#
#.........#
#.........#
#...#.....#
#..#......#
#.........#
#####d#####

5
3
#####.#####
#.........#
#..##.....#
#...##....#
#...?#....#
...##.....#
#.#.#.....#
#.#.#.....#
#........e#
#.......ee#
###########
enemies 3
sign A locked path — look elsewhere first.

5
2
#####l#####
#.........#
#.#...#...#
#.........#
#.#.#.#.#.#
#..........
#.#.#.....#
#.........#
#.#.#.....#
#.........#
###########
locked : 2

