2
0
#####D#####
#.........#
#.........#
#......#..#
#.........#
#.........#
#k#..#....#
#.........#
#.........#
##........#
#####D#####
key : 1

3
1
###########
#....k....#
#.........#
#.........#
#.........#
D.........D
#.........#
#.........#
#.........#
#.........#
#####D#####
key : 0

1
1
#####D#####
#.......#e#
#.........#
#..#.#.#.##
#.........#
D...#.....d
#.........#
#..#.#.#..#
#.........#
#e#?....#e#
###########
enemies 3
sign The brave are rewarded.

5
2
#####D#####
#.........#
#......#.##
#.........#
#.#.#.#.#.#
D.........#
#..#.#.#..#
#.........#
#.....#...#
#.........#
#####D#####

0
1
###########
#.........#
#.........#
#.........#
#.........#
D.........#
#.........#
#.#.....#.#
#..#...#..#
#.........#
#####D#####

4
3
###########
#.......#.#
#..#......#
#.#.......#
#.........#
d.........#
#.........#
#.........#
#.........#
#.........#
###########

3
0
#####D#####
##........#
#...#..#..#
#.....##..#
#..##@##..#
#...###...D
#..##.##..#
#.........#
#.........#
#.........#
#####D#####

1
0
#####D#####
#.........#
#..#......#
#k#.......#
#.........#
#.........D
#.........#
#.......#.#
#......#..#
#.........#
#####D#####
key : 2

0
0
###########
#k........#
#.........#
#.........#
#....#....#
#..#..#...D
#....#.#..#
#.........#
#..#..##..#
#.........#
#####D#####
key : 3

4
2
#####l#####
#......#..#
#.........#
#..#.#.#.##
#.........#
l..#.#.#..d
#.........#
##...#.#.##
#.........#
##.#...#.##
#####D#####
locked : 1

1
2
###########
#.........#
#.........#
##..#..#..#
#.........#
d.........#
#......#..#
#.........#
#.........#
#......#..#
#####D#####

2
3
###########
#.##.....X#
#.......p.#
##.#p.....#
#.#.##....#
D.........#
#.........#
#.........#
#.........#
#.........#
###########

2
2
#####D#####
#.........#
#.........#
#...#...#.#
#...##.#..#
#...e#....D
#...##.##.#
#.....#.#.#
#.....#...#
#.........#
#####d#####
boss
enemies 1

4
1
#####D#####
#.........#
#......#..#
#.......#.#
#.........#
d.........l
#.........#
#.........#
#.........#
#.........#
#####D#####

6
2
#####D#####
#.........#
#.......p.#
#.#......p#
#.....###.#
l.....#...#
#.........#
#.........#
#.........#
#.........#
###########
locked : 3

4
0
#####D#####
#.........#
#...#...#.#
#...#..##.#
#.#.#..#..#
#..##.....d
#.###.....#
###.......#
##.##.....#
#.........#
###########

6
1
#####l#####
#.........#
#..#...#..#
#.#.....#.#
#.........#
#.........l
#.........#
#.#.......#
#..#......#
#.........#
###########
locked : 2

3
2
#####d#####
#.......#.#
#...#..#..#
#...##..#.#
#.#..###..#
D....#.#..#
#.#.......#
#.........#
#.........#
#.........#
#####l#####
locked : 0

5
1
#####D#####
#.........#
##.....#..#
#.........#
#..#......#
#.........D
#..#.#.#..#
#.........#
##.#...#.##
#.........#
#####l#####

