0
1
###########
#.........#
#.........#
#.........#
#.###.....#
..........#
#.###.....#
#.........#
#.........#
#.........#
#####.#####

3
3
#####d#####
#.........#
#.........#
#.........#
#.....#...#
...........
#.........#
#..#......#
#.........#
#.........#
###########

1
4
###########
#........k#
#.........#
#.........#
#.........#
..........#
#.........#
#.........#
#.........#
#.........#
#####.#####
key : 7

1
3
#####.#####
#.........#
#.........#
#.........#
#.......#.#
.....e#....
#.......#.#
#.........#
#.........#
#.........#
#####l#####
locked : 3
boss
enemies 1

1
0
#####.#####
#.........#
#.........#
#.........#
#.........#
#?...@.....
#.........#
#.........#
#.........#
#.........#
#####.#####
sign Beware what lurks ahead.

3
4
#####.#####
#......#..#
#..##.....#
#..#.##...#
#..#...#..#
..........#
#.........#
#.........#
#........?#
#.......ee#
###########
enemies 2
door 0 : 0 1
sign Beware what lurks ahead.

1
2
###########
#.......#.#
#......#..#
#.......#.#
#.........#
d..........
#....#....#
#.......#.#
#......#..#
#.........#
#####.#####

3
1
#####l#####
#.........#
#.........#
#.........#
#....##.#.#
.....##....
#......##.#
#...#.#...#
#.....#.#.#
#.........#
###########
locked : 0

4
0
#####.#####
#.........#
#..#......#
#.#.......#
#.........#
#.........#
#.........#
#.#.......#
#..#......#
#k........#
###########
key : 3

2
3
#####l#####
#.........#
#..#......#
#.#.......#
#.........#
..........d
#.........#
#.......#.#
#......#..#
#.........#
#####d#####

2
2
#####.#####
#k........#
#.........#
#.........#
#.........#
...........
#....#....#
#....###..#
#......#..#
#.........#
#####d#####
key : 1

2
1
#####.#####
#.........#
#.........#
#.........#
#.........#
...........
#.........#
#.........#
#.........#
#.........#
#####l#####

0
0
###########
#.........#
#.........#
#.........#
#.........#
#..........
#.........#
#.........#
#.........#
#.........#
#####.#####

3
2
#####d#####
#.........#
##.....#..#
#.........#
#.........#
.....#.....
#.........#
#.........#
##.....#..#
#.........#
###########

2
4
#####.#####
#.........#
#..#......#
#.#.......#
#.........#
d.........#
#.........#
#.#.......#
#..#......#
#.........#
#####.#####

1
1
#####.#####
#e........#
#.......#.#
#.......#.#
#......#..#
..........d
#.........#
#...###...#
#.........#
#e........#
#####.#####
enemies 2

3
0
#####.#####
#.........#
#.........#
#.......#.#
#.........#
#k.........
#.........#
#.......#.#
#......#..#
#.........#
#####.#####
key : 0

0
3
###########
#X........#
#.........#
#.........#
#..####...#
#...###...#
#.#..##...#
#..#..#...#
#.#...#...#
#.........#
#####.#####

2
0
#####.#####
#e.#......#
#.........#
#.........#
#s.#..#...#
#e.........
#.........#
#..#..#..##
#.........#
#.........#
#####.#####
enemies 2
switch 0 : 0 1

