1
3
#####D#####
#.........#
#.........#
#.........#
#.........#
D....e....D
#.........#
#.........#
#.........#
#.........#
#####l#####
locked : 3
boss
enemies 1

3
3
#####d#####
#.#.....#.#
#.........#
#..#...#..#
#.........#
D.........D
#.........#
#......#..#
#.........#
#.......#.#
###########

2
3
#####l#####
#.........#
#......#..#
#.......#.#
#.........#
D.........d
#.........#
#.#.....#.#
#..#...#..#
#.........#
#####d#####

2
1
#####D#####
#.........#
#.#.#.#.#.#
#.........#
#.#...#.#.#
D.........D
#...#.#.#.#
#.........#
#.#.#.....#
#.........#
#####l#####

1
2
###########
#.........#
#.........#
#.........#
#.........#
d.........D
#.........#
#.........#
#.........#
#.........#
#####D#####

0
3
###########
#X.......##
#.........#
#......#..#
#.........#
#.........#
#.........#
#.........#
#.........#
#.........#
#####D#####

3
1
#####l#####
#.........#
#.#.#...#.#
#.........#
#...#.....#
D.........D
#.#.#...#.#
#.........#
#.#.#...#.#
#.........#
###########
locked : 0

2
0
#####D#####
#s........#
#.......p.#
#.........#
#.........#
#e........D
#.........#
#.........#
#........p#
#........e#
#####D#####
enemies 2
switch 0 : 0 1

1
0
#####D#####
#.........#
#.........#
#.........#
#...@#.##.#
#....#.#..D
#.....##..#
#....#.?###
#......#..#
#.........#
#####D#####
sign Beware what lurks ahead.

4
0
#####D#####
#.........#
#..#......#
#.#.......#
#.........#
#.........#
#.........#
#.......#.#
#......#..#
#k........#
###########
key : 3

1
1
#####D#####
#e........#
#.........#
#.........#
#.........#
D.........d
#....#....#
#....###..#
#......#..#
#e........#
#####D#####
enemies 2

3
0
#####D#####
#.........#
#.........#
#.........#
#.........#
#k........D
#.........#
#.........#
#.........#
#.........#
#####D#####
key : 0

2
4
#####D#####
#.........#
#.........#
#.........#
#.........#
d.........#
#.........#
#.........#
#.........#
#.........#
#####D#####

3
2
#####d#####
#.........#
##.....#..#
#.........#
#.........#
D....#....D
#.........#
#.........#
##.....#..#
#.........#
###########

3
4
#####D#####
#.........#
#.........#
#...#.....#
#.........#
D.....#...#
#.........#
#.#.......#
#........?#
#.#.....ee#
###########
enemies 2
door 0 : 0 1
sign Beware what lurks ahead.

1
4
###########
#........k#
#.........#
#.........#
#.........#
D.........#
#.........#
#.........#
#.........#
#.........#
#####D#####
key : 7

2
2
#####D#####
#k#.......#
#..#......#
#.##......#
#.........#
D.........D
#.........#
#.........#
#.........#
#.........#
#####d#####
key : 1

0
0
###########
#.........#
#..#......#
#.#.......#
#.........#
#.........D
#.........#
#.#.....#.#
#..#...#..#
#.........#
#####D#####

0
1
###########
#.........#
#.#.....#.#
#.........#
#.........#
D..#......#
#.........#
#.........#
#.#.....#.#
#.........#
#####D#####

