3
1
#####l#####
#.........#
#.........#
#.........#
#.........#
...###....#
#.###.....#
#.####....#
#.###.....#
#.##......#
#####d#####

5
2
#####l#####
#.........#
#.........#
#....#..#.#
#.........#
l..........
#.....#...#
#.........#
#.........#
#.#.....#.#
#####.#####
locked : 0

0
0
###########
#e........#
#.....#...#
#.........#
#.#...#...#
#.........#
#.#.#.#...#
#.........#
#.#.#...#.#
#.........#
#####.#####
enemies 1

2
0
#####.#####
#.........#
#.........#
#.........#
#..#.#....#
#...##.....
#..###....#
#....#....#
#.........#
#.........#
#####d#####

2
1
#####.#####
#.........#
#.........#
#.........#
#.........#
.....e....#
#.........#
#.........#
#.........#
#.........#
#####l#####
locked : 3
boss
enemies 1

6
0
#####.#####
#.........#
#.........#
#.........#
#.........#
#..........
#.........#
#.#.......#
#..#......#
#.........#
#####.#####

6
1
#####d#####
#.........#
#.........#
#.....#..##
#.........#
...........
#..#..#...#
#.........#
#.........#
#........##
###########

5
1
#####.#####
#k........#
#..#......#
#.#.......#
#.........#
..........l
#.........#
#.#.......#
#..#......#
#.........#
#####d#####
key : 0

3
0
#####d#####
#..#......#
#..#..##..#
#..#..#...#
#..#.###..#
#..........
#...###...#
#...#.....#
#.....#...#
#.........#
#####.#####

5
3
###########
#........k#
#.........#
#.........#
#.........#
..........#
#.........#
#.........#
#.........#
#.........#
###########
key : 3

4
2
###########
#.#.....#.#
#.........#
#..#.#....#
#.........#
....#.#...#
#.........#
#..#.#.#.##
#.........#
#.......#.#
#####l#####
locked : 1

7
0
#####.#####
#.........#
#.......#.#
#.........#
#.........#
#.........#
#.........#
#.........#
#.........#
#k........#
###########
key : 1

1
0
#####.#####
#e........#
##..#..#..#
#e........#
#.........#
#......#...
#.........#
#.........#
##..#..#..#
#e........#
#####.#####
enemies 3

6
2
#####.#####
#.........#
#...#.#.#.#
#.........#
#...#.#...#
..........#
#.#...#.#k#
#.........#
#.....#.#.#
#.........#
#####d#####
key : 2

5
0
#####.#####
#.........#
#......##.#
#.....###.#
#.........#
#....@.....
#.........#
#.........#
#.........#
#.........#
#####.#####

4
0
#####.#####
#.........#
#.........#
#....##...#
#..###....#
#..#####...
#...##.#..#
#..###....#
#.........#
#.........#
#####.#####

4
1
#####d#####
#......#.##
####..#...#
#.#######.#
#.#.#..#..#
...........
#.#.#.....#
#.........#
#.........#
#.........#
#####.#####

7
2
#####d#####
#.........#
#.........#
#.........#
#.........#
#.........#
#.........#
#.......#.#
#......#..#
#.........#
###########

1
1
###########
#.......#X#
#.....##..#
#........##
#....###..#
..........#
#.......#.#
#....######
#.....#..##
#.........#
#####.#####

