7
1
#####.#####
#?.......e#
#..#...#.##
#.........#
#..#.#....#
..........d
#..#.#.#..#
#.........#
##.#......#
#e.e.s....#
###########
enemies 3
switch 0 : 0
sign A useful tool lies just ahead.

5
0
#####.#####
#.........#
#.........#
#.##......#
#..##.....#
#..##@....l
#..##.....#
#?####....#
##..#.....#
#.........#
#####.#####
sign This door will not yield without a key.

7
0
#####.#####
#.........#
#..#......#
#.#...#...#
#.........#
#..........
#.........#
#.......#.#
#......#..#
#k.#......#
###########
key : 1

2
0
###########
#.........#
#.#.#.#.#.#
#.........#
#.#.#.#.#.#
#.........l
#.#.#...#.#
#.........#
#.#...#.#.#
#.........#
#####d#####

2
1
#####.#####
#.........#
#.........#
#.........#
#...#..#..#
l..........
#.........#
#..#..#..##
#.........#
#.........#
#####.#####
locked : 2

6
0
#####.#####
#.........#
#......#.##
#.........#
#k#.#.#.#.#
#..........
#..#.#.#..#
#.........#
#.....#.#.#
#.........#
#####.#####
key : 0

4
1
#####.#####
#.........#
#.........#
#.........#
#.........#
..........d
#.........#
##........#
#.........#
#.........#
#####.#####

4
2
###########
#.........#
#.#.#.#.#.#
#.........#
#.#.#...#.#
d.........#
#.#...#...#
#.........#
#.#.#.#.#.#
#.........#
###########

6
1
#####.#####
##........#
#..##.....#
##.###....#
#..#......#
..........#
#.........#
#.........#
#.........#
#.........#
#####.#####

2
2
#####d#####
#.........#
#.........#
#.........#
#.........#
...........
#.........#
#.#.......#
#..#......#
#..k......#
###########
key : 4

1
2
#####.#####
#.........#
#.........#
#.........#
#.........#
.....e....#
#.........#
#.........#
#.........#
#.........#
#####d#####
boss
enemies 1

3
1
#####.#####
#.........#
#.........#
#.#..#..#.#
#.........#
..........#
#..#..#...#
#.........#
#.........#
#.......#k#
#####.#####
key : 2

0
2
###########
#X........#
#.........#
#.........#
#.........#
#.........#
#.........#
#.........#
#.........#
#..#......#
#####.#####

2
3
###########
#........e#
#...#.#...#
#.........#
#.#.#.#.#.#
..........#
#...#.#.#.#
#.........#
#.#...#.#.#
#........?#
###########
enemies 1
door 0 : 0
sign Something glints behind that door…

7
2
###########
#.........#
#.........#
#.....#..##
#.........#
d.........#
#..#..#...#
#.........#
#.........#
#........##
###########

5
1
#####.#####
#......#.##
#.........#
##.#...#.##
#.........#
l..#.#.#..#
#.........#
#..#.#.#.##
#.........#
##.#...#.##
#####.#####
locked : 0

3
0
#####d#####
#......#..#
#.....#...#
#.....##..#
#..##.....#
#..........
#.........#
#.........#
#.........#
#.........#
#####.#####

1
1
###########
#e........#
#?........#
#.........#
#.........#
#..........
#.........#
#..#......#
#.........#
#.........#
#####.#####
enemies 1
sign This door will not yield without a key.

4
0
#####.#####
#.........#
#.........#
#....#....#
#.......#.#
#......#...
#.........#
#.........#
#.........#
#.........#
#####.#####

