5
3
###########
#....k....#
#.........#
#...#..#..#
#.........#
D.........D
#...#..#..#
#.........#
#.........#
##........#
#####D#####
key : 2

0
1
###########
#e.......e#
#.#.......#
#.........#
#.........#
#..#......#
#.........#
#.........#
#.......#.#
#.........#
#####D#####
enemies 2

5
4
###########
#.........#
#..##.....#
#...####k##
#......##.#
D....###..#
#....#..#.#
#.....#...#
#.........#
#.........#
###########
key : 4

4
2
#####D#####
#.........#
#.........#
#.........#
#.........#
D.........#
#.........#
#.........#
#.........#
#.........#
#####D#####

3
0
#####D#####
#......#..#
#.......#.#
#....##.#.#
#......##.#
#.........D
#.........#
#.........#
#.........#
#.........#
#####D#####

1
2
###########
#.........#
#.........#
#.........#
#...e.....#
d...##....#
#..###....#
#..#.##...#
#.....##..#
#..#...#..#
#####D#####
boss
enemies 1

6
3
#####D#####
#.........#
#.........#
#......#..#
#.........#
D.........#
#...#.....#
#.........#
#.........#
##.....#.k#
###########
key : 3

5
0
#####D#####
#.........#
##.#...#.##
#.........#
#...#.#.#.#
#.........D
#....#.#..#
#.........#
#.....#.#.#
#k........#
###########
key : 0

3
1
#####d#####
#.........#
#.........#
#.........#
#.........#
D.........D
#..#......#
###.......#
#.........#
#.........#
#####D#####

5
2
#####D#####
#.........#
#.#.....#.#
#.........#
#.........#
d.........D
#.........#
#.........#
#.#.....#.#
#.........#
#####l#####

4
0
#####D#####
#.........#
#.........#
#.........#
#.........#
#....@....D
#.........#
#.........#
#.........#
#.........#
#####D#####

2
0
###########
#e........#
#?........#
#.........#
#.........#
#.........D
#.........#
#.........#
#.........#
#.........#
#####D#####
enemies 1
sign The dungeon remembers all who enter.

5
1
#####D#####
#.........#
#.........#
#.........#
#.........#
D.........d
#.........#
#.#.....#.#
#..#...#..#
#.........#
###########

2
1
#####d#####
##.....#..#
#.........#
#.........#
#...#.....#
D.........D
#.........#
##..#..#..#
#.........#
#.........#
#####d#####

6
2
#####l#####
#.........#
#......#..#
#.......#.#
#.........#
#.........D
#.........#
#.........#
#.........#
#.........#
###########
locked : 2

1
1
#####D#####
#.........#
#......#..#
#.......#.#
#.........#
#.........d
#.........#
#.#.....#.#
#..#...#..#
#.........#
#####d#####

3
2
#####D#####
#.........#
#.........#
#.........#
#.....###.#
D.....#.?.#
#...##e.#.#
#....##...#
#...#..#..#
#.........#
#####D#####
enemies 1
sign Beware what lurks ahead.

4
1
#####D#####
#?........#
#.........#
#...###e#.#
#...#..##.#
D.........D
#.........#
#.........#
#.........#
#.........#
#####D#####
enemies 1
sign The dungeon remembers all who enter.

2
2
#####D#####
#.........#
#..##..#..#
#..###....#
#..###....#
D........X#
#....#....#
#.........#
#.........#
#.........#
#####D#####

