3
0
#####D#####
#.........#
#.........#
###.......#
#.........#
#.........D
#.........#
#.......#.#
#......#..#
#.........#
#####D#####

5
2
#####D#####
#.........#
#.........#
#.........#
#.........#
d...#e....#
#...#.....#
#.........#
#.........#
#.........#
#####D#####
boss
enemies 1

1
2
#####l#####
##.#...#.##
#.........#
#.#.#.#.#.#
#.........#
l..#.#.#..#
#.........#
#.#.#...#.#
#.........#
##.#...#.##
#####D#####
locked : 0

4
1
#####D#####
#.........#
#......#..#
#.......#.#
#.........#
l.........l
#.........#
#.#.......#
#..#......#
#.........#
#####D#####
locked : 3

3
2
#####D#####
#.........#
#.........#
#.........#
#.........#
D.........#
#.........#
#.......#k#
#......#..#
#.........#
#####D#####
key : 3

2
1
#####d#####
#.........#
#.........#
##.....#..#
#.........#
D.........D
#...#.....#
#.........#
#.........#
##........#
#####D#####

2
2
#####D#####
#.........#
#.........#
#.........#
#.........#
D........k#
#.........#
#.........#
#.........#
#.........#
#####D#####
key : 2

1
0
#####D#####
#.........#
#..#......#
#.#.....#.#
#.........#
#.........D
#.........#
#.#.....#.#
#..#...#..#
#........##
#####D#####

0
1
###########
#.........#
#.........#
#.........#
#.........#
D.........D
#.........#
#.#.......#
#..#......#
#.........#
#####D#####

0
2
###########
#.........#
#.........#
#..#......#
#..#......#
D..#......#
#.........#
#.........#
#.........#
#........##
#####l#####
locked : 2

3
1
#####D#####
#.........#
#.........#
##k#......#
#.##......#
D..#.#.#..D
#....#..#.#
#.....#...#
#.....#.###
#.......###
#####D#####
key : 4

0
0
###########
#?........#
#.........#
#.........#
#..#......#
#....@.#..D
#.........#
#.........#
#.........#
#.........#
#####D#####
sign The dungeon remembers all who enter.

2
0
#####D#####
#.........#
#.........#
#..#.....##
#.........#
#.........D
#...#.....#
#.........#
#.........#
#..#.....##
#####D#####

4
0
#####D#####
#.........#
#.........#
#..#..#..##
#.........#
#e........l
#..#..#...#
#.........#
#.........#
#..#......#
#####d#####
enemies 1

4
2
#####D#####
#.........#
#.........#
#.........#
#.........#
l.........#
#.........#
#.......#.#
#......#..#
#.........#
#####D#####
locked : 4

5
0
#####d#####
#.........#
#.........#
#.........#
#.........#
#.........D
#.........#
#.#.......#
#..#......#
#.........#
###########

1
1
#####D#####
#.k#......#
#.##......#
#.#..#....#
#.#.#.....#
D.........l
#.........#
#.........#
#.........#
#.........#
#####d#####
key : 0

6
2
#####D#####
#.........#
#.........#
#.........#
#....#.#..#
#.........#
#....##.#.#
#....##.###
#.....#..##
#........X#
###########

5
1
#####D#####
#.........#
#.#.#.#.#.#
#.........#
#.#.#.#.#.#
D.........d
#.#.....#.#
#.........#
#.....#?#.#
#....ee...#
###########
enemies 2
sign Turn back; you are not yet ready.

