3
2
#####D#####
#.........#
#..#...#..#
#.#.....#.#
#.........#
d.........#
#.........#
#.........#
#.........#
#.........#
###########

2
2
#####D#####
#.........#
#..#......#
#.#.......#
#.........#
D.........D
#.........#
#.......#.#
#......#..#
#.........#
#####D#####

2
3
#####D#####
#.........#
#.........#
#....##p..#
#...#e###.#
D.....##..d
#.....##..#
#...#?#e#.#
#.p.......#
#.........#
###########
enemies 2
sign This door will not yield without a key.

1
2
#####l#####
#......####
#.........#
#.....#.###
#......##.#
D....###..l
#....#....#
#...##....#
#.........#
#.........#
#####D#####

2
0
#####D#####
##........#
#.........#
#.........#
#...#..#..#
#.........D
#.........#
##..#.....#
#.........#
#.........#
#####d#####

0
1
###########
#e..?e....#
#.........#
##..#..#..#
#.........#
D.........D
#...#..#..#
#.........#
#.........#
##.....#..#
#####D#####
enemies 2
sign Only the prepared may pass.

1
4
#####D#####
#.........#
#.........#
#.........#
#.........#
D....e....#
#.....#...#
#.........#
#.#.......#
#.........#
#####d#####
boss
enemies 1

0
2
###########
#.........#
#.....#...#
#.........#
#.....#...#
D.........#
#.........#
#.........#
#.........#
#.........#
#####l#####
locked : 1

0
0
###########
#?........#
#.........#
###.......#
#.#.......#
#..#.@....D
#.........#
#.........#
#.....#...#
#.........#
#####D#####
sign The dungeon remembers all who enter.

2
4
#####d#####
#.........#
#......#..#
#.......#.#
#.........#
d.........#
#.........#
#.........#
#.........#
#.........#
###########

0
4
###########
#X........#
#.........#
#.........#
#.........#
#.........#
#.........#
#.........#
#.........#
#.........#
#####D#####

1
1
#####D#####
#k........#
##.#...#.##
#.........#
#.#.#.#.#.#
D.........D
#....#.#..#
#.........#
#.#.#.#...#
#.........#
#####D#####
key : 0

3
1
#####D#####
#.........#
#.........#
#.........#
#.........#
D.........d
#.........#
#.#.......#
#..#......#
#.........#
###########

4
0
#####D#####
#.........#
#.....##..#
#.......#.#
#.........#
#.........#
#.......#k#
#.#.......#
#..#......#
#.........#
#####D#####
key : 2

1
3
###########
#.........#
#..#......#
#.#.......#
#.........#
l.........D
#.........#
#.......#.#
#......#..#
#.........#
#####D#####
locked : 2

1
0
#####D#####
#.........#
#.........#
#.......#.#
#......##.#
#...####..D
#...###...#
#.....#...#
#.........#
#.........#
#####D#####

5
0
#####D#####
#.........#
#.........#
#..#......#
#..#......#
#.........#
#.........#
#.........#
#.........#
#k........#
###########
key : 5

2
1
#####D#####
#k........#
#..#......#
#.#.......#
#.........#
D.........D
#.....#...#
#........##
#.........#
#.........#
#####D#####
key : 1

3
0
#####d#####
#.........#
#.........#
#.........#
#.........#
#.........D
#.........#
#.........#
#.........#
#.........#
#####D#####

