1
4
#####.#####
#.........#
#.........#
#...#.....#
#..#......#
....#e....#
#...##....#
#..###....#
#..#......#
#.........#
#####d#####
boss
enemies 1

0
4
###########
#X........#
#.........#
#.........#
#.........#
#.........#
#.........#
#.........#
#.........#
#.........#
#####.#####

1
0
#####.#####
#..#.....##
#.........#
#.........#
#...#..#..#
#..........
#.........#
#..#.....##
#.........#
#.........#
#####.#####

0
1
###########
#e...e....#
#.........#
#.........#
#.........#
...........
#.........#
#.........#
#.........#
#?........#
#####.#####
enemies 2
sign Only the prepared may pass.

5
0
#####.#####
#.........#
###.#.....#
#####.....#
#.#.##....#
#.........#
#.........#
#.........#
#.........#
#k........#
###########
key : 5

1
2
#####l#####
#.........#
#..#......#
#.#.......#
#.........#
..........l
#.........#
#.........#
#.........#
#.........#
#####.#####

1
3
###########
#.........#
#.....#.#.#
#.........#
#.#.#...#.#
l..........
#.#.#.#.#.#
#.........#
#...#.#.#.#
#.........#
#####.#####
locked : 2

1
1
#####.#####
#k........#
#.........#
#.........#
#.........#
...........
#.........#
#.......#.#
#......#..#
#.........#
#####.#####
key : 0

4
0
#####.#####
#......#..#
#.........#
#.........#
#k#..#..#.#
#.........#
#.........#
##..#..#..#
#.........#
#.........#
#####.#####
key : 2

2
3
#####.#####
#.........#
#.........#
#.#.....#.#
#.........#
..........d
#.........#
#.........#
#.........#
#e#?....#e#
###########
enemies 2
sign This door will not yield without a key.

0
0
###########
#?........#
#.........#
#...#.....#
#.#.#.....#
#...#@.....
#.........#
#.........#
#.........#
#.........#
#####.#####
sign The dungeon remembers all who enter.

0
2
###########
#.........#
#..#......#
#.#.......#
#.........#
..........#
#.........#
#.......#.#
#......#..#
##........#
#####l#####
locked : 1

3
2
#####.#####
##.#...#.##
#.........#
#.#.#.#.#.#
#.........#
d..#.#....#
#.........#
#.#.#.#.#.#
#.........#
##.....#..#
###########

2
0
#####.#####
#.........#
#.........#
#.........#
#.........#
#.....##...
#.......#.#
#........##
#.....#.#.#
#.........#
#####d#####

2
2
#####.#####
#.........#
#........##
#.........#
#...#.#.#.#
...........
#..#.#.#..#
#.........#
#.#.#.#.#.#
#.........#
#####.#####

3
0
#####d#####
#.........#
#.#.#.#.#.#
#..##..##.#
#.#.#.##..#
#..........
#.........#
#.........#
#.........#
#.........#
#####.#####

3
1
#####.#####
#.........#
#..#...#..#
#.#.....#.#
#.........#
..........d
#.........#
#.........#
#.........#
#.........#
###########

2
1
#####.#####
#k#.....#.#
#.........#
#.#...#.#.#
#.........#
....#.#....
#.........#
#.#...#.#.#
#.........#
#.#.....#.#
#####.#####
key : 1

2
4
#####d#####
#.........#
#.....#...#
#...#.....#
#.....#...#
d...#.....#
#.........#
#.........#
#.........#
#.........#
###########

