1
3
#####D#####
#.##......#
#..##.....#
#.#######.#
#..###..#.#
#...#e#...#
#.....#.#.#
#...#.##..#
#.....#...#
#.........#
#####d#####
boss
enemies 1

0
3
###########
#X........#
#.........#
#.........#
#.........#
#.........#
#.........#
#.........#
#.........#
#.........#
#####D#####

8
2
#####D#####
#.........#
#.........#
#.........#
#.........#
#.........#
#.........#
#.........#
#.........#
#.........#
###########

4
2
###########
#e.e......#
####e..#..#
#.####....#
#..##...#.#
D......#..D
#.........#
#.........#
#.........#
#.........#
#####D#####
enemies 3

2
4
###########
#.#......k#
#.........#
#.........#
#..#..#...#
D.........#
#.........#
#.#..#..#.#
#.........#
#.........#
#####D#####
key : 4

7
2
#####D#####
#.........#
#.........#
#.........#
#....#....#
#k........#
#.....#...#
#.........#
#.....#...#
#.........#
#####D#####
key : 1

6
3
#####d#####
#.........#
#......#..#
#.......#.#
#.........#
D.........#
#.........#
#.......#.#
#......#..#
#.........#
###########

6
2
#####D#####
#e.......##
#.........#
#.........#
#?.....#..#
#e........D
#.........#
#..#..#..##
#.........#
#.........#
#####D#####
enemies 2
sign Those who search shall find.

4
1
###########
#........k#
#......#.##
#.........#
#.#.#.#.#.#
D.........D
#..#......#
#.........#
#.#.#.#.#.#
#.........#
#####D#####
key : 0

5
2
#####D#####
#.........#
#..#...#..#
#.#.......#
#.........#
d.........l
#.........#
#.#...#.#.#
#..#...#..#
#.........#
#####D#####

5
3
#####D#####
#.........#
#.........#
#.........#
#.........#
l......p..#
#.........#
#.........#
#.........#
#.........#
#####d#####
locked : 0

5
0
#####D#####
#......#..#
#.....##..#
#.........#
#.........#
#....@....D
#.........#
#.........#
#.........#
#.........#
###########

4
3
#####D#####
#.........#
#.........#
#.........#
#.........#
D.........l
#.........#
#.........#
#.........#
#.........#
#####D#####

5
1
#####D#####
#......#..#
#.........#
#...####..#
#.........#
D.........d
#.........#
#.........#
#.........#
#.........#
###########

4
4
#####D#####
#.........#
#.....#..##
#.........#
#.........#
l...#.....#
#.........#
#.........#
#..#......#
#.........#
###########
locked : 1

2
3
#####d#####
#.........#
##.....#..#
#.......#.#
#.........#
#.........D
#.........#
#......#..#
#.........#
#.........#
#####d#####

3
3
#####d#####
#.........#
#.........#
#.........#
#.....##..#
#?...##...D
#.....e##.#
#....###e##
#......#..#
#.........#
#####D#####
enemies 2
sign A useful tool lies just ahead.

4
0
###########
#.........#
#.........#
#.........#
#.........#
#.........D
#.p.......#
#.........#
#.........#
#.p.......#
#####D#####

3
4
#####D#####
#.........#
#...#.#...#
#...###...#
#.....#...#
D..#.....k#
#.........#
#.........#
#.........#
#.........#
#####D#####
key : 2

