4
1
#####d#####
##.#...#.##
#.........#
#...#.#.#.#
#.........#
.......#..#
#.........#
#...#.#.#.#
#.........#
##.#......#
#####.#####

7
0
#####.#####
#.......#.#
#.........#
##........#
#.........#
#..........
#.........#
#.........#
#?........#
#e........#
###########
enemies 1
sign Turn back; you are not yet ready.

8
1
#####d#####
#.........#
#.........#
#.........#
#..#e#....#
#..#.#.....
#...##....#
#.........#
#..#......#
#.........#
#####.#####
boss
enemies 1

6
0
#####l#####
#.........#
#..#......#
#.#.......#
#.........#
#..........
#.........#
#.......#.#
#......#..#
#.........#
#####.#####
locked : 0

3
0
#####.#####
#.........#
#......#..#
#.......#.#
#.........#
#..........
#....#....#
#......#..#
#.........#
#.........#
#####d#####

2
1
#####.#####
#.........#
#......#..#
#.......#.#
#.........#
...........
#.........#
#.#.......#
#..#......#
#.........#
#####d#####

5
1
#####.#####
#.........#
#.........#
#.........#
#.........#
..........#
#.........#
#.........#
#.........#
#.........#
#####.#####

1
1
#####.#####
#e........#
#.........#
#.........#
#e........#
#e.........
#?........#
#.........#
#.........#
#.........#
#####.#####
enemies 3
door 0 : 0
sign Those who search shall find.

4
0
#####d#####
#.........#
#.........#
#.........#
#.........#
#k.........
#.....#...#
#........##
#.........#
#.........#
#####.#####
key : 0

9
1
#####.#####
#.........#
#..#...#..#
#.#.....#.#
#.........#
#.........#
#.........#
#.........#
#.........#
#k........#
###########
key : 3

5
0
#####.#####
#.........#
#.........#
#.........#
#.........#
#....@.....
#.........#
#.........#
#.........#
#.........#
#####l#####

0
1
###########
#k........#
#...#.#...#
#...#.#...#
#....#.#..#
#...#..#..#
#..#...#..#
#.........#
#.........#
#.........#
#####.#####
key : 5

8
2
###########
#........X#
#.........#
#.........#
#.........#
...#......#
#......#..#
#.........#
#.........#
#.........#
###########

3
1
#####d#####
#.........#
#.........#
#..#..#..##
#.........#
..........#
#..#..#...#
#.........#
#.........#
#..#.....##
#####d#####

2
0
###########
#es.......#
#e........#
#.........#
#.........#
#..........
#.........#
#.........#
#.........#
#.........#
#####.#####
enemies 2
switch 0 : 0

1
2
###########
#........k#
#.........#
#.........#
#.........#
..........#
#.........#
#.........#
#.........#
#.........#
#####.#####
key : 4

6
1
#####.#####
#.##......#
#.#.#.....#
#.#..#....#
#.##.#....#
...#.#....#
#.........#
#..#......#
#.........#
#.........#
#####.#####

7
1
#####.#####
#.........#
#.........#
#.........#
#.........#
..........#
#.........#
#.#.....#.#
#..#...#..#
#.........#
#####d#####

2
2
#####.#####
#.........#
#........##
#.........#
#.#.......#
..........#
#.........#
#.........#
#.........#
#.........#
###########

