0
1
###########
#.......ee#
#.##.....s#
#.##.....?#
#.##......#
D.........#
#.........#
#.........#
#.........#
#.........#
#####D#####
enemies 2
switch 0 : 0
sign What you seek is close.

3
3
#####d#####
#.........#
#.#.#.....#
#.##..#...#
#.#####...#
D..##.....D
#.###.....#
#.........#
#.........#
#.........#
#####d#####

3
4
#####D#####
#.........#
#.........#
#.#..#..#.#
#.........#
D.........d
#.#..#..#.#
#.........#
#.........#
#.......#k#
#####D#####
key : 3

3
5
###########
#.......###
#.........#
#......p..#
#...e##.#.#
d...##....#
#.....#...#
#..p#.....#
#...#..#..#
#.........#
#####D#####
boss
enemies 1

1
2
###########
#.........#
#.........#
#.........#
#.........#
D.........D
#.........#
#.........#
#.........#
#.........#
#####D#####

1
3
###########
#........e#
#.........#
#.........#
#.........#
D.........#
#.........#
#.........#
#.........#
#.........#
#####D#####
enemies 1
door 0 : 0

4
5
#####D#####
#.........#
#..##.....#
#..#.#....#
#..#.#....#
D.........#
#.........#
#.........#
#.........#
#........X#
###########

3
2
#####d#####
#.........#
#.........#
#.##..#...#
#.#####...#
D....##...D
#.#.##....#
#.###.#...#
#.........#
#.........#
###########

2
2
#####D#####
#.........#
#.....##..#
#....#k#..#
#.p.......#
D.........D
#......p..#
#.........#
#.........#
#.........#
#####d#####
key : 1

2
4
###########
#..#......#
#.#.......#
#.#.......#
#.........#
D.........#
#...##....#
###.##....#
##.##.....#
#.........#
#####D#####

2
3
#####D#####
#.........#
#.#.#.#.#.#
#.........#
#..#...#..#
D.........D
#...#.#.#.#
#.........#
#..#...#.##
#.........#
#####d#####

1
1
#####D#####
#k........#
#...#.....#
#.........#
#.........#
D.........D
#.........#
#.........#
#.........#
#.........#
#####l#####
key : 0

1
0
#####D#####
#.........#
#.........#
#.........#
#.........#
#....#....D
#...##....#
#.#####...#
#...#.#...#
##........#
#####D#####

2
1
#####l#####
#.........#
#......#..#
#.......#.#
#.........#
D.........D
#.........#
#.......#.#
#......#..#
#.........#
#####l#####
locked : 0

4
3
#####d#####
##.....#..#
#.........#
#.........#
#...#..#..#
#.........D
#.........#
##..#.....#
#.........#
#.........#
###########

4
4
#####D#####
#k........#
##.....#..#
#.........#
#.#.#.#.#.#
D.........D
#..#.#.#..#
#.........#
#...#...#.#
#.........#
###########
key : 5

2
0
#####D#####
#.#.......#
#...#.#...#
#...#.#...#
#.#.#.#...#
#....@....D
#.........#
#.........#
#.........#
#?........#
###########
sign Only the prepared may pass.

0
0
###########
#.........#
#.........#
#.........#
#.........#
#.........D
#.........#
#.........#
#.........#
#.........#
#####D#####

3
1
#####l#####
#.........#
#.........#
#.........#
#..##..##.#
#..##.##..D
#...####..#
#..#####..#
#.....##..#
#.........#
###########
locked : 1

