5
3
#####.#####
#.........#
#..#......#
#.#.......#
#.........#
..........#
#.........#
#.......#.#
#......#..#
#.........#
###########

0
2
###########
#X........#
#.#.#.#...#
#.###.....#
#...##....#
#.........#
#.........#
#.........#
#.........#
#.........#
#####.#####

4
1
#####.#####
#.........#
#.........#
#.........#
#.........#
l.....#....
#.....#...#
#.#.....#.#
#..#...#..#
#.........#
#####l#####
locked : 0

4
2
#####.#####
#.........#
#.#.#.#.#.#
#.........#
#..#...#..#
...........
#.#.#.#.#.#
#.........#
#..#.....##
#........k#
#####d#####
key : 2

6
2
#####d#####
#.........#
#.....#.#.#
#.........#
#.#...#...#
#.........#
#.#...#...#
#.........#
#.#.#.#.#.#
#.........#
###########

1
2
#####.#####
#.........#
#.#.......#
#.##......#
#.........#
#....e....#
#.........#
#.........#
#.........#
#.........#
#####l#####
locked : 5
boss
enemies 1

2
3
###########
#.#....e#e#
#........e#
#....#...##
#........?#
....#.#...#
#.........#
#....#.#.##
#.........#
#.#.....#.#
#####.#####
enemies 3
door 0 : 0
sign A locked path — look elsewhere first.

4
3
#####.#####
#.........#
#.........#
#.........#
#.........#
.....##...#
#....s#..e#
#....#.####
#.......###
#........e#
#####.#####
enemies 2
switch 0 : 0

3
2
#####l#####
#.........#
#.........#
#.........#
#....#.#..#
d..###.#...
#....#....#
#.........#
#.........#
#.........#
#####.#####

5
1
#####l#####
#.........#
#.........#
#.........#
#.....#...#
#..#.......
#..#.#....#
#...#.##..#
#..#..#...#
#.........#
###########
locked : 2

3
0
#####.#####
#.........#
#.........#
##........#
#k........#
#..........
#...#.....#
#....##...#
#...#.#...#
#..#......#
#####.#####
key : 0

4
0
#####.#####
#.........#
#.........#
#..##.....#
#..#.#....#
#..#.@....l
#.........#
#.........#
#.........#
#.........#
###########

3
1
#####.#####
#k........#
#.........#
#.........#
#.........#
..........d
#.........#
#.........#
#.........#
#.........#
#####.#####
key : 1

5
2
#####d#####
#.........#
#.........#
#.........#
#.........#
...........
#.........#
#.........#
#.........#
#.........#
#####d#####

2
0
#####.#####
#.........#
#.........#
#.........#
#.........#
#..##.#....
#.##.##...#
#..#..#...#
#..#......#
#.##......#
#####.#####

2
2
#####l#####
#.........#
##.#...#.##
#.........#
#.#.#.#...#
...........
#..#......#
#.........#
#.#.....#.#
#.........#
#####l#####
locked : 1

2
1
###########
##......#.#
#......#..#
#.......#.#
#.........#
...........
#...#.....#
#.......#.#
#......#..#
#.........#
#####.#####

1
0
###########
#.........#
#..#......#
#.#.......#
#....#....#
#..#......#
#.........#
#.......#.#
#......#..#
#.........#
#####.#####

3
3
#####.#####
#.........#
#......#..#
#.......#k#
#.........#
..........#
#.........#
#.........#
#.........#
#.........#
#####.#####
key : 5

