5
0
#####d#####
#.........#
#.........#
#.........#
#.##......#
#...#.....#
#.###.....#
##..#.....#
##.##.....#
#.........#
###########

1
2
#####d#####
#.........#
#.........#
#.........#
#.........#
...........
#.........#
#.#.....#.#
#..#...#..#
#.........#
#####.#####

3
1
#####.#####
#.........#
#..#..#..##
#.........#
#.........#
...#..#...l
#.........#
#.........#
#..#..#..##
#.........#
#####.#####

2
4
#####.#####
#.........#
#.....#...#
#...#.....#
#.........#
..........#
#....##...#
#......#..#
#.....#...#
#........X#
###########

2
3
#####.#####
#.........#
#......#..#
#.......#.#
#.........#
d..........
#.........#
#.#.......#
#..#......#
#.........#
###########

3
2
#####.#####
#.........#
#.#...#.#.#
#.........#
#.....#.#.#
l.........#
#.#.#.#.#.#
#.........#
#.#.#.#.#.#
#.........#
###########
locked : 2

2
0
#####l#####
#.........#
#.....#...#
#....###..#
#.....##..#
#?...@.....
#.........#
#.........#
#.........#
#.........#
#####.#####
sign This door will not yield without a key.

1
0
###########
#.........#
#..#.....##
#.........#
#.........#
#...#..#...
#.........#
#.........#
#..#..#..##
#.........#
#####l#####
locked : 0

4
1
#####.#####
#.........#
##.#...#.##
#.........#
#.#.#.#.#.#
..........#
#.........#
#.........#
#...#.#.#.#
#........k#
###########
key : 3

2
2
#####.#####
#.........#
#.........#
#.........#
#.........#
.......#..d
#....#....#
#.........#
#.........#
#.........#
#####.#####

1
1
###########
#.....k...#
#.#...#.#.#
#.........#
#....#.#..#
...........
#.#.#.#.#.#
#.........#
#..#.....##
#.........#
#####.#####
key : 2

4
0
#####.#####
#.........#
#.........#
#....#..#.#
#.........#
#..........
#..#..#...#
#.........#
#.........#
#.#.......#
#####d#####

1
4
#####.#####
#.........#
#.........#
#.........#
#.........#
d....e....#
#.........#
#.........#
#.........#
#.........#
#####.#####
boss
enemies 1

2
1
#####.#####
#k........#
#.#.....#.#
#.........#
#.........#
...#..#....
#.........#
#.........#
#.#.....#.#
#.........#
#####.#####
key : 1

3
0
#####.#####
#.........#
#.........#
#.........#
#k##.#....#
#.....#....
#.#..#....#
#...###...#
#.#.#.#...#
#.........#
#####.#####
key : 0

0
3
###########
#.........#
#.#.....#.#
#.........#
#.........#
...........
#.........#
#.........#
#.#.....#.#
#.........#
#####l#####
locked : 3

0
4
###########
#..#.....##
#.........#
#.........#
#..#..#...#
..........#
#.........#
#..#..#..##
#.........#
#.........#
#####.#####

1
3
#####l#####
#e.......?#
#.###.....#
#.#e##....#
#...###...#
..........d
#.........#
#.........#
#.......#.#
#e........#
#####.#####
enemies 3
sign A locked path — look elsewhere first.

0
2
###########
#.........#
#...#..##.#
#...#.#...#
#...#.###.#
#.....##...
#...#.....#
#.........#
#.........#
#.........#
#####d#####

