3
3
#####.#####
#k#.......#
#.........#
#.........#
#..#......#
..........#
#.........#
#.#..#..#.#
#.........#
#.........#
#####.#####
key : 3

5
1
#####d#####
#......##.#
#...#...#.#
#....####.#
#.....##..#
.....#.#..#
#....#.#..#
#.........#
#.........#
#.........#
###########

1
0
###########
#.........#
#.........#
#.........#
#.........#
#..........
#.........#
#.........#
#.........#
#.........#
#####l#####
locked : 0

4
2
#####d#####
#......#..#
#......#..#
#.......#.#
#.........#
.......#..d
#.........#
#.......#.#
#......#..#
#.........#
###########

4
0
#####.#####
#......##.#
#......##.#
#...##.##.#
#....#.#..#
#..........
#....#.#..#
#....#.#..#
#.....##..#
#.........#
#####.#####

3
2
#####.#####
#e.#.....?#
#.........#
#.........#
#...#..#..#
...........
#.........#
#.....#...#
#.........#
#e........#
#####d#####
enemies 2
sign Those who search shall find.

1
2
#####.#####
#.........#
#.........#
#.#..#..#.#
#.........#
..........#
#..#..#...#
#.........#
#.........#
#.......#.#
#####.#####

1
1
###########
#.........#
#.........#
######....#
#.##.#....#
...#.......
#.#.##....#
###.......#
#.........#
#.........#
#####.#####

2
0
#####l#####
#.........#
#.........#
#.........#
#..#......#
#..........
#..##.....#
##.###....#
##.#......#
#.........#
#####.#####

2
1
#####.#####
#.........#
#..##.....#
#.#.......#
#.........#
...........
#.........#
#.......#.#
#......#..#
#.........#
#####d#####

5
0
#####.#####
#.........#
#..#......#
#.#.......#
#.........#
#..........
#.........#
#.........#
#.........#
#k........#
###########
key : 1

2
3
###########
#........k#
#..#.....##
#.#.......#
#.........#
..........#
#.........#
#.#..#....#
#..#......#
#.#.......#
#####.#####
key : 5

0
2
###########
#e##.....e#
#e##..#...#
#.##.##...#
#....#....#
#....##...#
#.........#
#.........#
#.........#
#.........#
#####.#####
enemies 3
door 0 : 0 1

4
1
#####.#####
#..#......#
#..?#.....#
#.###.....#
#.#.e#....#
....#e#....
#.........#
#.........#
#.........#
#.........#
#####d#####
enemies 2
sign What you seek is close.

3
0
#####.#####
#.........#
#.........#
#.........#
#.........#
#....@.....
#.........#
#.........#
#.........#
#.........#
#####.#####

4
3
#####.#####
#.........#
#...#.#...#
#.........#
#....##...#
d..#.e....#
#.........#
#.........#
#.........#
#.........#
#####.#####
boss
enemies 1

2
2
#####.#####
##.......e#
#s........#
#.........#
#.#..#..#.#
...........
#.........#
##.....#..#
#.........#
#e.......e#
#####.#####
enemies 3
switch 0 : 0 1

3
1
#####d#####
#.........#
#.........#
#.....##..#
#.......#.#
.....###...
#..##k.#..#
#..###.#..#
#..##.....#
#..#......#
#####.#####
key : 0

5
3
#####.#####
#.........#
#.........#
#......#..#
#......#..#
#.........#
#.........#
#.........#
#.........#
#X........#
###########

